,popularity,budget,revenue,profit,original_title,cast,director,runtime,genres,release_date,vote_count,vote_average,release_year,budget_adj,revenue_adj,profit_adj,ratings
0,32.985763,150000000,1513528810,1363528810,Jurassic World,Chris Pratt|Bryce Dallas Howard|Irrfan Khan|Vincent D'Onofrio|Nick Robinson,Colin Trevorrow,124,Action|Adventure|Science Fiction|Thriller,2015-06-09,5562,6.5,2015,137999939,1392445892,1254445953,6
1,28.419936,150000000,378436354,228436354,Mad Max: Fury Road,Tom Hardy|Charlize Theron|Hugh Keays-Byrne|Nicholas Hoult|Josh Helman,George Miller,120,Action|Adventure|Science Fiction|Thriller,2015-05-13,6185,7.1,2015,137999939,348161292,210161353,7
2,13.112507,110000000,295238201,185238201,Insurgent,Shailene Woodley|Theo James|Kate Winslet|Ansel Elgort|Miles Teller,Robert Schwentke,119,Adventure|Science Fiction|Thriller,2015-03-18,2480,6.3,2015,101199955,271619025,170419070,6
3,11.173104,200000000,2068178225,1868178225,Star Wars: The Force Awakens,Harrison Ford|Mark Hamill|Carrie Fisher|Adam Driver|Daisy Ridley,J.J. Abrams,136,Action|Adventure|Science Fiction|Fantasy,2015-12-15,5292,7.5,2015,183999919,1902723129,1718723210,7
4,9.335014,190000000,1506249360,1316249360,Furious 7,Vin Diesel|Paul Walker|Jason Statham|Michelle Rodriguez|Dwayne Johnson,James Wan,137,Action|Crime|Thriller,2015-04-01,2947,7.3,2015,174799923,1385748801,1210948878,7
5,9.1107,135000000,532950503,397950503,The Revenant,Leonardo DiCaprio|Tom Hardy|Will Poulter|Domhnall Gleeson|Paul Anderson,Alejandro GonzÃ¡lez IÃ±Ã¡rritu,156,Western|Drama|Adventure|Thriller,2015-12-25,3929,7.2,2015,124199945,490314247,366114302,7
6,8.654359,155000000,440603537,285603537,Terminator Genisys,Arnold Schwarzenegger|Jason Clarke|Emilia Clarke|Jai Courtney|J.K. Simmons,Alan Taylor,125,Science Fiction|Action|Thriller|Adventure,2015-06-23,2598,5.8,2015,142599937,405355075,262755138,6
7,7.6674,108000000,595380321,487380321,The Martian,Matt Damon|Jessica Chastain|Kristen Wiig|Jeff Daniels|Michael PeÃ±a,Ridley Scott,141,Drama|Adventure|Science Fiction,2015-09-30,4572,7.6,2015,99359956,547749654,448389698,8
8,7.40416499999999,74000000,1156730962,1082730962,Minions,Sandra Bullock|Jon Hamm|Michael Keaton|Allison Janney|Steve Coogan,Kyle Balda|Pierre Coffin,91,Family|Animation|Adventure|Comedy,2015-06-17,2893,6.5,2015,68079970,1064192016,996112046,6
9,6.326804,175000000,853708609,678708609,Inside Out,Amy Poehler|Phyllis Smith|Richard Kind|Bill Hader|Lewis Black,Pete Docter,94,Comedy|Animation|Family,2015-06-09,3935,8.0,2015,160999929,785411574,624411645,8
10,6.200282,245000000,880674609,635674609,Spectre,Daniel Craig|Christoph Waltz|LÃ©a Seydoux|Ralph Fiennes|Monica Bellucci,Sam Mendes,148,Action|Adventure|Crime,2015-10-26,3254,6.2,2015,225399900,810220283,584820383,6
11,6.189369,176000003,183987723,7987720,Jupiter Ascending,Mila Kunis|Channing Tatum|Sean Bean|Eddie Redmayne|Douglas Booth,Lana Wachowski|Lilly Wachowski,124,Science Fiction|Fantasy|Action|Adventure,2015-02-04,1937,5.2,2015,161919931,169268630,7348699,5
12,6.118847,15000000,36869414,21869414,Ex Machina,Domhnall Gleeson|Alicia Vikander|Oscar Isaac|Sonoya Mizuno|Corey Johnson,Alex Garland,108,Drama|Science Fiction,2015-01-21,2854,7.6,2015,13799993,33919845,20119852,8
13,5.984995,88000000,243637091,155637091,Pixels,Adam Sandler|Michelle Monaghan|Peter Dinklage|Josh Gad|Kevin James,Chris Columbus,105,Action|Comedy|Science Fiction,2015-07-16,1575,5.8,2015,80959964,224146025,143186061,6
14,5.944927,280000000,1405035767,1125035767,Avengers: Age of Ultron,Robert Downey Jr.|Chris Hemsworth|Mark Ruffalo|Chris Evans|Scarlett Johansson,Joss Whedon,141,Action|Adventure|Science Fiction,2015-04-22,4304,7.4,2015,257599886,1292632336,1035032450,7
15,5.8984,44000000,155760117,111760117,The Hateful Eight,Samuel L. Jackson|Kurt Russell|Jennifer Jason Leigh|Walton Goggins|DemiÃ¡n Bichir,Quentin Tarantino,167,Crime|Drama|Mystery|Western,2015-12-25,2389,7.4,2015,40479982,143299244,102819262,7
16,5.749758,48000000,325771424,277771424,Taken 3,Liam Neeson|Forest Whitaker|Maggie Grace|Famke Janssen|Dougray Scott,Olivier Megaton,109,Crime|Action|Thriller,2015-01-01,1578,6.1,2015,44159980,299709578,255549598,6
17,5.573184,130000000,518602163,388602163,Ant-Man,Paul Rudd|Michael Douglas|Evangeline Lilly|Corey Stoll|Bobby Cannavale,Peyton Reed,115,Science Fiction|Action|Adventure,2015-07-14,3779,7.0,2015,119599947,477113780,357513833,7
18,5.556818,95000000,542351353,447351353,Cinderella,Lily James|Cate Blanchett|Richard Madden|Helena Bonham Carter|Holliday Grainger,Kenneth Branagh,112,Romance|Fantasy|Family|Drama,2015-03-12,1495,6.8,2015,87399961,498963025,411563064,7
19,5.476958,160000000,650523427,490523427,The Hunger Games: Mockingjay - Part 2,Jennifer Lawrence|Josh Hutcherson|Liam Hemsworth|Woody Harrelson|Elizabeth Banks,Francis Lawrence,136,War|Adventure|Science Fiction,2015-11-18,2380,6.5,2015,147199935,598481289,451281354,6
20,5.462138,190000000,209035668,19035668,Tomorrowland,Britt Robertson|George Clooney|Raffey Cassidy|Thomas Robinson|Hugh Laurie,Brad Bird,130,Action|Family|Science Fiction|Adventure|Mystery,2015-05-19,1899,6.2,2015,174799923,192312729,17512806,6
21,5.337064,30000000,91709827,61709827,Southpaw,Jake Gyllenhaal|Rachel McAdams|Forest Whitaker|Oona Laurence|50 Cent,Antoine Fuqua,123,Action|Drama,2015-06-15,1386,7.3,2015,27599987,84373003,56773016,7
22,4.907832,110000000,470490832,360490832,San Andreas,Dwayne Johnson|Alexandra Daddario|Carla Gugino|Ioan Gruffudd|Archie Panjabi,Brad Peyton,114,Action|Drama|Thriller,2015-05-27,2060,6.1,2015,101199955,432851374,331651419,6
23,4.71040199999999,40000000,569651467,529651467,Fifty Shades of Grey,Dakota Johnson|Jamie Dornan|Jennifer Ehle|Eloise Mumford|Victor Rasuk,Sam Taylor-Johnson,125,Drama|Romance,2015-02-11,1865,5.3,2015,36799983,524079119,487279136,5
24,4.648046,28000000,133346506,105346506,The Big Short,Christian Bale|Steve Carell|Ryan Gosling|Brad Pitt|Melissa Leo,Adam McKay,130,Comedy|Drama,2015-12-11,1545,7.3,2015,25759988,122678731,96918743,7
25,4.566713,150000000,682330139,532330139,Mission: Impossible - Rogue Nation,Tom Cruise|Jeremy Renner|Simon Pegg|Rebecca Ferguson|Ving Rhames,Christopher McQuarrie,131,Action,2015-07-23,2349,7.1,2015,137999939,627743451,489743512,7
26,4.564549,68000000,215863606,147863606,Ted 2,Mark Wahlberg|Seth MacFarlane|Amanda Seyfried|Jessica Barth|Giovanni Ribisi,Seth MacFarlane,115,Comedy,2015-06-25,1666,6.3,2015,62559972,198594430,136034458,6
27,4.503789,81000000,403802136,322802136,Kingsman: The Secret Service,Taron Egerton|Colin Firth|Samuel L. Jackson|Michael Caine|Mark Strong,Matthew Vaughn,130,Crime|Comedy|Action|Adventure,2015-01-24,3833,7.6,2015,74519967,371497801,296977834,8
28,4.062293,20000000,88346473,68346473,Spotlight,Mark Ruffalo|Michael Keaton|Rachel McAdams|Liev Schreiber|John Slattery,Tom McCarthy,128,Drama|Thriller|History,2015-11-06,1559,7.8,2015,18399991,81278719,62878728,8
29,3.968891,61000000,311256926,250256926,Maze Runner: The Scorch Trials,Dylan O'Brien|Kaya Scodelario|Thomas Brodie-Sangster|Giancarlo Esposito|Aidan Gillen,Wes Ball,132,Action|Science Fiction|Thriller,2015-09-09,1849,6.4,2015,56119975,286356245,230236270,6
31,3.899557,49000000,102069268,53069268,Chappie,Sharlto Copley|Dev Patel|Ninja|Yolandi Visser|Jose Pablo Cantillo,Neill Blomkamp,120,Crime|Action|Science Fiction,2015-03-04,1990,6.6,2015,45079980,93903685,48823705,7
32,3.877764,29000000,287506194,258506194,Pitch Perfect 2,Anna Kendrick|Rebel Wilson|Hailee Steinfeld|Brittany Snow|Skylar Astin,Elizabeth Banks,115,Comedy|Music,2015-05-07,1264,6.8,2015,26679988,264505582,237825594,7
33,3.64821,40000000,162610473,122610473,Bridge of Spies,Tom Hanks|Mark Rylance|Amy Ryan|Alan Alda|Sebastian Koch,Steven Spielberg,141,Thriller|Drama,2015-10-15,1638,7.1,2015,36799983,149601569,112801586,7
34,3.644541,58000000,150170815,92170815,Goosebumps,Jack Black|Dylan Minnette|Odeya Rush|Amy Ryan|Jillian Bell,Rob Letterman,103,Adventure|Horror|Comedy,2015-08-05,600,6.2,2015,53359976,138157089,84797113,6
35,3.557846,6000000,35401758,29401758,Room,Brie Larson|Jacob Tremblay|Joan Allen|Sean Bridgers|William H. Macy,Lenny Abrahamson,117,Drama|Thriller,2015-10-16,1520,8.0,2015,5519997,32569603,27049606,8
37,3.339135,175000000,331926147,156926147,The Good Dinosaur,Raymond Ochoa|Jack Bright|Jeffrey Wright|Frances McDormand|Maleah Nipay-Padilla,Peter Sohn,93,Adventure|Animation|Comedy|Family|Fantasy,2015-11-14,1087,6.6,2015,160999929,305371920,144371991,7
38,3.23737,50000000,71561644,21561644,Run All Night,Liam Neeson|Ed Harris|Joel Kinnaman|Boyd Holbrook|Bruce McGill,Jaume Collet-Serra,114,Action|Crime|Drama|Mystery|Thriller,2015-03-11,814,6.3,2015,45999979,65836683,19836704,6
39,3.227329,11000000,62076141,51076141,Brooklyn,Saoirse Ronan|Domhnall Gleeson|Emory Cohen|Emily Bett Rickards|Eileen O'Higgins,John Crowley,111,Drama|Romance,2015-11-04,754,7.3,2015,10119995,57110024,46990029,7
40,3.202719,28000000,201634991,173634991,Straight Outta Compton,O'Shea Jackson Jr.|Corey Hawkins|Jason Mitchell|Neil Brown Jr.|Aldis Hodge,F. Gary Gray,147,Drama|Music,2015-08-13,918,7.7,2015,25759988,185504110,159744122,8
41,3.080505,90000000,140396650,50396650,The Last Witch Hunter,Vin Diesel|Rose Leslie|Michael Caine|Elijah Wood|Ã“lafur Darri Ã“lafsson,Breck Eisner,106,Fantasy|Action|Adventure,2015-10-21,879,5.6,2015,82799963,129164861,46364898,6
42,3.079522,30000000,34441873,4441873,Steve Jobs,Michael Fassbender|Kate Winslet|Seth Rogen|Katherine Waterston|Jeff Daniels,Danny Boyle,122,History|Drama,2015-10-09,1035,6.9,2015,27599987,31686509,4086522,7
43,3.053421,75000000,108145109,33145109,The Man from U.N.C.L.E.,Henry Cavill|Armie Hammer|Alicia Vikander|Elizabeth Debicki|Luca Calvani,Guy Ritchie,116,Comedy|Action|Adventure,2015-08-13,1548,7.0,2015,68999969,99493456,30493487,7
44,3.025852,25000000,42629776,17629776,The Age of Adaline,Blake Lively|Michiel Huisman|Harrison Ford|Ellen Burstyn|Kathy Baker,Lee Toland Krieger,112,Fantasy|Drama|Romance,2015-04-16,1221,7.3,2015,22999989,39219376,16219387,7
45,3.023253,10000000,14333790,4333790,Hardcore Henry,Sharlto Copley|Haley Bennett|Danila Kozlovskiy|Tim Roth|Andrei Dementiev,Ilya Naishuller,97,Action|Adventure|Science Fiction,2015-09-12,396,5.9,2015,9199995,13187080,3987085,6
46,2.976436,135000000,368871007,233871007,Home,Jim Parsons|Rihanna|Steve Martin|Jennifer Lopez|Matt Jones,Tim Johnson,94,Fantasy|Comedy|Animation|Science Fiction|Family,2015-03-18,1060,6.9,2015,124199945,339361177,215161232,7
47,2.968254,12000000,85512300,73512300,Paper Towns,Nat Wolff|Cara Delevingne|Halston Sage|Justice Smith|Austin Abrams,Jake Schreier,109,Drama|Mystery|Romance,2015-07-09,1252,6.2,2015,11039995,78671281,67631286,6
49,2.885126,4000000,9064511,5064511,The Lobster,Colin Farrell|Rachel Weisz|LÃ©a Seydoux|John C. Reilly|Ben Whishaw,Yorgos Lanthimos,118,Thriller|Comedy|Drama|Romance|Science Fiction,2015-10-08,638,6.6,2015,3679998,8339346,4659348,7
50,2.883233,11800000,40272135,28472135,Carol,Cate Blanchett|Rooney Mara|Kyle Chandler|Sarah Paulson|Jake Lacy,Todd Haynes,118,Romance|Drama,2015-11-20,562,7.1,2015,10855995,37050347,26194352,7
51,2.814802,35000000,194564672,159564672,The Intern,Robert De Niro|Anne Hathaway|Rene Russo|Anders Holm|JoJo Kushner,Nancy Meyers,121,Comedy,2015-09-24,1255,7.1,2015,32199985,178999419,146799434,7
52,2.798017,55000000,203427584,148427584,Everest,Jason Clarke|Jake Gyllenhaal|Josh Brolin|John Hawkes|Sam Worthington,Baltasar KormÃ¡kur,121,Adventure|Drama,2015-09-10,1172,6.7,2015,50599977,187153294,136553317,7
53,2.793297,60000000,101134059,41134059,Joy,Jennifer Lawrence|Bradley Cooper|Robert De Niro|Dascha Polanco|Edgar RamÃ­rez,David O. Russell,124,Comedy|Drama,2015-12-24,1001,6.4,2015,55199975,93043293,37843318,6
54,2.614499,105000000,133718711,28718711,Point Break,Edgar RamÃ­rez|Luke Bracey|Teresa Palmer|Delroy Lindo|Ray Winstone,Ericson Core,114,Action|Crime|Thriller,2015-12-03,505,5.5,2015,96599957,123021159,26421202,5
55,2.584264,20000000,36606743,16606743,Burnt,Bradley Cooper|Sienna Miller|Lily James|Alicia Vikander|Uma Thurman,John Wells,100,Drama,2015-10-02,631,6.3,2015,18399991,33678188,15278197,6
56,2.578919,26000000,30523226,4523226,Self/less,Ryan Reynolds|Ben Kingsley|Natalie Martinez|Matthew Goode|Michelle Dockery,Tarsem Singh,116,Science Fiction|Mystery|Thriller,2015-07-10,719,6.2,2015,23919989,28081355,4161366,6
57,2.575711,60000000,30418560,-29581440,Mortdecai,Johnny Depp|Gwyneth Paltrow|Ewan McGregor|Paul Bettany|Olivia Munn,David Koepp,106,Comedy|Adventure,2015-01-21,696,5.3,2015,55199975,27985062,-27214913,5
58,2.557859,15000000,64191523,49191523,The Danish Girl,Eddie Redmayne|Alicia Vikander|Matthias Schoenaerts|Amber Heard|Ben Whishaw,Tom Hooper,120,Drama,2015-11-27,867,7.3,2015,13799993,59056175,45256182,7
59,2.550747,70000000,17752940,-52247060,Blackhat,Chris Hemsworth|Leehom Wang|Tang Wei|Viola Davis|Holt McCallany,Michael Mann,133,Mystery|Crime|Action|Thriller|Drama,2015-01-13,584,5.0,2015,64399971,16332697,-48067274,5
60,2.487849,30000000,84025816,54025816,Sicario,Emily Blunt|Benicio del Toro|Josh Brolin|Victor Garber|Jon Bernthal,Denis Villeneuve,121,Action|Crime|Drama|Mystery|Thriller,2015-09-17,1479,7.1,2015,27599987,77303716,49703729,7
61,2.487042,120000001,167977596,47977595,Fantastic Four,Miles Teller|Kate Mara|Michael B. Jordan|Jamie Bell|Toby Kebbell,Josh Trank,100,Action|Adventure|Science Fiction,2015-08-05,1565,4.4,2015,110399952,154539320,44139368,4
62,2.46449,3500000,40423945,36923945,The Witch,Anya Taylor-Joy|Ralph Ineson|Kate Dickie|Harvey Scrimshaw|Ellie Grainger,Robert Eggers,92,Mystery|Horror,2015-03-24,700,5.8,2015,3219998,37190013,33970015,6
63,2.404473,65000000,235666219,170666219,Spy,Melissa McCarthy|Jason Statham|Rose Byrne|Miranda Hart|Bobby Cannavale,Paul Feig,120,Action|Comedy|Crime,2015-05-06,1840,6.9,2015,59799973,216812826,157012853,7
64,2.395366,50100000,153962963,103862963,Focus,Will Smith|Margot Robbie|Rodrigo Santoro|Robert Taylor|Gerald McRaney,Glenn Ficarra|John Requa,105,Romance|Comedy|Crime|Drama,2015-02-25,1831,6.7,2015,46091979,141645863,95553884,7
65,2.354654,35000000,82347656,47347656,Hitman: Agent 47,Rupert Friend|Zachary Quinto|Hannah Ware|Emilio Rivera|Rolf Kanies,Aleksander Bach,96,Action|Crime|Thriller,2015-08-20,820,5.5,2015,32199985,75759810,43559825,5
66,2.345821,100000000,93820758,-6179242,In the Heart of the Sea,Chris Hemsworth|Benjamin Walker|Cillian Murphy|Brendan Gleeson|Ben Whishaw,Ron Howard,122,Thriller|Drama|Adventure|Action|History,2015-11-20,805,6.4,2015,91999959,86315059,-5684900,6
68,2.331567,35000000,137935567,102935567,Creed,Michael B. Jordan|Sylvester Stallone|Graham McTavish|Tessa Thompson|Phylicia RashÄd,Ryan Coogler,133,Drama,2015-11-25,1171,7.3,2015,32199985,126900665,94700680,7
69,2.31767,35000000,140795793,105795793,Trainwreck,Amy Schumer|Bill Hader|Brie Larson|Colin Quinn|Vanessa Bayer,Judd Apatow,125,Comedy,2015-07-17,849,6.1,2015,32199985,129532072,97332087,6
70,2.29573,13000000,32848185,19848185,Eye in the Sky,Helen Mirren|Aaron Paul|Alan Rickman|Iain Glen|Barkhad Abdi,Gavin Hood,102,Drama|Thriller|War,2015-09-11,265,7.2,2015,11959994,30220316,18260322,7
71,2.28135,25000000,42972994,17972994,Legend,Tom Hardy|Emily Browning|Christopher Eccleston|David Thewlis|Taron Egerton,Brian Helgeland,131,Crime|Thriller,2015-09-09,619,6.7,2015,22999989,39535137,16535148,7
73,2.234573,150000000,128388320,-21611680,Pan,Levi Miller|Garrett Hedlund|Hugh Jackman|Rooney Mara|Amanda Seyfried,Joe Wright,111,Adventure|Family|Fantasy,2015-09-24,586,5.9,2015,137999939,118117202,-19882737,6
76,2.140199,99000000,246233113,147233113,The Peanuts Movie,Noah Schnapp|Bill Melendez|Venus Schultheis|Hadley Belle Miller|Madisyn Shipman,Steve Martino,88,Adventure|Animation|Comedy|Family,2015-11-05,414,6.4,2015,91079959,226534364,135454405,6
77,2.121884,35000000,48623572,13623572,Concussion,Will Smith|Bitsie Tulloch|Gugu Mbatha-Raw|Alec Baldwin|Matthew Willig,Peter Landesman,123,Drama,2015-11-12,500,6.9,2015,32199985,44733666,12533681,7
78,2.096273,25000000,52395996,27395996,The Night Before,Joseph Gordon-Levitt|Seth Rogen|Anthony Mackie|Lizzy Caplan|Jillian Bell,Jonathan Levine,100,Comedy,2015-11-20,363,6.1,2015,22999989,48204295,25204306,6
79,2.080935,2500000,5214043,2714043,Knock Knock,Keanu Reeves|Lorenza Izzo|Ana de Armas|Aaron Burns|Colleen Camp,Eli Roth,99,Drama|Horror|Thriller,2015-06-26,473,4.8,2015,2299998,4796917,2496919,5
80,2.070708,34000000,63013281,29013281,The Longest Ride,Scott Eastwood|Britt Robertson|Lolita Davidovich|Melissa Benoist|Jack Huston,"George Tillman, Jr.",128,Romance|Drama,2015-04-09,711,7.3,2015,31279986,57972193,26692207,7
81,2.060162,80000000,466183544,386183544,Hotel Transylvania 2,Adam Sandler|Andy Samberg|Selena Gomez|Kevin James|Steve Buscemi,Genndy Tartakovsky,89,Animation|Comedy|Family,2015-09-21,919,6.8,2015,73599967,428888671,355288704,7
82,2.055572,17000000,24000000,7000000,Love the Coopers,Steve Martin|Diane Keaton|John Goodman|Alan Arkin|Olivia Wilde,Jessie Nelson,107,Family|Comedy,2015-11-12,111,5.3,2015,15639993,22079990,6439997,5
83,2.049886,35000000,61181942,26181942,The Walk,Joseph Gordon-Levitt|Ben Kingsley|Charlotte Le Bon|Ben Schwartz|James Badge Dale,Robert Zemeckis,123,Adventure|Drama|Thriller,2015-09-30,706,6.8,2015,32199985,56287361,24087376,7
84,2.026651,11000000,1863315,-9136685,Tracers,Marie Avgeropoulos|Taylor Lautner|Adam Rayner|Rafi Gavron|Sam Medina,Daniel Benmayor,94,Action|Crime|Drama,2015-01-15,326,5.9,2015,10119995,1714249,-8405746,6
85,2.000338,31000000,104384188,73384188,Vacation,Ed Helms|Christina Applegate|Skyler Gisondo|Steele Stebbins|Chris Hemsworth,John Francis Daley|Jonathan M. Goldstein,99,Adventure|Comedy,2015-07-28,846,6.1,2015,28519987,96033410,67513423,6
86,1.984529,35000000,95437994,60437994,Poltergeist,Sam Rockwell|Rosemarie DeWitt|Saxon Sharbino|Kyle Catlett|Kennedi Clements,Gil Kenan,93,Horror|Thriller,2015-05-20,589,5.0,2015,32199985,87802915,55602930,5
87,1.980039,4000000,187112,-3812888,Maggie,Arnold Schwarzenegger|Abigail Breslin|Joely Richardson|Laura Cayouette|J.D. Evermore,Henry Hobson,95,Horror,2015-05-08,384,5.1,2015,3679998,172142,-3507856,5
89,1.95632,50000000,3324330,-46675670,Child 44,Tom Hardy|Gary Oldman|Noomi Rapace|Joel Kinnaman|Paddy Considine,Daniel Espinosa,137,Crime|Thriller,2015-03-15,341,5.9,2015,45999979,3058382,-42941597,6
90,1.926739,5000000,58978653,53978653,The Gift,Jason Bateman|Rebecca Hall|Joel Edgerton|David Denman|Beau Knapp,Joel Edgerton,108,Thriller|Mystery,2015-07-30,631,6.6,2015,4599997,54260336,49660339,7
91,1.904898,50000000,240360392,190360392,Daddy's Home,Will Ferrell|Mark Wahlberg|Linda Cardellini|Thomas Haden Church|Hannibal Buress,Sean Anders,96,Comedy,2015-12-25,568,5.7,2015,45999979,221131463,175131484,6
94,1.865007,64000000,97571250,33571250,The Little Prince,Jeff Bridges|Rachel McAdams|Paul Rudd|Marion Cotillard|James Franco,Mark Osborne,92,Adventure|Animation|Fantasy,2015-07-29,423,7.5,2015,58879974,89765510,30885536,7
96,1.82313,11930000,18340000,6410000,The Dressmaker,Kate Winslet|Liam Hemsworth|Caroline Goodall|Judy Davis|Hayley Magnus,Jocelyn Moorhouse,118,Drama,2015-10-01,197,6.9,2015,10975595,16872792,5897197,7
97,1.758618,8500000,43528634,35028634,The DUFF,Mae Whitman|Robbie Amell|Bella Thorne|Bianca A. Santos|Skyler Samuels,Ari Sandel,100,Romance|Comedy,2015-02-20,753,6.8,2015,7819996,40046325,32226329,7
98,1.742286,10000000,52882018,42882018,Sinister 2,Shannyn Sossamon|James Ransone|Tate Ellington|Nicholas King|Lucas Jade Zumann,Ciaran Foy,97,Horror,2015-08-19,331,5.5,2015,9199995,48651435,39451440,5
99,1.73518,30000000,107597242,77597242,Paul Blart: Mall Cop 2,Kevin James|Raini Rodriguez|Eduardo VerÃ¡stegui|Daniella Alonso|Neal McDonough,Andy Fickman,94,Action|Adventure|Comedy|Family,2015-04-16,422,5.3,2015,27599987,98989419,71389432,5
102,1.65107799999999,4000000,50163103,46163103,The Boy Next Door,Jennifer Lopez|Ryan Guzman|Ian Nelson|John Corbett|Kristin Chenoweth,Rob Cohen,91,Thriller,2015-01-23,810,3.9,2015,3679998,46150034,42470036,4
104,1.532997,30000000,49263404,19263404,Entourage,Jeremy Piven|Adrian Grenier|Jerry Ferrara|Kevin Connolly|Kevin Dillon,Doug Ellin,104,Comedy,2015-06-03,364,6.2,2015,27599987,45322311,17722324,6
105,1.510096,23000000,79799880,56799880,The Wedding Ringer,Kevin Hart|Josh Gad|Kaley Cuoco|Affion Crockett|Jorge Garcia,Jeremy Garelick,101,Comedy,2015-01-16,446,6.5,2015,21159990,73415857,52255867,6
106,1.499614,15000000,14860766,-139234,Scouts Guide to the Zombie Apocalypse,Tye Sheridan|Logan Miller|Joey Morgan|Sarah Dumont|David Koechner,Christopher B. Landon,93,Comedy|Horror,2015-10-23,288,6.2,2015,13799993,13671898,-128095,6
107,1.495112,5000000,98450062,93450062,The Visit,Olivia DeJonge|Ed Oxenbould|Kathryn Hahn|Benjamin Kanes|Deanna Dunagan,M. Night Shyamalan,94,Horror|Thriller,2015-09-10,729,5.9,2015,4599997,90574017,85974020,6
108,1.48324599999999,53000000,99775678,46775678,Black Mass,Johnny Depp|Joel Edgerton|Benedict Cumberbatch|Dakota Johnson|Kevin Bacon,Scott Cooper,122,Crime|Drama,2015-09-04,848,6.3,2015,48759978,91793583,43033605,6
109,1.449072,8900000,50136,-8849864,Heist,Jeffrey Dean Morgan|Robert De Niro|Kate Bosworth|Dave Bautista|Gina Carano,Scott Mann,93,Crime|Action|Thriller,2015-11-13,233,5.4,2015,8187996,46125,-8141871,5
110,1.448002,15000000,61548707,46548707,Krampus,Adam Scott|Toni Collette|Allison Tolman|David Koechner|Emjay Anthony,Michael Dougherty,98,Horror|Comedy|Fantasy,2015-11-26,342,5.9,2015,13799993,56624785,42824792,6
111,1.443406,20000000,208588,-19791412,Dark Places,Charlize Theron|Nicholas Hoult|Christina Hendricks|ChloÃ« Grace Moretz|Tye Sheridan,Gilles Paquet-Brenner,113,Drama|Mystery|Thriller,2015-03-31,322,5.7,2015,18399991,191900,-18208091,6
112,1.41239,5000000,54418872,49418872,No Escape,Owen Wilson|Lake Bell|Pierce Brosnan|Sterling Jerins|Spencer Garrett,John Erick Dowdle,103,Action|Thriller,2015-08-26,519,6.7,2015,4599997,50065340,45465343,7
113,1.40805,700000,17986781,17286781,Dope,Shameik Moore|Kiersey Clemons|Tony Revolori|ZoÃ« Kravitz|Chanel Iman,Rick Famuyiwa,103,Crime|Drama|Comedy,2015-06-19,448,7.3,2015,643999,16547831,15903832,7
114,1.388251,28000000,28208085,208085,American Ultra,Jesse Eisenberg|Kristen Stewart|Topher Grace|Connie Britton|Walton Goggins,Nima Nourizadeh,96,Comedy|Action,2015-08-19,695,5.9,2015,25759988,25951426,191438,6
115,1.388032,11000000,61619773,50619773,Woman in Gold,Helen Mirren|Ryan Reynolds|Tatiana Maslany|Katie Holmes|Max Irons,Simon Curtis,120,Drama,2015-04-10,277,7.3,2015,10119995,56690166,46570171,7
117,1.376605,30000000,105011053,75011053,Sisters,Tina Fey|Amy Poehler|John Leguizamo|Ike Barinholtz|Maya Rudolph,Jason Moore,118,Comedy,2015-12-18,399,5.9,2015,27599987,96610126,69010139,6
118,1.360926,12000000,32248241,20248241,Project Almanac,Jonny Weston|Virginia Gardner|Sofia Black-D'Elia|Sam Lerner|Allen Evangelista,Dean Israelite,106,Science Fiction|Thriller,2015-01-30,637,6.3,2015,11039995,29668368,18628373,6
120,1.355822,25000000,72629670,47629670,The Transporter Refueled,Ed Skrein|Ray Stevenson|Loan Chabanol|Gabriella Wright|Tatjana PajkoviÄ‡,Camille Delamarre,96,Thriller|Action|Crime,2015-09-03,407,5.3,2015,22999989,66819266,43819277,5
121,1.345982,55000000,74679822,19679822,Crimson Peak,Mia Wasikowska|Jessica Chastain|Tom Hiddleston|Charlie Hunnam|Jim Beaver,Guillermo del Toro,119,Mystery|Thriller|Fantasy|Horror|Drama,2015-10-13,819,6.4,2015,50599977,68705406,18105429,6
123,1.338481,14800000,122413057,107613057,Magic Mike XXL,Channing Tatum|Matt Bomer|Joe Manganiello|Kevin Nash|Adam RodrÃ­guez,Gregory Jacobs,115,Comedy|Drama|Music,2015-07-01,501,6.3,2015,13615994,112619962,99003968,6
124,1.338322,10000000,78099553,68099553,Paranormal Activity: The Ghost Dimension,Chris J. Murray|Brit Shaw|Ivy George|Lauren Frandsen|Tyler Craig,Gregory Plotkin,88,Horror|Thriller,2015-10-21,267,5.0,2015,9199995,71851557,62651562,5
126,1.316239,15000000,8235661,-6764339,Trumbo,Bryan Cranston|Diane Lane|Helen Mirren|Elle Fanning|Louis C.K.,Jay Roach,124,Drama,2015-10-27,273,7.2,2015,13799993,7576804,-6223189,7
127,1.315266,19500000,32189727,12689727,Secret in Their Eyes,Chiwetel Ejiofor|Nicole Kidman|Julia Roberts|Dean Norris|Lyndon Smith,Billy Ray,111,Crime|Drama|Mystery,2015-10-14,202,6.2,2015,17939992,29614535,11674543,6
129,1.291013,74000000,311594032,237594032,The SpongeBob Movie: Sponge Out of Water,Tom Kenny|Bill Fagerbakke|Rodger Bumpass|Clancy Brown|Carolyn Lawrence,Paul Tibbitt,93,Family|Animation,2015-02-05,533,5.7,2015,68079970,286666383,218586413,6
131,1.278928,20000000,43967255,23967255,Max,Thomas Haden Church|Josh Wiggins|Lauren Graham|Robbie Amell|Mia Xitlali,Boaz Yakin,111,Adventure|Drama|Family,2015-06-26,214,7.0,2015,18399991,40449856,22049865,7
135,1.225325,40000000,10664749,-29335251,The Gunman,Sean Penn|Jasmine Trinca|Javier Bardem|Ray Winstone|Mark Rylance,Pierre Morel,115,Action|Drama|Crime,2015-02-16,283,5.6,2015,36799983,9811564,-26988419,6
136,1.191138,1000000,62882090,61882090,Unfriended,Shelley Hennig|Moses Jacob Storm|Renee Olstead|William Peltz|Jacob Wysocki,Levan Gabriadze,82,Horror|Thriller,2015-04-17,643,5.6,2015,919999,57851497,56931498,6
137,1.178831,35000000,51680201,16680201,Hot Pursuit,Reese Witherspoon|SofÃ­a Vergara|Michael Mosley|John Carroll Lynch|Richard T. Jones,Anne Fletcher,87,Action|Crime|Comedy,2015-05-08,472,5.5,2015,32199985,47545763,15345778,5
138,1.164724,10000000,104303851,94303851,Insidious: Chapter 3,Dermot Mulroney|Stefanie Scott|Lin Shaye|Leigh Whannell|Angus Sampson,Leigh Whannell,97,Drama|Horror|Thriller,2015-06-04,610,6.3,2015,9199995,95959500,86759505,6
141,1.142518,6000000,41387687,35387687,The Lady in the Van,Maggie Smith|Alex Jennings|Frances de la Tour|Gwen Taylor|Dominic Cooper,Nicholas Hytner,104,Comedy|Drama,2015-11-13,135,5.9,2015,5519997,38076655,32556658,6
142,1.138395,40000000,34227298,-5772702,Victor Frankenstein,James McAvoy|Daniel Radcliffe|Jessica Brown Findlay|Andrew Scott|Charles Dance,Paul McGuigan,109,Drama|Science Fiction|Thriller,2015-11-10,408,5.5,2015,36799983,31489100,-5310883,5
144,1.125239,8000000,3759286,-4240714,Anomalisa,Jennifer Jason Leigh|David Thewlis|Tom Noonan,Duke Johnson|Charlie Kaufman,90,Animation|Comedy|Drama|Romance,2015-12-30,259,6.7,2015,7359996,3458541,-3901455,7
150,1.03839,2000000,1477002,-522998,The Diary of a Teenage Girl,Bel Powley|Kristen Wiig|Alexander SkarsgÃ¥rd|Christopher Meloni|Margarita Levieva,Marielle Heller,102,Drama|Romance,2015-08-07,186,6.8,2015,1839999,1358841,-481158,7
155,1.007054,11000000,27391084,16391084,Irrational Man,Emma Stone|Joaquin Phoenix|Jamie Blackley|Parker Posey|Meredith Hagner,Woody Allen,95,Mystery|Drama,2015-07-17,319,6.1,2015,10119995,25199786,15079791,6
157,0.956096,18000000,41325328,23325328,Ricki and the Flash,Meryl Streep|Kevin Kline|Mamie Gummer|Sebastian Stan|Audra McDonald,Jonathan Demme,100,Comedy|Drama|Music,2015-07-10,152,5.5,2015,16559992,38019285,21459293,5
160,0.950793,12000000,60273173,48273173,The Perfect Guy,Michael Ealy|Sanaa Lathan|Morris Chestnut|Kathryn Morris|Rutina Wesley,David M. Rosenthal,100,Drama|Thriller,2015-09-11,122,5.6,2015,11039995,55451294,44411299,6
162,0.93762,10000000,7587485,-2412515,While We're Young,Ben Stiller|Naomi Watts|Adam Driver|Amanda Seyfried|Charles Grodin,Noah Baumbach,97,Drama|Comedy,2015-03-27,265,5.9,2015,9199995,6980483,-2219512,6
163,0.927339,40000000,106511453,66511453,Get Hard,Will Ferrell|Kevin Hart|Alison Brie|Craig T. Nelson|T.I.,Etan Cohen,100,Comedy,2015-03-26,661,5.9,2015,36799983,97990493,61190510,6
167,0.906036,25000000,24902723,-97277,The 33,Antonio Banderas|Rodrigo Santoro|Juliette Binoche|James Brolin|Lou Diamond Phillips,Patricia Riggen,120,History|Drama,2015-08-06,262,5.8,2015,22999989,22910495,-89494,6
168,0.898295999999999,14000000,16002420,2002420,Suffragette,Carey Mulligan|Helena Bonham Carter|Meryl Streep|Ben Whishaw|Brendan Gleeson,Sarah Gavron,106,Drama|History,2015-10-16,231,7.1,2015,12879994,14722219,1842225,7
170,0.880937999999999,6000000,11122090,5122090,We Are Your Friends,Zac Efron|Emily Ratajkowski|Wes Bentley|Nick Rotteveel|Alessandro Lindblad,Max Joseph,96,Drama|Music|Romance,2015-08-26,412,6.2,2015,5519997,10232318,4712321,6
179,0.832487,10000000,85978266,75978266,The Second Best Exotic Marigold Hotel,Dev Patel|Judi Dench|Richard Gere|Maggie Smith|Bill Nighy,John Madden,122,Drama|Comedy,2015-02-26,196,6.4,2015,9199995,79099969,69899974,6
180,0.829111,20000000,6420319,-13579681,Little Boy,Jakob Salvati|Emily Watson|Cary-Hiroyuki Tagawa|Michael Rapaport|David Henrie,Alejandro Monteverde,106,Comedy|Drama|War,2015-04-23,113,7.1,2015,18399991,5906690,-12493301,7
183,0.814206,37000000,26250020,-10749980,Aloha,Bradley Cooper|Emma Stone|Rachel McAdams|John Krasinski|Bill Murray,Cameron Crowe,105,Adventure|Comedy|Romance,2015-05-27,469,5.2,2015,34039985,24150007,-9889978,5
186,0.795762,28000000,7002261,-20997739,Our Brand Is Crisis,Sandra Bullock|Anthony Mackie|Billy Bob Thornton|Zoe Kazan|Scoot McNairy,David Gordon Green,108,Drama|Comedy,2015-09-11,122,5.7,2015,25759988,6442077,-19317911,6
200,0.706023,7000000,573335,-6426665,Freeheld,Julianne Moore|Ellen Page|Steve Carell|Michael Shannon|Luke Grimes,Peter Sollett,103,Romance|Drama,2015-10-02,86,7.1,2015,6439997,527467,-5912530,7
202,0.699932,3000000,695269,-2304731,Love,Karl Glusman|Aomi Muyock|Klara Kristin|Juan Saavedra|Gaspar NoÃ©,Gaspar NoÃ©,134,Drama|Romance,2015-07-06,307,4.7,2015,2759998,639647,-2120351,5
203,0.69957,9600000,2541554,-7058446,Truth,Robert Redford|Cate Blanchett|Elisabeth Moss|Topher Grace|Dennis Quaid,James Vanderbilt,121,Drama,2015-09-12,89,6.4,2015,8831996,2338228,-6493768,6
205,0.690479,10000000,10835752,835752,Danny Collins,Al Pacino|Annette Bening|Jennifer Garner|Bobby Cannavale|Christopher Plummer,Dan Fogelman,107,Comedy|Drama|Music,2015-03-20,114,6.6,2015,9199995,9968887,768892,7
206,0.689578999999999,15000000,3020664,-11979336,Rock the Kasbah,Bill Murray|Zooey Deschanel|Bruce Willis|Kate Hudson|Taylor Kinney,Barry Levinson,100,Comedy|Music|War,2015-10-22,56,5.1,2015,13799993,2779009,-11020984,5
208,0.673792,1000000,14444999,13444999,"Hello, My Name Is Doris",Sally Field|Max Greenfield|Beth Behrs|Stephen Root|Natasha Lyonne,Michael Showalter,95,Comedy|Drama|Romance,2015-11-27,87,6.6,2015,919999,13289393,12369394,7
209,0.669351,13000000,1784763,-11215237,The Vatican Tapes,Olivia Taylor Dudley|Michael PeÃ±a|Djimon Hounsou|Dougray Scott|Peter Andersson,Mark Neveldine,91,Thriller|Horror,2015-07-24,164,4.5,2015,11959994,1641981,-10318013,4
210,0.661471,8000000,1411927,-6588073,99 Homes,Andrew Garfield|Laura Dern|Michael Shannon|Tim Guinee|J.D. Evermore,Ramin Bahrani,112,Drama,2015-09-25,121,6.8,2015,7359996,1298972,-6061024,7
211,0.661163,14000000,12314651,-1685349,Hot Tub Time Machine 2,Rob Corddry|Craig Robinson|Clark Duke|Adam Scott|Chevy Chase,Steve Pink,93,Comedy,2015-02-20,244,5.0,2015,12879994,11329473,-1550521,5
213,0.654046,4000000,143101,-3856899,Manglehorn,Al Pacino|Chris Messina|Holly Hunter|Harmony Korine|Natalie Wilemon,David Gordon Green,97,Drama,2015-06-03,35,5.0,2015,3679998,131652,-3548346,5
223,0.602165,8000000,35991087,27991087,A Walk in the Woods,Robert Redford|Nick Nolte|Emma Thompson|Nick Offerman|Kristen Schaal,Ken Kwapis,104,Drama|Adventure|Comedy,2015-09-02,171,5.4,2015,7359996,33111785,25751789,5
225,0.599655,3300000,64110728,60810728,The Lazarus Effect,Olivia Wilde|Mark Duplass|Donald Glover|Evan Peters|Sarah Bolger,David Gelb,83,Thriller|Horror,2015-01-29,327,4.9,2015,3035998,58981843,55945845,5
229,0.577814,35000000,14431253,-20568747,Unfinished Business,Vince Vaughn|Dave Franco|James Marsden|June Diane Raphael|Sienna Miller,Ken Scott,90,Comedy,2015-03-05,241,4.9,2015,32199985,13276746,-18923239,5
230,0.570743999999999,2000000,45431,-1954569,Lost River,Christina Hendricks|Saoirse Ronan|Eva Mendes|Matt Smith|Iain De Caestecker,Ryan Gosling,95,Fantasy|Thriller,2015-04-08,129,5.7,2015,1839999,41796,-1798203,6
242,0.532205,100000,42664410,42564410,The Gallows,Cassidy Gifford|Ryan Shoos|Pfeifer Brown|Reese Mishler|Price T. Morgan,Travis Cluff|Chris Lofing,87,Horror|Thriller,2015-07-10,247,5.0,2015,91999,39251239,39159240,5
246,0.524315,10000000,3334927,-6665073,By the Sea,Angelina Jolie|Brad Pitt|MÃ©lanie Laurent|Melvil Poupaud|Niels Arestrup,Angelina Jolie,122,Drama|Romance,2015-11-12,82,5.4,2015,9199995,3068131,-6131864,5
270,0.46209,9000000,21571189,12571189,Black or White,Kevin Costner|Jennifer Ehle|Gillian Jacobs|Octavia Spencer|Bill Burr,Mike Binder,121,Drama,2015-01-30,72,6.7,2015,8279996,19845485,11565489,7
274,0.450872,13000000,1646788,-11353212,I Saw the Light,Tom Hiddleston|Elizabeth Olsen|David Krumholtz|Bradley Whitford|Maddie Hasson,Marc Abraham,123,Drama|Music,2015-09-11,19,5.6,2015,11959994,1515044,-10444950,6
287,0.435582,5000000,2333684,-2666316,Jem and the Holograms,Aubrey Peeples|Stefanie Scott|Aurora Perrineau|Hayley Kiyoko|Barnaby Carpenter,Jon M. Chu,119,Drama|Music|Adventure|Fantasy,2015-10-22,69,5.7,2015,4599997,2146988,-2453009,6
291,0.424813,6000000,90777,-5909223,Beasts of No Nation,Idris Elba|Opeyemi Fagbohungbe|Abraham Attah|Richard Pepple|Ama K. Abebrese,Cary Fukunaga,137,Drama|War,2015-09-11,306,7.5,2015,5519997,83514,-5436483,7
297,0.414913,3000000,3387000,387000,Demonic,Maria Bello|Frank Grillo|Cody Horn|Dustin Milligan|Megan Park,Will Canon,83,Thriller|Horror,2015-02-12,91,5.0,2015,2759998,3116038,356040,5
304,0.402236,447524,771317,323793,The D Train,Jack Black|James Marsden|Kathryn Hahn|Jeffrey Tambor|Mike White,Andrew Mogel|Jarrad Paul,101,Drama|Comedy,2015-05-08,47,4.2,2015,411721,709611,297890,4
331,0.365901,10000000,17472,-9982528,Strangerland,Nicole Kidman|Joseph Fiennes|Hugo Weaving|Lisa Flanagan|Megan Alston,Kim Farrant,111,Drama|Thriller,2015-07-01,48,5.0,2015,9199995,16074,-9183921,5
350,0.336107,2000000,2801508,801508,Captive,Kate Mara|David Oyelowo|Michael Kenneth Williams|Mimi Rogers|Leonor Varela,Jerry Jameson,97,Crime|Drama|Thriller,2015-09-17,55,5.7,2015,1839999,2577386,737387,6
380,0.298751,5000000,4842699,-157301,90 Minutes in Heaven,Kate Bosworth|Hayden Christensen|Hudson Meek|Bobby Batson|Elizabeth Hunter,Michael Polish,121,Drama,2015-09-11,24,5.7,2015,4599997,4455281,-144716,6
409,0.259794,600000,7087452,6487452,Grandma,Lily Tomlin|Julia Garner|Marcia Gay Harden|Judy Greer|Laverne Cox,Paul Weitz,78,Drama|Comedy,2015-06-04,81,5.6,2015,551999,6520452,5968453,6
492,0.731022,3000000,67790117,64790117,War Room,Priscilla C. Shirer|T.C. Stallings|Karen Abercrombie|Beth Moore|Michael Jr.,Alex Kendrick,120,Drama,2015-08-28,57,6.9,2015,2759998,62366880,59606882,7
583,0.076109,13500000,187674,-13312326,Stonewall,Jeremy Irvine|Jonny Beauchamp|Jonathan Rhys Meyers|Ron Perlman|Caleb Landry Jones,Roland Emmerich,129,Drama,2015-09-18,14,5.6,2015,12419994,172660,-12247334,6
629,24.949134,165000000,621752480,456752480,Interstellar,Matthew McConaughey|Jessica Chastain|Anne Hathaway|Michael Caine|Casey Affleck,Christopher Nolan,169,Adventure|Drama|Science Fiction,2014-11-05,6498,8.0,2014,151980023,572690645,420710622,8
630,14.311205,170000000,773312399,603312399,Guardians of the Galaxy,Chris Pratt|Zoe Saldana|Dave Bautista|Vin Diesel|Bradley Cooper,James Gunn,121,Action|Science Fiction|Adventure,2014-07-30,5612,7.9,2014,156585478,712291130,555705652,8
631,12.971027,170000000,714766572,544766572,Captain America: The Winter Soldier,Chris Evans|Scarlett Johansson|Sebastian Stan|Samuel L. Jackson|Robert Redford,Joe Russo|Anthony Russo,136,Action|Adventure|Science Fiction,2014-03-20,3848,7.6,2014,156585478,658365092,501779614,8
632,11.422751,20000000,78739897,58739897,John Wick,Keanu Reeves|Michael Nyqvist|Alfie Allen|Willem Dafoe|Dean Winters,Chad Stahelski|David Leitch,101,Action|Thriller,2014-10-22,2712,7.0,2014,18421821,72526614,54104793,7
633,10.739009,125000000,752100229,627100229,The Hunger Games: Mockingjay - Part 1,Jennifer Lawrence|Josh Hutcherson|Liam Hemsworth|Woody Harrelson|Donald Sutherland,Francis Lawrence,123,Science Fiction|Adventure|Thriller,2014-11-18,3590,6.6,2014,115136381,692752790,577616409,7
634,10.174599,250000000,955119788,705119788,The Hobbit: The Battle of the Five Armies,Martin Freeman|Ian McKellen|Richard Armitage|Ken Stott|Graham McTavish,Peter Jackson,144,Adventure|Fantasy,2014-12-10,3110,7.1,2014,230272762,879752289,649479527,7
635,8.691294,165000000,652105443,487105443,Big Hero 6,Scott Adsit|Ryan Potter|Daniel Henney|T.J. Miller|Jamie Chung,Don Hall|Chris Williams,102,Adventure|Family|Animation|Action|Comedy,2014-10-24,4185,7.8,2014,151980023,600648487,448668464,8
636,8.110711,14000000,233555708,219555708,The Imitation Game,Benedict Cumberbatch|Keira Knightley|Matthew Goode|Rory Kinnear|Allen Leech,Morten Tyldum,113,History|Drama|Thriller|War,2014-11-14,3478,8.0,2014,12895274,215126072,202230798,8
637,7.137273,34000000,348319861,314319861,The Maze Runner,Dylan O'Brien|Ki Hong Lee|Kaya Scodelario|Aml Ameen|Blake Cooper,Wes Ball,113,Action|Mystery|Science Fiction|Thriller,2014-09-10,3425,7.0,2014,31317095,320834306,289517211,7
638,6.90714799999999,18000000,103215094,85215094,Birdman,Michael Keaton|Zach Galifianakis|Edward Norton|Emma Stone|Naomi Watts,Alejandro GonzÃ¡lez IÃ±Ã¡rritu,119,Drama|Comedy,2014-10-17,2801,7.3,2014,16579638,95070499,78490861,7
639,6.438727,61000000,369330363,308330363,Gone Girl,Ben Affleck|Rosamund Pike|Carrie Coon|Neil Patrick Harris|Tyler Perry,David Fincher,145,Mystery|Thriller|Drama,2014-10-01,3720,7.9,2014,56186554,340186892,284000338,8
640,6.415818,68000000,211817906,143817906,Fury,Brad Pitt|Shia LaBeouf|Logan Lerman|Michael PeÃ±a|Jon Bernthal,David Ayer,135,War|Drama|Action,2014-10-15,2572,7.4,2014,62634191,195103577,132469386,7
641,6.286692,127000000,349424282,222424282,Night at the Museum: Secret of the Tomb,Ben Stiller|Rami Malek|Rebel Wilson|Robin Williams|Owen Wilson,Shawn Levy,97,Adventure|Comedy|Fantasy|Family,2014-12-17,1111,6.1,2014,116978563,321851579,204873016,6
642,6.14502,85000000,288747895,203747895,Divergent,Shailene Woodley|Theo James|Kate Winslet|Miles Teller|Ray Stevenson,Neil Burger,139,Action|Science Fiction|Thriller,2014-03-14,3038,6.9,2014,78292739,265963102,187670363,7
643,6.052479,250000000,746000000,496000000,X-Men: Days of Future Past,Hugh Jackman|James McAvoy|Patrick Stewart|Michael Fassbender|Ian McKellen,Bryan Singer,131,Action|Adventure|Fantasy|Science Fiction,2014-05-15,4006,7.6,2014,230272762,687133923,456861161,8
644,5.947136,40000000,463360063,423360063,Lucy,Scarlett Johansson|Morgan Freeman|Choi Min-sik|Amr Waked|Julian Rhind-Tutt,Luc Besson,89,Action|Science Fiction,2014-07-14,3699,6.3,2014,36843642,426796807,389953165,6
645,5.787396,125000000,477200000,352200000,Teenage Mutant Ninja Turtles,Megan Fox|Will Arnett|William Fichtner|Alan Ritchson|Noel Fisher,Jonathan Liebesman,101,Science Fiction|Action|Adventure|Fantasy|Comedy,2014-08-07,1836,5.8,2014,115136381,439544649,324408268,6
646,5.701683,40000000,126069509,86069509,Sex Tape,Cameron Diaz|Jason Segel|Rob Corddry|Ellie Kemper|Rob Lowe,Jake Kasdan,97,Comedy,2014-07-17,1150,5.3,2014,36843642,116121496,79277854,5
647,5.522641,8500000,38697217,30197217,Nightcrawler,Jake Gyllenhaal|Rene Russo|Riz Ahmed|Bill Paxton|Kevin Rahm,Dan Gilroy,117,Crime|Drama|Thriller,2014-10-23,2087,7.6,2014,7829273,35643660,27814387,8
648,4.983782,210000000,245500000,35500000,Transformers: Age of Extinction,Mark Wahlberg|Stanley Tucci|Nicola Peltz|Jack Reynor|Li Bingbing,Michael Bay,165,Science Fiction|Action|Adventure,2014-06-25,2161,5.9,2014,193429120,226127852,32698732,6
649,4.93082,30000000,174600318,144600318,The Grand Budapest Hotel,Ralph Fiennes|Tony Revolori|F. Murray Abraham|Mathieu Amalric|Adrien Brody,Wes Anderson,99,Comedy|Drama,2014-02-26,2802,7.9,2014,27632731,160822790,133190059,8
650,4.780419,3300000,13993093,10693093,Whiplash,Miles Teller|J.K. Simmons|Melissa Benoist|Austin Stowell|Jayson Blair,Damien Chazelle,105,Drama|Music,2014-10-10,2372,8.2,2014,3039600,12888912,9849312,8
651,4.452507,170000000,708200000,538200000,Dawn of the Planet of the Apes,Andy Serkis|Jason Clarke|Toby Kebbell|Keri Russell|Judy Greer,Matt Reeves,130,Science Fiction|Action|Drama|Thriller,2014-06-26,2625,7.4,2014,156585478,652316682,495731204,7
652,4.145209,55000000,192330738,137330738,The Equalizer,Denzel Washington|Marton Csokas|ChloÃ« Grace Moretz|David Harbour|Haley Bennett,Antoine Fuqua,132,Thriller|Action|Crime,2014-09-24,2100,7.2,2014,50660007,177154121,126494114,7
653,4.105685,42000000,106645357,64645357,Horrible Bosses 2,Jason Bateman|Jason Sudeikis|Charlie Day|Jennifer Aniston|Kevin Spacey,Sean Anders,108,Comedy,2014-11-26,1033,6.1,2014,38685824,98230083,59544259,6
654,4.101979,200000000,705717432,505717432,The Amazing Spider-Man 2,Andrew Garfield|Emma Stone|Jamie Foxx|Dane DeHaan|Colm Feore,Marc Webb,142,Action|Adventure|Fantasy,2014-04-16,2813,6.6,2014,184218210,650030010,465811800,7
655,3.990452,178000000,370541256,192541256,Edge of Tomorrow,Tom Cruise|Emily Blunt|Brendan Gleeson|Bill Paxton|Jonas Armstrong,Doug Liman,113,Action|Science Fiction,2014-05-27,3267,7.7,2014,163954207,341302234,177348027,8
656,3.989231,44000000,11305175,-32694825,The Interview,James Franco|Seth Rogen|Lizzy Caplan|Randall Park|Diana Bang,Evan Goldberg|Seth Rogen,112,Action|Comedy,2014-12-25,1657,6.1,2014,40528006,10413095,-30114911,6
657,3.863074,58800000,542307423,483507423,American Sniper,Bradley Cooper|Sienna Miller|Kyle Gallner|Cole Konis|Ben Reed,Clint Eastwood,134,War|Action,2014-12-11,3004,7.5,2014,54160153,499514514,445354361,7
658,3.81374,140000000,268031828,128031828,Exodus: Gods and Kings,Christian Bale|Joel Edgerton|John Turturro|Aaron Paul|Ben Mendelsohn,Ridley Scott,153,Adventure|Drama|Action,2014-12-03,1377,5.6,2014,128952747,246881718,117928971,6
659,3.689601,160000000,529076069,369076069,Godzilla,Aaron Taylor-Johnson|Ken Watanabe|Elizabeth Olsen|Bryan Cranston|Juliette Binoche,Gareth Edwards,123,Action|Science Fiction|Thriller,2014-05-14,2169,6.2,2014,147374568,487327232,339952664,6
660,3.582315,180000000,758410378,578410378,Maleficent,Angelina Jolie|Elle Fanning|Juno Temple|Sharlto Copley|Isobelle Molloy,Robert Stromberg,97,Fantasy|Adventure|Action|Family|Romance,2014-05-28,2928,7.0,2014,165796389,698565011,532768622,7
661,3.573028,15000000,32556119,17556119,The November Man,Pierce Brosnan|Luke Bracey|Olga Kurylenko|Bill Smitrovich|Amila Terzimehic,Roger Donaldson,108,Crime|Action|Thriller,2014-08-27,481,6.0,2014,13816365,29987149,16170784,6
662,3.489314,5000000,102529779,97529779,Ouija,Olivia Cooke|Ana Coto|Daren Kagasoff|Bianca A. Santos|Douglas Smith,Stiles White,89,Horror,2014-10-24,569,4.9,2014,4605455,94439261,89833806,5
663,3.489106,145000000,609123048,464123048,How to Train Your Dragon 2,Jay Baruchel|Gerard Butler|Kristen Wiig|Jonah Hill|Cate Blanchett,Dean DeBlois,102,Fantasy|Action|Adventure|Animation|Comedy,2014-06-12,2152,7.7,2014,133558202,561057788,427499586,8
664,3.393741,2000000,13500000,11500000,It Follows,Maika Monroe|Keir Gilchrist|Olivia Luccardi|Lili Sepe|Bailey Spry,David Robert Mitchell,100,Thriller|Horror,2014-08-27,1003,6.6,2014,1842182,12434729,10592547,7
665,3.34625,90000000,206172544,116172544,The Expendables 3,Sylvester Stallone|Jason Statham|Harrison Ford|Arnold Schwarzenegger|Mel Gibson,Patrick Hughes,127,Action|Adventure|Thriller,2014-08-04,1275,6.2,2014,82898194,189903685,107005491,6
666,3.327799,60000000,469160692,409160692,The Lego Movie,Will Arnett|Elizabeth Banks|Craig Berry|Alison Brie|David Burrows,Phil Lord|Christopher Miller,100,Adventure|Fantasy|Animation|Comedy|Action,2014-02-06,2268,7.5,2014,55265463,432139714,376874251,7
668,3.260581,95000000,114178613,19178613,Seventh Son,Jeff Bridges|Julianne Moore|Ben Barnes|Alicia Vikander|Kit Harington,Sergey Bodrov,102,Adventure|Fantasy,2014-12-12,675,5.1,2014,87503649,105168898,17665249,5
669,3.170271,15000000,121201940,106201940,The Theory of Everything,Eddie Redmayne|Felicity Jones|Harry Lloyd|David Thewlis|Emily Watson,James Marsh,123,Drama|Romance,2014-11-26,1960,7.8,2014,13816365,111638022,97821657,8
670,3.14993,17000000,136621271,119621271,Let's Be Cops,Jake Johnson|Damon Wayans Jr.|Nina Dobrev|Rob Riggle|James D'Arcy,Luke Greenfield,104,Comedy,2014-08-13,912,6.4,2014,15658547,125840630,110182083,6
671,3.028769,70000000,215529201,145529201,Dracula Untold,Luke Evans|Sarah Gadon|Dominic Cooper|Art Parkinson|Charles Dance,Gary Shore,92,Horror|Action|Drama|Fantasy|War,2014-10-01,1666,6.1,2014,64476373,198522018,134045645,6
672,3.007018,132000000,373552094,241552094,Penguins of Madagascar,Tom McGrath|Chris Miller|Christopher Knights|Conrad Vernon|John Malkovich,Simon J. Smith|Eric Darnell,92,Family|Animation|Adventure|Comedy,2014-11-22,939,6.5,2014,121584018,344075490,222491472,6
673,2.996038,50000000,212902372,162902372,Into the Woods,Meryl Streep|Emily Blunt|James Corden|Anna Kendrick|Chris Pine,Rob Marshall,125,Fantasy|Comedy|Music,2014-12-25,1095,5.6,2014,46054552,196102469,150047917,6
674,2.979181,110000000,337580051,227580051,300: Rise of an Empire,Sullivan Stapleton|Eva Green|Lena Headey|Callan Mulvey|David Wenham,Noam Murro,102,Action|War,2014-03-05,1664,6.1,2014,101320015,310941963,209621948,6
675,2.881991,25000000,66980456,41980456,The Giver,Jeff Bridges|Meryl Streep|Brenton Thwaites|Odeya Rush|Alexander SkarsgÃ¥rd,Phillip Noyce,94,Drama|Science Fiction,2014-08-11,1151,6.3,2014,23027276,61695098,38667822,6
676,2.805019,50000000,188441614,138441614,22 Jump Street,Jonah Hill|Channing Tatum|Dave Franco|Ice Cube|Nick Offerman,Phil Lord|Christopher Miller,112,Crime|Comedy|Action,2014-06-05,2416,7.0,2014,46054552,173571884,127517332,7
677,2.777996,28000000,53181600,25181600,A Walk Among the Tombstones,Liam Neeson|Dan Stevens|David Harbour|Boyd Holbrook|Adam David Thompson,Scott Frank,113,Crime|Drama|Mystery|Thriller,2014-09-18,823,6.2,2014,25790549,48985095,23194546,6
678,2.721864,55000000,259207227,204207227,Paddington,Nicole Kidman|Peter Capaldi|Ben Whishaw|Michael Gambon|Imelda Staunton,Paul King,95,Comedy,2014-11-27,606,7.1,2014,50660007,238753457,188093450,7
679,2.692691,7000000,2360281,-4639719,Cake,Jennifer Aniston|Anna Kendrick|William H. Macy|Adriana Barraza|Felicity Huffman,Daniel Barnz,102,Drama,2014-09-07,255,6.1,2014,6447637,2174033,-4273604,6
680,2.67235,11000000,45967935,34967935,Chef,Jon Favreau|John Leguizamo|Bobby Cannavale|Emjay Anthony|Scarlett Johansson,Jon Favreau,115,Comedy,2014-05-08,866,7.2,2014,10132001,42340653,32208652,7
681,2.611251,9000000,108782847,99782847,The Purge: Anarchy,Frank Grillo|Carmen Ejogo|Zach Gilford|Kiele Sanchez|ZoÃ« Borde,James DeMonaco,104,Horror|Thriller,2014-07-17,1126,6.6,2014,8289819,100198906,91909087,7
682,2.601775,16000000,19682924,3682924,Left Behind,Nicolas Cage|Chad Michael Murray|Lea Thompson|Nicky Whelan|Martin Klebba,Vic Armstrong,110,Thriller|Action|Science Fiction,2014-10-03,253,3.8,2014,14737456,18129765,3392309,4
683,2.595951,4000000,44349000,40349000,Boyhood,Ellar Coltrane|Patricia Arquette|Ethan Hawke|Elijah Smith|Lorelei Linklater,Richard Linklater,164,Drama,2014-06-05,1343,7.6,2014,3684364,40849467,37165103,8
684,2.576396,20000000,12007070,-7992930,A Most Violent Year,Oscar Isaac|Jessica Chastain|Albert Brooks|Elyes Gabel|David Oyelowo,J.C. Chandor,125,Action|Thriller|Crime|Drama,2014-12-30,384,6.4,2014,18421821,11059604,-7362217,6
685,2.549403,100000000,243400000,143400000,Hercules,Dwayne Johnson|Ian McShane|John Hurt|Rufus Sewell|Aksel Hennie,Brett Ratner,99,Action|Adventure,2014-07-23,1215,5.6,2014,92109105,224193561,132084456,6
686,2.526779,125000000,362637473,237637473,Noah,Russell Crowe|Jennifer Connelly|Emma Watson|Logan Lerman|Anthony Hopkins,Darren Aronofsky,139,Drama|Adventure,2014-03-20,1589,5.5,2014,115136381,334022131,218885750,5
687,2.523101,50000000,83719388,33719388,The Judge,Robert Downey Jr.|Robert Duvall|Vera Farmiga|Vincent D'Onofrio|Jeremy Strong,David Dobkin,141,Drama,2014-10-08,974,7.2,2014,46054552,77113179,31058627,7
689,2.445165,40000000,123494610,83494610,Blended,Drew Barrymore|Adam Sandler|Wendi McLendon-Covey|Bella Thorne|Terry Crews,Frank Coraci,117,Comedy,2014-05-21,720,6.7,2014,36843642,113749780,76906138,7
690,2.376309,18000000,268157400,250157400,Neighbors,Seth Rogen|Zac Efron|Rose Byrne|Dave Franco|Ike Barinholtz,Nicholas Stoller,96,Comedy,2014-05-08,1829,6.2,2014,16579638,246997381,230417743,6
691,2.361267,11000000,78874843,67874843,If I Stay,ChloÃ« Grace Moretz|Jamie Blackley|Liana Liberato|Mireille Enos|Stacy Keach,R.J. Cutler,106,Drama,2014-08-21,856,7.2,2014,10132001,72650912,62518911,7
692,2.303556,45000000,86165646,41165646,Step Up All In,Ryan Guzman|Briana Evigan|Stephen Boss|Misha Gabriel|Izabella Miko,Trish Sie,112,Romance|Drama|Music,2014-07-16,421,6.7,2014,41449097,79366405,37917308,7
694,2.293859,12000000,305151265,293151265,The Fault in Our Stars,Shailene Woodley|Ansel Elgort|Nat Wolff|Laura Dern|Sam Trammell,Josh Boone,125,Romance|Drama,2014-05-16,2389,7.8,2014,11053092,281072099,270019007,8
696,2.165462,25000000,153997819,128997819,Ride Along,Ice Cube|Kevin Hart|John Leguizamo|Bruce McGill|Tika Sumpter,Tim Story,99,Action|Comedy,2014-01-17,634,6.1,2014,23027276,141846012,118818736,6
698,2.160156,20000000,11110975,-8889025,Inherent Vice,Joaquin Phoenix|Josh Brolin|Owen Wilson|Katherine Waterston|Reese Witherspoon,Paul Thomas Anderson,148,Comedy|Romance|Crime|Drama|Mystery,2014-12-25,552,6.3,2014,18421821,10234219,-8187602,6
699,2.141491,60000000,50549107,-9450893,Jack Ryan: Shadow Recruit,Chris Pine|Keira Knightley|Kevin Costner|Nonso Anozie|Gemma Chan,Kenneth Branagh,105,Action|Drama|Thriller,2014-01-15,873,5.9,2014,55265463,46560330,-8705133,6
700,2.136758,50000000,222809600,172809600,Non-Stop,Liam Neeson|Julianne Moore|Scoot McNairy|Michelle Dockery|Nate Parker,Jaume Collet-Serra,106,Action|Thriller|Mystery,2014-01-26,1648,6.8,2014,46054552,205227928,159173376,7
701,2.116264,5500000,3000000,-2500000,Predestination,Ethan Hawke|Sarah Snook|Noah Taylor|Christopher Kirby|Madeleine West,Michael Spierig|Peter Spierig,97,Science Fiction|Thriller,2014-08-28,1136,7.2,2014,5066000,2763273,-2302727,7
704,1.957672,12600000,18658381,6058381,The Drop,Tom Hardy|Noomi Rapace|James Gandolfini|Matthias Schoenaerts|John Ortiz,MichaÃ«l R. Roskam,106,Drama|Crime,2014-09-12,583,6.6,2014,11605747,17186067,5580320,7
705,1.940735,120000000,239379423,119379423,RoboCop,Joel Kinnaman|Gary Oldman|Michael Keaton|Abbie Cornish|Jackie Earle Haley,JosÃ© Padilha,102,Science Fiction|Action,2014-01-30,1709,5.7,2014,110530926,220490244,109959318,6
706,1.904422,100000000,103039258,3039258,Transcendence,Johnny Depp|Paul Bettany|Rebecca Hall|Kate Mara|Morgan Freeman,Wally Pfister,119,Thriller|Science Fiction|Drama|Mystery,2014-04-16,1555,5.9,2014,92109105,94908538,2799433,6
707,1.900038,40000000,196781193,156781193,The Other Woman,Cameron Diaz|Leslie Mann|Kate Upton|Don Johnson|Nikolaj Coster-Waldau,Nick Cassavetes,109,Comedy|Romance,2014-04-16,1056,6.2,2014,36843642,181253395,144409753,6
708,1.894706,145000000,272912430,127912430,Mr. Peabody & Sherman,Ty Burrell|Max Charles|Ariel Winter|Allison Janney|Ellie Kemper,Rob Minkoff,92,Animation|Adventure|Family,2014-02-07,592,6.8,2014,133558202,251377196,117818994,7
710,1.840817,65000000,39407616,-25592384,Sin City: A Dame to Kill For,Mickey Rourke|Jessica Alba|Josh Brolin|Joseph Gordon-Levitt|Rosario Dawson,Frank Miller|Robert Rodriguez,102,Crime|Thriller,2014-08-20,857,6.2,2014,59870918,36298002,-23572916,6
712,1.811692,103000000,500188435,397188435,Rio 2,Jesse Eisenberg|Anne Hathaway|Leslie Mann|Jamie Foxx|Andy GarcÃ­a,Carlos Saldanha,102,Animation|Adventure|Comedy|Family,2014-03-19,659,6.5,2014,94872378,460719091,365846713,6
713,1.805954,40000000,169837010,129837010,Dumb and Dumber To,Jim Carrey|Jeff Daniels|Rachel Melvin|Kathleen Turner|Brady Bluhm,Bobby Farrelly|Peter Farrelly,110,Comedy,2014-11-12,790,5.5,2014,36843642,156435350,119591708,5
715,1.779861,70000000,154984035,84984035,The Monuments Men,Matt Damon|Cate Blanchett|George Clooney|Bill Murray|John Goodman,George Clooney,118,War|Drama|History|Action,2014-01-24,1083,5.7,2014,64476373,142754407,78278034,6
716,1.769987,65000000,163442937,98442937,Unbroken,Jack O'Connell|Domhnall Gleeson|Garrett Hedlund|Takamasa Ishihara|Finn Wittrock,Angelina Jolie,137,Drama|War,2014-12-25,981,7.2,2014,59870918,150545826,90674908,7
717,1.754707,20000000,66787908,46787908,Selma,David Oyelowo|Tom Wilkinson|Carmen Ejogo|AndrÃ© Holland|Omar J. Dorsey,Ava DuVernay,127,History|Drama,2014-12-25,580,7.5,2014,18421821,61517744,43095923,7
718,1.737699,4900000,3494070,-1405930,Mommy,Anne Dorval|Suzanne ClÃ©ment|Antoine-Olivier Pilon|Patrick Huard|Alexandre Goyette,Xavier Dolan,138,Drama,2014-05-22,389,8.0,2014,4513346,3218356,-1294990,8
721,1.64932099999999,15000000,52501541,37501541,Wild,Reese Witherspoon|Laura Dern|Thomas Sadoski|Keene McRae|Michiel Huisman,Jean-Marc VallÃ©e,115,Drama,2014-12-05,677,6.9,2014,13816365,48358699,34542334,7
722,1.638781,130000000,117831631,-12168369,Pompeii,Kit Harington|Carrie-Anne Moss|Emily Browning|Adewale Akinnuoye-Agbaje|Jessica Lucas,Paul W.S. Anderson,105,Action|Adventure|History|Romance|Drama,2014-02-18,837,5.1,2014,119741836,108533660,-11208176,5
723,1.63015,26000000,35926213,9926213,The Best of Me,Michelle Monaghan|James Marsden|Liana Liberato|Luke Bracey|Gerald McRaney,Michael Hoffman,117,Drama|Romance,2014-10-16,535,7.2,2014,23948367,33091313,9142946,7
724,1.58801,65000000,133821816,68821816,Annie,QuvenzhanÃ© Wallis|Jamie Foxx|Rose Byrne|Cameron Diaz|Bobby Cannavale,Will Gluck,119,Music|Comedy|Drama|Family,2014-12-19,331,6.1,2014,59870918,123262077,63391159,6
726,1.54505499999999,50000000,97437106,47437106,The Book of Life,Diego Luna|Channing Tatum|Zoe Saldana|Christina Applegate|Eugenio Derbez,Jorge R. Gutierrez,95,Romance|Animation|Adventure|Comedy|Family,2014-10-01,531,7.3,2014,46054552,89748446,43693894,7
727,1.542392,13000000,54837234,41837234,St. Vincent,Bill Murray|Melissa McCarthy|Naomi Watts|Chris O'Dowd|Terrence Howard,Theodore Melfi,102,Comedy,2014-10-09,531,7.1,2014,11974183,50510085,38535902,7
728,1.541069,66000000,203277636,137277636,Need for Speed,Aaron Paul|Dominic Cooper|Imogen Poots|Rami Malek|RamÃ³n RodrÃ­guez,Scott Waugh,130,Action|Crime|Drama|Thriller,2014-03-13,1117,6.2,2014,60792009,187237211,126445202,6
731,1.44904599999999,22000000,88880821,66880821,The Hundred-Foot Journey,Helen Mirren|Manish Dayal|Om Puri|Charlotte Le Bon|Rohan Chand,Lasse HallstrÃ¶m,122,Drama,2014-08-06,352,7.2,2014,20264003,81867328,61603325,7
732,1.440084,60000000,108255770,48255770,The Boxtrolls,Ben Kingsley|Isaac Hempstead Wright|Elle Fanning|Dee Bradley Baker|Steve Blum,Graham Annable|Anthony Stacchi,97,Animation|Comedy|Family|Fantasy,2014-09-10,498,6.6,2014,55265463,99713420,44447957,7
733,1.398713,10000000,28883511,18883511,Big Eyes,Amy Adams|Christoph Waltz|Krysten Ritter|Danny Huston|Jason Schwartzman,Tim Burton,105,Drama,2014-12-24,710,6.8,2014,9210910,26604343,17393433,7
734,1.394382,18000000,266586800,248586800,The Prince,Bruce Willis|Jason Patric|John Cusack|Jessica Lowndes|Gia Mantegna,Brian A Miller,93,Thriller|Action,2014-08-22,165,4.6,2014,16579638,245550715,228971077,5
738,1.319416,4000000,600896,-3399104,The Signal,Brenton Thwaites|Laurence Fishburne|Olivia Cooke|Lin Shaye|Beau Knapp,William Eubank,95,Thriller|Science Fiction,2014-03-15,400,5.8,2014,3684364,553479,-3130885,6
740,1.3155,50000000,160602194,110602194,Into the Storm,Richard Armitage|Sarah Wayne Callies|Matt Walsh|Nathan Kress|Alycia Debnam-Carey,Steven Quale,89,Action|Thriller,2014-08-06,572,5.7,2014,46054552,147929243,101874691,6
743,1.240895,50000000,151165787,101165787,Planes: Fire & Rescue,Dane Cook|Ed Harris|Julie Bowen|Curtis Armstrong|John Michael Higgins,Roberts Gannaway,83,Animation|Comedy|Adventure|Family,2014-07-17,223,5.9,2014,46054552,139237453,93182901,6
745,1.214094,35000000,17508518,-17491482,Sabotage,Arnold Schwarzenegger|Sam Worthington|Mireille Enos|Joe Manganiello|Harold Perrineau,David Ayer,110,Action|Drama|Thriller|Crime,2014-03-28,422,5.4,2014,32238186,16126939,-16111247,5
750,1.146492,13200000,53830415,40630415,No Good Deed,Idris Elba|Taraji P. Henson|Leslie Bibb|Kate del Castillo|Henry Simmons,Sam Miller,84,Thriller,2014-09-12,105,5.8,2014,12158401,49582713,37424312,6
751,1.142614,5000000,41797583,36797583,Still Alice,Julianne Moore|Alec Baldwin|Kristen Stewart|Kate Bosworth|Shane McRae,Richard Glatzer|Wash Westmoreland,99,Drama,2014-12-05,725,7.5,2014,4605455,38499379,33893924,7
752,1.140302,5000000,40100000,35100000,"As Above, So Below",Perdita Weeks|Ben Feldman|Edwin Hodge|FranÃ§ois Civil|Marion Lambert,John Erick Dowdle,93,Horror|Thriller,2014-08-14,501,6.1,2014,4605455,36935751,32330296,6
753,1.136851,24000000,12096300,-11903700,Foxcatcher,Steve Carell|Channing Tatum|Mark Ruffalo|Sienna Miller|Vanessa Redgrave,Bennett Miller,134,Drama|Thriller,2014-05-19,645,6.5,2014,22106185,11141793,-10964392,6
755,1.077877,20000000,34077920,14077920,Endless Love,Alex Pettyfer|Gabriella Wilde|Robert Patrick|Rhys Wakefield|Emma Rigby,Shana Feste,103,Drama|Romance,2014-02-12,357,6.6,2014,18421821,31388867,12967046,7
756,1.052381,12250000,2295423,-9954577,The Rover,Guy Pearce|Robert Pattinson|Scoot McNairy|Nash Edgerton|Anthony Hayes,David MichÃ´d,100,Crime|Drama,2014-05-18,164,6.0,2014,11283365,2114293,-9169072,6
757,1.041267,24000000,70181428,46181428,Think Like a Man Too,Kevin Hart|Regina Hall|Michael Ealy|Jerry Ferrara|Taraji P. Henson,Tim Story,106,Comedy|Romance,2014-06-19,175,6.2,2014,22106185,64643485,42537300,6
758,1.039133,15000000,9104716,-5895284,Suite FranÃ§aise,Michelle Williams|Kristin Scott Thomas|Matthias Schoenaerts|Sam Riley|Ruth Wilson,Saul Dibb,107,Drama|Romance|War,2014-11-05,161,6.9,2014,13816365,8386272,-5430093,7
760,1.027357,15000000,59209,-14940791,Walk of Shame,Elizabeth Banks|James Marsden|Gillian Jacobs|Ethan Suplee|Sarah Wright,Steven Brill,95,Comedy,2014-05-02,402,5.7,2014,13816365,54536,-13761829,6
762,1.018115,6500000,255273813,248773813,Annabelle,Annabelle Wallis|Alfre Woodard|Eric Ladin|Tony Amendola|Gabriel Bateman,John R. Leonetti,99,Horror,2014-10-02,827,5.6,2014,5987091,235130424,229143333,6
765,0.989916,65000000,71154592,6154592,"I, Frankenstein",Aaron Eckhart|Yvonne Strahovski|Bill Nighy|Jai Courtney|Miranda Otto,Stuart Beattie,92,Horror|Thriller,2014-01-22,501,5.1,2014,59870918,65539857,5668939,5
766,0.988081,8000000,26049082,18049082,That Awkward Moment,Zac Efron|Miles Teller|Michael B. Jordan|Imogen Poots|Mackenzie Davis,Tom Gormican,94,Comedy|Romance,2014-01-29,713,6.0,2014,7368728,23993576,16624848,6
768,0.98174,27000000,28831145,1831145,Draft Day,Kevin Costner|Jennifer Garner|Tom Welling|Sam Elliott|Terry Crews,Ivan Reitman,109,Drama,2014-04-11,207,6.5,2014,24869458,26556109,1686651,6
769,0.979655,28000000,68896829,40896829,Brick Mansions,Paul Walker|David Belle|RZA|Robert Maillet|Carlo Rota,Camille Delamarre,90,Action|Crime|Drama,2014-04-22,476,5.8,2014,25790549,63460252,37669703,6
770,0.967846,2000000,6676471,4676471,The Babadook,Essie Davis|Noah Wiseman|Daniel Henshall|Hayley McElhinney|Cathy Adamek,Jennifer Kent,93,Drama|Thriller|Horror,2014-05-22,1089,6.5,2014,1842182,6149637,4307455,6
771,0.966048,20000000,100525432,80525432,Tammy,Melissa McCarthy|Susan Sarandon|Kathy Bates|Allison Janney|Dan Aykroyd,Ben Falcone,97,Comedy,2014-07-02,381,5.1,2014,18421821,92593075,74171254,5
780,0.92537,60000000,30800231,-29199769,Winter's Tale,Colin Farrell|Jessica Brown Findlay|Russell Crowe|William Hurt|Jennifer Connelly,Akiva Goldsman,118,Drama|Fantasy|Mystery|Romance,2014-02-13,327,5.9,2014,55265463,28369817,-26895646,6
783,0.916435,5000000,2367161,-2632839,The Guest,Dan Stevens|Maika Monroe|Sheila Kelley|Ethan Embry|Joel David Moore,Adam Wingard,99,Mystery|Thriller|Action,2014-09-17,402,6.6,2014,4605455,2180370,-2425085,7
788,0.893120999999999,22500000,15520023,-6979977,The Water Diviner,Russell Crowe|Olga Kurylenko|Jai Courtney|Isabel Lucas|Damon Herriman,Russell Crowe,112,War|Drama,2014-12-25,287,6.8,2014,20724548,14295354,-6429194,7
789,0.890965,5000000,6833445,1833445,The Green Inferno,Lorenza Izzo|Ariel Levy|Sky Ferreira|Nicolas Martinez|Kirby Bliss Blanton,Eli Roth,100,Horror|Thriller,2014-09-04,194,4.8,2014,4605455,6294225,1688770,5
792,0.876513999999999,28000000,100654149,72654149,"Alexander and the Terrible, Horrible, No Good, Very Bad Day",Steve Carell|Jennifer Garner|Ed Oxenbould|Dylan Minnette|Kerris Dorsey,Miguel Arteta,81,Family|Comedy,2014-10-08,380,6.2,2014,25790549,92711635,66921086,6
793,0.876066,19800000,41296320,21496320,This Is Where I Leave You,Jason Bateman|Tina Fey|Adam Driver|Rose Byrne|Corey Stoll,Shawn Levy,103,Drama|Comedy,2014-09-10,377,6.5,2014,18237602,38037670,19800068,6
794,0.870104,16000000,2429989,-13570011,The Homesman,Hilary Swank|Tommy Lee Jones|Grace Gummer|Meryl Streep|Miranda Otto,Tommy Lee Jones,122,Western|Drama,2014-05-18,150,6.2,2014,14737456,2238241,-12499215,6
801,0.805839,8500000,7500000,-1000000,Big Game,Samuel L. Jackson|Onni Tommila|Ted Levine|Victor Garber|Felicity Huffman,Jalmari Helander,90,Action|Adventure,2014-09-05,261,5.2,2014,7829273,6908182,-921091,5
803,0.797723,40000000,67347013,27347013,Jersey Boys,Christopher Walken|Vincent Piazza|Freya Tingley|James Madio|Sean Whalen,Clint Eastwood,134,Music|Drama,2014-06-05,181,6.7,2014,36843642,62032730,25189088,7
804,0.796721,12500000,49002684,36502684,About Last Night,Kevin Hart|Michael Ealy|Regina Hall|Joy Bryant|Christopher McDonald,Steve Pink,100,Comedy|Romance,2014-02-14,165,5.8,2014,11513638,45135933,33622295,6
805,0.786397999999999,25000000,38307627,13307627,Million Dollar Arm,Jon Hamm|Bill Paxton|Lake Bell|Suraj Sharma|Aasif Mandvi,Craig Gillespie,124,Drama,2014-05-09,182,6.6,2014,23027276,35284812,12257536,7
806,0.778247,5500000,5483299,-16701,Wish I Was Here,Zach Braff|Kate Hudson|Joey King|Pierce Gagnon|Donald Faison,Zach Braff,120,Drama|Comedy,2014-01-18,192,6.3,2014,5066000,5050617,-15383,6
807,0.777096,6700000,1430655,-5269345,Infinitely Polar Bear,Mark Ruffalo|Zoe Saldana|Imogene Wolodarsky|Ashley Aufderheide|Wallace Wolodarsky,Maya Forbes,87,Comedy|Drama,2014-01-18,76,7.0,2014,6171310,1317763,-4853547,7
812,0.757089,13300000,5380251,-7919749,Under the Skin,Scarlett Johansson|KryÅ¡tof HÃ¡dek|Paul Brannigan|Michael Moreland|Scott Dymond,Jonathan Glazer,108,Thriller|Science Fiction|Drama,2014-03-14,704,6.0,2014,12250510,4955701,-7294809,6
813,0.751772999999999,6000000,3485127,-2514873,Veronica Mars,Kristen Bell|Jason Dohring|Enrico Colantoni|Chris Lowell|Percy Daggs III,Rob Thomas,107,Comedy|Drama|Crime,2014-03-13,323,6.3,2014,5526546,3210119,-2316427,6
815,0.740796,22000000,67800064,45800064,Son of God,Roma Downey|Diogo Morgado|Louise Delamere|Darwin Shaw|Amber Rose Revah,Christopher Spencer,138,Drama,2014-02-28,61,5.8,2014,20264003,62450032,42186029,6
818,0.728025,6000000,15071,-5984929,Barefoot,Evan Rachel Wood|Scott Speedman|J.K. Simmons|Treat Williams|Kate Burton,Andrew Fleming,90,Comedy|Drama|Romance,2014-02-02,129,6.5,2014,5526546,13881,-5512665,6
819,0.72546,3500000,5155325,1655325,Justice League: War,Michelle Monaghan|Alan Tudyk|Sean Astin|Shemar Moore|Christopher Gorham,Jay Oliva,79,Animation,2014-02-02,141,7.0,2014,3223818,4748523,1524705,7
820,0.722877,8500000,770706,-7729294,The Zero Theorem,Christoph Waltz|David Thewlis|MÃ©lanie Thierry|Lucas Hedges|Matt Damon,Terry Gilliam,107,Drama|Fantasy|Science Fiction,2014-01-02,232,5.7,2014,7829273,709890,-7119383,6
823,0.714661,15000000,30127963,15127963,When the Game Stands Tall,Jim Caviezel|Michael Chiklis|Laura Dern|Clancy Brown|Ser'Darius Blain,Thomas Carter,115,Drama,2014-08-22,94,6.2,2014,13816365,27750597,13934232,6
831,0.688179,2000000,48390,-1951610,Decoding Annie Parker,Samantha Morton|Helen Hunt|Aaron Paul|Alice Eve|Maggie Grace,Steven Bernstein,91,Drama,2014-05-02,23,5.2,2014,1842182,44571,-1797611,5
837,0.667732,200000,17834867,17634867,The Quiet Ones,Jared Harris|Sam Claflin|Olivia Cooke|Erin Richards|Rory Fleck-Byrne,John Pogue,98,Horror,2014-04-01,147,5.1,2014,184218,16427536,16243318,5
839,0.660405,15000000,31554855,16554855,A Most Wanted Man,Philip Seymour Hoffman|Rachel McAdams|Robin Wright|Daniel BrÃ¼hl|Willem Dafoe,Anton Corbijn,121,Thriller,2014-07-25,393,6.3,2014,13816365,29064894,15248529,6
842,0.646336999999999,6500000,13865435,7365435,The Pyramid,Ashley Hinshaw|Denis O'Hare|James Buckley|Christa Nicola|Amir K,GrÃ©gory Levasseur,89,Horror,2014-12-04,234,4.7,2014,5987091,12771328,6784237,5
844,0.635214,6600000,1554000,-5046000,Clouds of Sils Maria,Juliette Binoche|Kristen Stewart|ChloÃ« Grace Moretz|Lars Eidinger|Brady Corbet,Olivier Assayas,124,Drama,2014-08-20,173,6.8,2014,6079200,1431375,-4647825,7
845,0.632047999999999,5000000,2450846,-2549154,Kill the Messenger,Jeremy Renner|Mary Elizabeth Winstead|Michael Sheen|Ray Liotta|Robert Patrick,Michael Cuesta,112,Thriller|Crime|Drama|Mystery,2014-10-09,247,6.5,2014,4605455,2257452,-2348003,6
851,0.615729,1000000,9318,-990682,Honeymoon,Rose Leslie|Harry Treadaway|Ben Huber|Hanna Brown,Leigh Janiak,87,Horror,2014-09-12,137,5.3,2014,921091,8582,-912509,5
854,0.602735,2000000,4635300,2635300,Locke,Tom Hardy|Ruth Wilson|Andrew Scott|Olivia Colman|Tom Holland,Steven Knight,85,Drama|Thriller,2014-04-10,480,6.8,2014,1842182,4269533,2427351,7
856,0.599079,36000000,52424533,16424533,Dolphin Tale 2,Morgan Freeman|Ashley Judd|Nathan Gamble|Cozi Zuehlsdorff|Harry Connick Jr.,Charles Martin Smith,107,Family|Drama,2014-09-12,63,6.8,2014,33159277,48287768,15128491,7
861,0.590256999999999,1000000,26501323,25501323,The Woman in Black 2: Angel of Death,Helen McCrory|Jeremy Irvine|Phoebe Fox|Ned Dennehy|Adrian Rawlins,Tom Harper,90,Thriller|Horror|Drama,2014-12-30,270,4.9,2014,921091,24410131,23489040,5
864,0.574398,50000000,80383113,30383113,Muppets Most Wanted,Ricky Gervais|Ty Burrell|Tina Fey|Steve Whitmire|Eric Jacobson,James Bobin,112,Comedy|Adventure|Crime|Family,2014-03-20,222,6.2,2014,46054552,74040166,27985614,6
870,0.559472,2800000,1826705,-973295,Tusk,Michael Parks|Justin Long|Haley Joel Osment|GÃ©nesis RodrÃ­guez|Ralph Garman,Kevin Smith,102,Comedy|Drama|Horror,2014-09-19,206,4.9,2014,2579054,1682561,-896493,5
878,0.548656,6000000,1020921,-4979079,5 Flights Up,Morgan Freeman|Diane Keaton|Carrie Preston|Cynthia Nixon|Alysia Reiner,Richard Loncraine,92,Drama,2014-09-05,56,5.9,2014,5526546,940361,-4586185,6
881,0.540852,12000000,101332962,89332962,Heaven is for Real,Greg Kinnear|Kelly Reilly|Connor Corum|Thomas Haden Church|Jon Ted Wynne,Randall Wallace,99,Drama,2014-04-16,159,6.1,2014,11053092,93336884,82283792,6
896,0.49584,70000000,61279452,-8720548,The Legend of Hercules,Kellan Lutz|Liam McIntyre|Gaia Weiss|Scott Adkins|Roxanne McKee,Renny Harlin,99,Action|Adventure,2014-01-10,399,4.4,2014,64476373,56443954,-8032419,4
901,0.485296,30000000,25312387,-4687613,And So It Goes,Michael Douglas|Diane Keaton|Sterling Jerins|Paloma GuzmÃ¡n|Frances Sternhagen,Rob Reiner,94,Comedy|Drama|Romance,2014-07-20,111,5.7,2014,27632731,23315013,-4317718,6
910,0.470651,2400000,88273,-2311727,Life After Beth,Aubrey Plaza|Dane DeHaan|John C. Reilly|Molly Shannon|Cheryl Hines,Jeff Baena,90,Romance|Comedy|Horror,2014-08-15,141,4.8,2014,2210618,81307,-2129311,5
924,0.446458,5500000,5000000,-500000,Miss Julie,Jessica Chastain|Colin Farrell|Samantha Morton|Nora McMenamy,Liv Ullmann,120,Drama,2014-09-07,15,5.4,2014,5066000,4605455,-460545,5
940,0.407983,6000000,32251,-5967749,Song One,Anne Hathaway|Johnny Flynn|Mary Steenburgen|Ben Rosenfield|Lola Kirke,Kate Barker-Froyland,86,Drama,2014-01-20,58,5.7,2014,5526546,29706,-5496840,6
942,0.403579,1000000,395000,-605000,A Girl Walks Home Alone at Night,Sheila Vand|Arash Marandi|Marshall Manesh|Dominic Rains|Rome Shadanloo,Ana Lily Amirpour,99,Horror|Romance,2014-01-19,146,7.0,2014,921091,363830,-557261,7
944,0.401153,318000,121179,-196821,Afflicted,Baya Rehaz|Derek Lee|Clif Prowse|Edo Van Breemen|Zachary Gray,Clif Prowse|Derek Lee,85,Horror|Thriller,2014-04-04,142,6.1,2014,292906,111616,-181290,6
947,0.398601,7000000,14618727,7618727,Beyond the Lights,Minnie Driver|Gugu Mbatha-Raw|Danny Glover|Jordan Belfi|Nate Parker,Gina Prince-Bythewood,116,Drama,2014-09-10,95,6.9,2014,6447637,13465178,7017541,7
954,0.386307,5000000,10429707,5429707,Moms' Night Out,Sarah Drew|Sean Astin|Patricia Heaton|Logan White|Robert Amaya ,Andrew Erwin|Jon Erwin,98,Comedy,2014-03-25,92,5.7,2014,4605455,9606709,5001254,6
956,0.382434,13000000,45300000,32300000,Earth to Echo,Teo Halm|Astro|Resse Hartwig|Ella Wahlestedt|Jason Gray-Stanford,Dave Green,89,Family|Adventure|Science Fiction,2014-07-02,223,5.7,2014,11974183,41725424,29751241,6
976,0.350612,25000000,39171130,14171130,The Gambler,Mark Wahlberg|John Goodman|Brie Larson|Michael Kenneth Williams|Jessica Lange,Rupert Wyatt,111,Thriller|Crime|Drama,2014-12-25,405,5.6,2014,23027276,36080177,13052901,6
983,0.34162,12700000,3430018,-9269982,The Grand Seduction,Brendan Gleeson|Taylor Kitsch|Gordon Pinsent|Liane Balaban|Mark Critch,Don McKellar,112,Comedy,2014-05-30,63,6.7,2014,11697856,3159358,-8538498,7
985,0.340308,4000000,2365467,-1634533,Joe,Nicolas Cage|Tye Sheridan|Ronnie Gene Blevins|Sue Rock|Heather Kafka,David Gordon Green,118,Drama,2014-04-10,207,6.5,2014,3684364,2178810,-1505554,6
1004,0.318941,500000,15000000,14500000,Parts Per Billion,Josh Hartnett|Teresa Palmer|Alexis Bledel|Rosario Dawson|Penn Badgley,Brian Horiuchi,139,Science Fiction,2014-03-25,14,4.8,2014,460545,13816365,13355820,5
1006,0.317225,5000000,75143,-4924857,Better Living Through Chemistry,Olivia Wilde|Michelle Monaghan|Sam Rockwell|Ray Liotta|Jane Fonda,Geoff Moore|David Posamentier,91,Drama|Comedy,2014-03-14,60,5.9,2014,4605455,69213,-4536242,6
1023,0.300442,17000000,29789000,12789000,God's Not Dead,Kevin Sorbo|Shane Harper|David A.R. White|Dean Cain|Cassidy Gifford,Harold Cronk,113,Drama,2014-03-21,146,6.1,2014,15658547,27438381,11779834,6
1042,0.283225,7000000,36433975,29433975,Devil's Due,Allison Miller|Zach Gilford|Sam Anderson|Robert Belushi|Catherine Kresge,Matt Bettinelli-Olpin|Tyler Gillett,89,Horror,2014-01-08,164,4.5,2014,6447637,33559008,27111371,4
1069,0.751476,5000000,4013786,-986214,My Old Lady,Maggie Smith|Kevin Kline|Kristin Scott Thomas|Dominique Pinon|Michael Burstin,Israel Horovitz,107,Romance|Comedy|Drama,2014-09-09,65,6.0,2014,4605455,3697062,-908393,6
1131,0.19104,8000000,53086,-7946914,Aloft,Jennifer Connelly|MÃ©lanie Laurent|Cillian Murphy|William Shimell|Zen McGrath,Claudia Llosa,112,Drama,2014-02-12,20,5.1,2014,7368728,48897,-7319831,5
1179,0.151591,5900000,23000000,17100000,Mrs. Brown's Boys D'Movie,Brendan O'Carroll|Jennifer Gibney|Eilish O'Carroll|Danny O'Carroll|Fiona O'Carroll,Ben Kellett,94,Comedy,2014-06-27,20,5.2,2014,5434437,21185094,15750657,5
1329,12.037933,11000000,775398007,764398007,Star Wars,Mark Hamill|Harrison Ford|Carrie Fisher|Peter Cushing|Alec Guinness,George Lucas,121,Adventure|Action|Science Fiction,1977-03-20,4428,7.9,1977,39575591,2789712242,2750136651,8
1330,2.379469,14000000,185438673,171438673,The Spy Who Loved Me,Roger Moore|Barbara Bach|Curd JÃ¼rgens|Richard Kiel|Caroline Munro,Lewis Gilbert,125,Adventure|Action|Thriller,1977-07-07,279,6.2,1977,50368934,667167740,616798806,6
1331,1.719385,1200000,71215869,70015869,The Rescuers,Bob Newhart|Eva Gabor|Geraldine Page|Joe Flynn|Jeanette Nolan,John Lounsbery|Wolfgang Reitherman|Art Stevens,78,Fantasy|Family|Animation|Adventure,1977-06-22,332,6.6,1977,4317337,256219102,251901765,7
1332,1.179653,4000000,38251425,34251425,Annie Hall,Woody Allen|Diane Keaton|Tony Roberts|Carol Kane|Paul Simon,Woody Allen,93,Comedy|Drama|Romance,1977-04-19,493,7.6,1977,14391124,137620251,123229127,8
1334,1.104816,20000000,303788635,283788635,Close Encounters of the Third Kind,Richard Dreyfuss|FranÃ§ois Truffaut|Teri Garr|Melinda Dillon|Bob Balaban,Steven Spielberg,135,Science Fiction|Drama,1977-11-16,600,7.0,1977,71955620,1092964988,1021009368,7
1335,1.048838,22000000,50750000,28750000,A Bridge Too Far,Dirk Bogarde|James Caan|Michael Caine|Sean Connery|Edward Fox,Richard Attenborough,175,Drama|History|War,1977-06-15,109,6.4,1977,79151182,182587387,103436205,6
1338,0.75125,3500000,16000000,12500000,Sinbad and the Eye of the Tiger,Patrick Wayne|Taryn Power|Margaret Whiting|Jane Seymour|Patrick Troughton,Sam Wanamaker,113,Action|Adventure|Family|Fantasy|Science Fiction,1977-07-15,15,5.9,1977,12592233,57564496,44972263,6
1340,0.602862,3500000,237113184,233613184,Saturday Night Fever,John Travolta|Karen Lynn Gorney|Barry Miller|Joseph Cali|Paul Pape,John Badham,118,Drama|Music,1977-12-16,192,6.3,1977,12592233,853081315,840489082,6
1341,0.560826,3400000,31063038,27663038,High Anxiety,Mel Brooks|Madeline Kahn|Cloris Leachman|Harvey Korman|Ron Carey,Mel Brooks,94,Comedy|Music,1977-12-25,29,6.2,1977,12232455,111758008,99525553,6
1344,0.49548,5500000,26414658,20914658,The Gauntlet,Clint Eastwood|Sondra Locke|Pat Hingle|William Prince|Bill McKinney,Clint Eastwood,109,Drama|Action|Crime|Thriller,1977-12-21,45,6.7,1977,19787795,95034155,75246360,7
1351,0.375967,14000000,30749142,16749142,Exorcist II: The Heretic,Linda Blair|Richard Burton|Louise Fletcher|Max von Sydow|Kitty Winn,John Boorman,118,Horror|Thriller|Fantasy,1977-06-17,56,4.6,1977,50368934,110628679,60259745,5
1352,0.373131,6000000,30000000,24000000,Airport '77,Jack Lemmon|Lee Grant|Brenda Vaccaro|Joseph Cotten|Olivia de Havilland,Jerry Jameson,114,Action|Adventure|Drama|Thriller,1977-03-11,25,5.7,1977,21586686,107933430,86346744,6
1354,0.331417,10000,7000000,6990000,Eraserhead,Jack Nance|Charlotte Stewart|Allen Joseph|Jeanne Bates|Judith Roberts,David Lynch,89,Science Fiction|Fantasy|Horror|Drama,1977-03-19,194,7.1,1977,35977,25184467,25148490,7
1363,0.228797,6000000,14717854,8717854,Orca: The Killer Whale,Richard Harris|Charlotte Rampling|Will Sampson|Bo Derek|Keenan Wynn,Michael Anderson,92,Drama|Adventure|Horror,1977-07-22,25,5.0,1977,21586686,52951615,31364929,5
1364,0.219941,22000000,12000000,-10000000,Sorcerer,Roy Scheider|Bruno Cremer|Francisco Rabal|Amidou|Ramon Bieri,William Friedkin,121,Action|Thriller|Adventure,1977-06-24,48,7.4,1977,79151182,43173372,-35977810,7
1365,0.191541,810000,1258000,448000,The Last Wave,Richard Chamberlain|Olivia Hamnett|David Gulpilil|Frederick Parslow|Vivean Gray,Peter Weir,106,Drama|Thriller|Mystery,1977-01-01,12,5.8,1977,2914202,4526008,1611806,6
1368,0.164123,500000,17000000,16500000,Kingdom of the Spiders,William Shatner|Tiffany Bolling|Woody Strode|Lieux Dressler|David McLean,John 'Bud' Cardos,97,Horror|Science Fiction,1977-08-24,16,5.7,1977,1798890,61162277,59363387,6
1370,0.175656999999999,1200000,9000000,7800000,Wizards,Bob Holt|Jesse Welles|Richard Romanus|David Proval,Ralph Bakshi,80,Animation|Fantasy|Science Fiction,1977-02-09,26,6.0,1977,4317337,32380029,28062692,6
1372,0.137351,230000,25000000,24770000,The Hills Have Eyes,Martin Speer|Russ Grieve|John Steadman|James Whitworth|Virginia Vincent,Wes Craven,89,Horror,1977-07-22,57,6.0,1977,827489,89944525,89117036,6
1386,9.432768,237000000,2781505847,2544505847,Avatar,Sam Worthington|Zoe Saldana|Sigourney Weaver|Stephen Lang|Michelle Rodriguez,James Cameron,162,Action|Adventure|Fantasy|Science Fiction,2009-12-10,8458,7.1,2009,240886902,2827123750,2586236848,7
1387,6.098027,70000000,319131050,249131050,Inglourious Basterds,Brad Pitt|MÃ©lanie Laurent|Christoph Waltz|Eli Roth|Michael Fassbender,Quentin Tarantino,153,Drama|Action|Thriller|War,2009-08-18,3969,7.7,2009,71148030,324364937,253216907,8
1388,5.806897,35000000,91327197,56327197,Underworld: Rise of the Lycans,Bill Nighy|Michael Sheen|Rhona Mitra|Shane Brolly|Steven Mackintosh,Patrick Tatopoulos,92,Fantasy|Action|Adventure|Science Fiction|Thriller,2009-01-22,979,6.2,2009,35574015,92825002,57250987,6
1389,5.076472,250000000,933959197,683959197,Harry Potter and the Half-Blood Prince,Daniel Radcliffe|Rupert Grint|Emma Watson|Tom Felton|Julie Walters,David Yates,153,Adventure|Fantasy|Family,2009-07-07,3220,7.3,2009,254100108,949276533,695176425,7
1390,4.90890199999999,175000000,731342744,556342744,Up,Ed Asner|Christopher Plummer|Jordan Nagai|Bob Peterson|Delroy Lindo,Bob Peterson|Pete Docter,96,Animation|Comedy|Family|Adventure,2009-05-13,4225,7.6,2009,177870075,743337082,565467007,8
1391,3.82957,150000000,385680446,235680446,Star Trek,Chris Pine|Zachary Quinto|Leonard Nimoy|Eric Bana|Bruce Greenwood,J.J. Abrams,127,Science Fiction|Action|Adventure,2009-05-06,3417,7.3,2009,152460065,392005772,239545707,7
1392,3.789633,200000000,371353001,171353001,Terminator Salvation,Christian Bale|Sam Worthington|Anton Yelchin|Moon Bloodgood|Bryce Dallas Howard,McG,115,Drama|Action|Thriller|Science Fiction,2009-05-20,1670,5.8,2009,203280086,377443351,174163265,6
1393,3.744956,30000000,210819611,180819611,District 9,Sharlto Copley|Jason Cope|Nathalie Boltt|Sylvaine Strike|Elizabeth Mkandawie,Neill Blomkamp,112,Action|Thriller|Science Fiction,2009-08-05,2141,7.1,2009,30492013,214277144,183785131,7
1394,3.431559,90000000,524028679,434028679,Sherlock Holmes,Robert Downey Jr.|Jude Law|Rachel McAdams|Mark Strong|Eddie Marsan,Guy Ritchie,128,Adventure|Drama|Action|Comedy|Thriller,2009-01-07,4118,6.9,2009,91476039,532622976,441146937,7
1395,3.244139,7500000,60722734,53222734,(500) Days of Summer,Joseph Gordon-Levitt|Zooey Deschanel|ChloÃ« Grace Moretz|Geoffrey Arend|Matthew Gray Gubler,Marc Webb,95,Comedy|Drama|Romance,2009-07-17,1778,7.3,2009,7623003,61718613,54095610,7
1396,3.154914,90000000,886686817,796686817,Ice Age: Dawn of the Dinosaurs,Ray Romano|John Leguizamo|Denis Leary|Queen Latifah|Simon Pegg,Carlos Saldanha,94,Animation|Comedy|Family|Adventure,2009-06-29,1392,6.4,2009,91476039,901228865,809752826,6
1397,3.15306,35000000,459270619,424270619,The Hangover,Bradley Cooper|Ed Helms|Zach Galifianakis|Justin Bartha|Heather Graham,Todd Phillips,100,Comedy,2009-06-05,4134,7.1,2009,35574015,466802856,431228841,7
1398,3.038063,130000000,185258983,55258983,Watchmen,Malin Ã…kerman|Billy Crudup|Carla Gugino|Jeffrey Dean Morgan|Patrick Wilson,Zack Snyder,162,Action|Mystery|Science Fiction,2009-03-05,1751,6.8,2009,132132056,188297310,56165254,7
1399,2.979786,200000000,769653595,569653595,2012,John Cusack|Amanda Peet|Chiwetel Ejiofor|Thandie Newton|Oliver Platt,Roland Emmerich,158,Action|Adventure|Science Fiction,2009-10-10,3533,5.6,2009,203280086,782276248,578996162,6
1400,2.846465,30000000,48428063,18428063,9,Elijah Wood|John C. Reilly|Jennifer Connelly|Christopher Plummer|Crispin Glover,Shane Acker,79,Action|Adventure|Animation|Science Fiction|Thriller,2009-08-19,851,6.5,2009,30492013,49222304,18730291,6
1401,2.841562,150000000,356613439,206613439,Angels & Demons,Tom Hanks|Ewan McGregor|Ayelet Zurer|Stellan SkarsgÃ¥rd|Pierfrancesco Favino,Ron Howard,138,Thriller|Mystery,2009-05-13,1275,6.3,2009,152460065,362462054,210001989,6
1402,2.463982,105000000,267045765,162045765,The Princess and the Frog,Anika Noni Rose|Bruno Campos|Keith David|Michael-Leon Wooley|Jennifer Cody,Ron Clements|John Musker,97,Romance|Family|Animation|Music,2009-12-08,706,6.5,2009,106722045,271425431,164703386,6
1403,2.367474,29000000,309208309,280208309,The Blind Side,Sandra Bullock|Quinton Aaron|Kathy Bates|Tim McGraw|Jae Head,John Lee Hancock,129,Drama,2009-11-20,1078,7.1,2009,29475612,314279459,284803847,7
1404,2.041804,23600000,102391382,78791382,Zombieland,Jesse Eisenberg|Woody Harrelson|Emma Stone|Abigail Breslin|Amber Heard,Ruben Fleischer,88,Comedy|Horror,2009-10-07,2165,7.1,2009,23987050,104070645,80083595,7
1405,1.971027,50000000,709827462,659827462,The Twilight Saga: New Moon,Kristen Stewart|Robert Pattinson|Taylor Lautner|Billy Burke|Ashley Greene,Chris Weitz,130,Adventure|Fantasy|Drama|Romance,2009-03-15,1388,5.6,2009,50820021,721468940,670648919,6
1406,1.926432,40000000,177259441,137259441,He's Just Not That Into You,Jennifer Aniston|Jennifer Connelly|Drew Barrymore|Ginnifer Goodwin|Ben Affleck,Ken Kwapis,129,Comedy|Romance|Drama,2009-02-06,612,6.0,2009,40656017,180166572,139510555,6
1407,1.906998,175000000,302469017,127469017,G.I. Joe: The Rise of Cobra,Dennis Quaid|Channing Tatum|Marlon Wayans|Sienna Miller|Joseph Gordon-Levitt,Stephen Sommers,118,Adventure|Action|Thriller|Science Fiction,2009-08-04,1470,5.7,2009,177870075,307429640,129559565,6
1408,1.895894,40000000,317375031,277375031,The Proposal,Sandra Bullock|Ryan Reynolds|Mary Steenburgen|Craig T. Nelson|Betty White,Anne Fletcher,108,Comedy|Romance|Drama,2009-06-01,1084,6.7,2009,40656017,322580119,281924102,7
1410,1.860267,38000000,205298907,167298907,The Ugly Truth,Katherine Heigl|Gerard Butler|Eric Winter|Bree Turner|Nick Searcy,Robert Luketic,96,Comedy|Romance,2009-07-24,584,6.3,2009,38623216,208665898,170042682,6
1411,1.849649,100000000,242988466,142988466,Cloudy with a Chance of Meatballs,Bill Hader|Anna Faris|James Caan|Mr. T|Benjamin Bratt,Phil Lord|Christopher Miller,90,Animation|Comedy|Family,2009-09-17,1116,6.4,2009,101640043,246973582,145333539,6
1412,1.826169,40000000,46471023,6471023,Fantastic Mr. Fox,George Clooney|Meryl Streep|Jason Schwartzman|Bill Murray|Wallace Wolodarsky,Wes Anderson,87,Adventure|Animation|Comedy|Family,2009-10-23,711,7.5,2009,40656017,47233167,6577150,7
1413,1.75384,60000000,124596398,64596398,Coraline,Dakota Fanning|Teri Hatcher|Jennifer Saunders|Dawn French|Keith David,Henry Selick,100,Animation|Family,2009-02-05,711,7.1,2009,60984026,126639833,65655807,7
1414,1.752134,150000000,413106170,263106170,Night at the Museum: Battle of the Smithsonian,Ben Stiller|Amy Adams|Owen Wilson|Hank Azaria|Robin Williams,Shawn Levy,105,Adventure|Fantasy|Action|Comedy|Family,2009-05-20,1108,5.9,2009,152460065,419881290,267421225,6
1415,1.732516,20000000,136267476,116267476,17 Again,Zac Efron|Leslie Mann|Matthew Perry|Tyler Steelman|Allison Miller,Burr Steers,102,Comedy,2009-03-11,765,6.0,2009,20328008,138502321,118174313,6
1416,1.71488699999999,200000000,325233863,125233863,A Christmas Carol,Gary Oldman|Jim Carrey|Steve Valentine|Daryl Sabara|Sage Ryan,Robert Zemeckis,96,Animation|Drama,2009-11-04,619,6.6,2009,203280086,330567839,127287753,7
1418,1.673879,65000000,93525586,28525586,The Lovely Bones,Rachel Weisz|Mark Wahlberg|Susan Sarandon|Saoirse Ronan|Stanley Tucci,Peter Jackson,136,Fantasy|Drama,2009-12-26,600,6.6,2009,66066028,95059446,28993418,7
1419,1.64173899999999,26000000,183293131,157293131,Paul Blart: Mall Cop,Kevin James|Keir O'Donnell|Jayma Mays|Raini Rodriguez|Shirley Knight,Steve Carr,91,Action|Adventure|Comedy|Family,2009-01-15,510,5.4,2009,26426411,186299217,159872806,5
1420,1.575231,16000000,47801389,31801389,Hachi: A Dog's Tale,Richard Gere|Joan Allen|Jason Alexander|Cary-Hiroyuki Tagawa|Sarah Roemer,Lasse HallstrÃ¶m,93,Drama|Family,2009-06-13,976,7.7,2009,16262406,48585352,32322946,8
1421,1.542135,53000000,126690726,73690726,Law Abiding Citizen,Jamie Foxx|Gerard Butler|Colm Meaney|Bruce McGill|Leslie Bibb,F. Gary Gray,109,Drama|Crime|Thriller,2009-10-15,900,7.2,2009,53869223,128768508,74899285,7
1422,1.535278,30000000,33333531,3333531,The Box,Cameron Diaz|James Marsden|Frank Langella|Michael Zegen|James Rebhorn,Richard Kelly,115,Thriller|Science Fiction,2009-09-17,296,5.3,2009,30492013,33880215,3388202,5
1423,1.487114,20000000,34560577,14560577,Crank: High Voltage,Jason Statham|Amy Smart|Dwight Yoakam|Efren Ramirez|Julanne Chidi Hill,Mark Neveldine|Brian Taylor,96,Action|Thriller|Crime,2009-04-16,560,5.9,2009,20328008,35127385,14799377,6
1424,1.453639,33000000,20645327,-12354673,Pandorum,Ben Foster|Dennis Quaid|Cam Gigandet|Antje Traue|Cung Le,Christian Alvart,108,Action|Horror|Mystery|Science Fiction|Thriller,2009-09-08,406,6.2,2009,33541214,20983919,-12557295,6
1426,1.398364,30000000,90842646,60842646,Drag Me to Hell,Alison Lohman|Justin Long|Lorna Raver|Dileep Rao|David Paymer,Sam Raimi,99,Horror|Thriller,2009-03-15,498,6.1,2009,30492013,92332504,61840491,6
1428,1.357091,50000000,155446362,105446362,Knowing,Nicolas Cage|Rose Byrne|Chandler Canterbury|Ben Mendelsohn|Nadia Townsend,Alex Proyas,121,Action|Adventure|Drama|Mystery|Science Fiction,2009-03-19,817,5.7,2009,50820021,157995749,107175728,6
1429,1.328218,5000000,9760104,4760104,Moon,Sam Rockwell|Kevin Spacey|Dominique McElligott|Rosie Shaw|Adrienne Shaw,Duncan Jones,97,Science Fiction|Drama,2009-06-12,1027,7.4,2009,5082002,9920173,4838171,7
1430,1.324927,150000000,292817841,142817841,G-Force,Sam Rockwell|PenÃ©lope Cruz|Tracy Morgan|Jon Favreau|Steve Buscemi,Hoyt Yeatman,88,Fantasy|Action|Adventure|Family|Comedy,2009-07-21,340,5.1,2009,152460065,297620180,145160115,5
1432,1.30199,100000000,150166126,50166126,The Taking of Pelham 1 2 3,Denzel Washington|John Travolta|Luis GuzmÃ¡n|Victor Gojcaj|John Turturro,Tony Scott,106,Thriller|Drama|Crime,2009-06-11,551,6.1,2009,101640043,152628915,50988872,6
1433,1.297769,18500000,31912793,13412793,The Invention of Lying,Ricky Gervais|Jennifer Garner|Jonah Hill|Louis C.K.|Jeffrey Tambor,Ricky Gervais|Matthew Robinson,100,Comedy|Romance|Fantasy,2009-09-13,305,5.8,2009,18803408,32436176,13632768,6
1434,1.290519,40000000,108332743,68332743,Confessions of a Shopaholic,Isla Fisher|Hugh Dancy|Krysten Ritter|Joan Cusack|John Goodman,P.J. Hogan,104,Comedy|Romance,2009-02-05,445,6.0,2009,40656017,110109447,69453430,6
1436,1.267182,50000000,40828540,-9171460,Gamer,Gerard Butler|Michael C. Hall|Logan Lerman|Amber Valletta|Terry Crews,Mark Neveldine|Brian Taylor,95,Action|Thriller|Science Fiction,2009-09-03,484,5.6,2009,50820021,41498145,-9321876,6
1438,1.26001,47000000,3547209,-43452791,Mr. Nobody,Jared Leto|Diane Kruger|Linh Äan Pháº¡m|Sarah Polley|Rhys Ifans,Jaco Van Dormael,141,Science Fiction|Drama|Romance|Fantasy,2009-09-11,827,7.8,2009,47770820,3605384,-44165436,8
1439,1.232312,70000000,171844840,101844840,Couples Retreat,Vince Vaughn|Malin Ã…kerman|Jason Bateman|Kristen Bell|Jon Favreau,Peter Billingsley,113,Comedy|Romance,2009-09-19,372,5.3,2009,71148030,174663169,103515139,5
1440,1.223786,26000000,43318349,17318349,Brothers,Tobey Maguire|Jake Gyllenhaal|Natalie Portman|Sam Shepard|Mare Winningham,Jim Sheridan,104,Drama|Thriller|War,2009-01-27,381,6.7,2009,26426411,44028788,17602377,7
1441,1.218657,32000000,27635305,-4364695,The Road,Viggo Mortensen|Kodi Smit-McPhee|Charlize Theron|Robert Duvall|Guy Pearce,John Hillcoat,111,Adventure|Drama,2009-11-25,600,6.7,2009,32524813,28088535,-4436278,7
1442,1.19445499999999,175000000,381509870,206509870,Monsters vs Aliens,Seth Rogen|Reese Witherspoon|Hugh Laurie|Paul Rudd|Kiefer Sutherland,Rob Letterman|Conrad Vernon,94,Animation|Family|Adventure|Science Fiction,2009-03-19,932,6.0,2009,177870075,387766797,209896722,6
1443,1.159118,3000000,2357852,-642148,Fish Tank,Katie Jarvis|Michael Fassbender|Kierston Wareing|Rebecca Griffiths|Harry Treadaway,Andrea Arnold,123,Drama,2009-05-14,124,6.6,2009,3049201,2396521,-652680,7
1444,1.14937,40000000,129540499,89540499,Julie & Julia,Meryl Streep|Amy Adams|Stanley Tucci|Chris Messina|Linda Emond,Nora Ephron,123,Romance|Drama,2009-08-06,341,6.5,2009,40656017,131665019,91009002,6
1445,1.145724,15000000,8459458,-6540542,Chloe,Julianne Moore|Liam Neeson|Amanda Seyfried|Max Thieriot|R. H. Thomson,Atom Egoyan,96,Drama|Thriller|Mystery,2009-03-25,297,5.9,2009,15246006,8598196,-6647810,6
1446,1.138277,80000000,214104620,134104620,Public Enemies,Christian Bale|Johnny Depp|Giovanni Ribisi|Billy Crudup|Marion Cotillard,Michael Mann,140,History|Crime|Drama,2009-07-01,853,6.5,2009,81312034,217616028,136303994,6
1448,1.104112,16000000,31556061,15556061,Jennifer's Body,Megan Fox|Amanda Seyfried|Johnny Simmons|Adam Brody|J.K. Simmons,Karyn Kusama,100,Comedy|Horror,2009-09-18,441,5.2,2009,16262406,32073594,15811188,5
1449,1.099003,20000000,41596251,21596251,Orphan,Vera Farmiga|Peter Sarsgaard|Isabelle Fuhrman|CCH Pounder|Jimmy Bennett,Jaume Collet-Serra,123,Horror|Thriller|Mystery,2009-07-24,707,6.5,2009,20328008,42278447,21950439,6
1450,1.085541,15000000,40105542,25105542,All About Steve,Sandra Bullock|Thomas Haden Church|Bradley Cooper|Ken Jeong|DJ Qualls,Phil Traill,99,Comedy,2009-09-04,192,4.6,2009,15246006,40763290,25517284,5
1451,1.083957,40000000,186167139,146167139,The Final Destination,Bobby Campo|Shantel VanSanten|Nick Zano|Haley Webb|Krista Allen,David R. Ellis,82,Horror|Mystery,2009-08-26,472,5.5,2009,40656017,189220360,148564343,5
1452,1.080415,75000000,443140005,368140005,Alvin and the Chipmunks: The Squeakquel,Zachary Levi|David Cross|Jason Lee|Justin Long|Matthew Gray Gubler,Betty Thomas,88,Comedy|Family|Animation|Fantasy|Music,2009-12-21,414,5.3,2009,76230032,450407693,374177661,5
1453,1.075405,4500000,3606395,-893605,After.Life,Liam Neeson|Justin Long|Christina Ricci|Josh Charles|Chandler Canterbury,Agnieszka Wojtowicz-Vosloo,104,Drama|Horror|Mystery|Thriller,2009-11-07,130,5.2,2009,4573801,3665541,-908260,5
1454,1.074072,30000000,114663461,84663461,Bride Wars,Anne Hathaway|Kate Hudson|Bryan Greenberg|Chris Pratt|Steve Howey,Gary Winick,89,Comedy,2009-01-09,501,5.8,2009,30492013,116543991,86051978,6
1455,1.065548,10000000,63647833,53647833,Precious,Gabourey Sidibe|Mo'Nique|Paula Patton|Mariah Carey|Lenny Kravitz,Lee Daniels,110,Drama,2009-11-06,205,6.8,2009,10164004,64691685,54527681,7
1456,1.04373799999999,60000000,87784194,27784194,State of Play,Russell Crowe|Ben Affleck|Rachel McAdams|Robin Wright|Jason Bateman,Kevin Macdonald,127,Action,2009-04-17,257,6.6,2009,60984026,89223892,28239866,7
1457,1.039442,16000000,76514050,60514050,The Unborn,Odette Annable|Gary Oldman|Meagan Good|Cam Gigandet|Idris Elba,David S. Goyer,87,Horror|Thriller|Mystery,2009-01-09,186,4.9,2009,16262406,77768913,61506507,5
1458,1.037708,14700000,8049666,-6650334,"New York, I Love You",Natalie Portman|Shia LaBeouf|Orlando Bloom|Christina Ricci|Hayden Christensen,Natalie Portman|Fatih Akin|Mira Nair|Allen Hughes|Yvan Attal|Shunji Iwai|Brett Ratner|Joshua Marston|Shekhar Kapur|Randall Balsmeyer|Wen Jiang,103,Drama|Comedy|Romance,2009-10-16,116,5.6,2009,14941086,8181684,-6759402,6
1459,1.022125,41000000,91636986,50636986,"I Love You, Man",Paul Rudd|Rashida Jones|Jason Segel|Sarah Burns|Jaime Pressly,John Hamburg,105,Comedy,2009-03-20,304,6.4,2009,41672417,93139872,51467455,6
1460,1.01800499999999,22000000,35424826,13424826,The Informant!,Matt Damon|Scott Bakula|Joel McHale|Melanie Lynskey|Ann Dowd,Steven Soderbergh,108,Comedy|Crime|Drama|Thriller,2009-09-18,170,6.0,2009,22360809,36005808,13644999,6
1461,1.014706,50000000,106303988,56303988,Race to Witch Mountain,Dwayne Johnson|AnnaSophia Robb|Alexander Ludwig|Carla Gugino|Chris Marquette,Andy Fickman,98,Adventure|Family|Fantasy|Science Fiction|Thriller,2009-03-12,308,5.4,2009,50820021,108047419,57227398,5
1462,0.999299,27000000,29000000,2000000,Case 39,RenÃ©e Zellweger|Jodelle Ferland|Ian McShane|Kerry O'Malley|Callum Keith Rennie,Christian Alvart,109,Horror|Mystery|Thriller,2009-08-13,298,6.0,2009,27442811,29475612,2032801,6
1463,0.967776,50000000,36348784,-13651216,The Boat That Rocked,Tom Sturridge|Philip Seymour Hoffman|Rhys Ifans|Bill Nighy|Emma Thompson,Richard Curtis,116,Drama|Comedy,2009-04-01,392,7.1,2009,50820021,36944919,-13875102,7
1465,0.966959,20000000,51416464,31416464,Daybreakers,Ethan Hawke|Sam Neill|Willem Dafoe|Claudia Karvan|Isabel Lucas,Michael Spierig|Peter Spierig,98,Fantasy|Horror|Action|Thriller|Science Fiction,2009-01-06,368,5.9,2009,20328008,52259716,31931708,6
1466,0.965516,39000000,101229792,62229792,The Time Traveler's Wife,Eric Bana|Rachel McAdams|Michelle Nolden|Arliss Howard|Ron Livingston,Robert Schwentke,107,Drama|Romance|Fantasy,2009-08-14,478,6.5,2009,39639616,102890004,63250388,6
1468,0.953705,11000000,791867,-10208133,Antichrist,Willem Dafoe|Charlotte Gainsbourg|Storm Acheche SahlstrÃ¸m,Lars von Trier,108,Drama|Horror|Thriller,2009-05-18,333,6.2,2009,11180404,804853,-10375551,6
1470,0.908112,18000000,36133014,18133014,Love Happens,Aaron Eckhart|Jennifer Aniston|Judy Greer|Martin Sheen|Deirdre Blades,Brandon Camp,109,Drama|Romance,2009-09-18,117,5.5,2009,18295207,36725611,18430404,5
1471,0.907448,38000000,45465299,7465299,Push,Dakota Fanning|Camilla Belle|Chris Evans|Djimon Hounsou|Maggie Siff,Paul McGuigan,111,Action,2009-02-06,367,5.8,2009,38623216,46210949,7587733,6
1472,0.905416,17000000,29536299,12536299,Brooklyn's Finest,Richard Gere|Don Cheadle|Ethan Hawke|Wesley Snipes|Vincent D'Onofrio,Antoine Fuqua,133,Crime|Drama|Thriller,2009-01-16,161,6.1,2009,17278807,30020707,12741900,6
1473,0.90173,11000000,68233629,57233629,Saw VI,Tobin Bell|Costas Mandylor|Betsy Russell|Mark Rolston|Peter Outerbridge,Kevin Greutert,90,Horror|Mystery,2009-10-22,379,5.9,2009,11180404,69352690,58172286,6
1474,0.894268,35000000,27409889,-7590111,The Young Victoria,Emily Blunt|Jim Broadbent|Mark Strong|Paul Bettany|Miranda Richardson,Jean-Marc VallÃ©e,105,Drama|History|Romance,2009-03-04,201,6.9,2009,35574015,27859423,-7714592,7
1475,0.884343,7000000,31430334,24430334,A Serious Man,Michael Stuhlbarg|Richard Kind|Fred Melamed|Sari Lennick|Aaron Wolff,Ethan Coen|Joel Coen,105,Comedy|Drama,2009-10-02,240,6.4,2009,7114803,31945805,24831002,6
1476,0.883984,14000000,22852638,8852638,A Perfect Getaway,Milla Jovovich|Timothy Olyphant|Steve Zahn|Chris Hemsworth|Anthony Ruivivar,David Twohy,98,Thriller|Mystery|Adventure,2009-06-08,185,6.1,2009,14229606,23227431,8997825,6
1478,0.850476,40000000,12206028,-27793972,Whiteout,Kate Beckinsale|Gabriel Macht|Tom Skerritt|Columbus Short|Shawn Doyle,Dominic Sena,101,Action|Crime|Mystery|Thriller,2009-09-09,114,5.2,2009,40656017,12406212,-28249805,5
1481,0.8342,13000000,10652035,-2347965,I Love You Phillip Morris,Jim Carrey|Ewan McGregor|Leslie Mann|Rodrigo Santoro|Brennan Brown,Glenn Ficarra|John Requa,98,Comedy|Drama|Romance,2009-01-18,311,6.3,2009,13213205,10826732,-2386473,6
1482,0.830596999999999,13000000,754249,-12245751,Enter the Void,Nathaniel Brown|Paz de la Huerta|Cyril Roy|Masato Tanno|Jesse Kuhn,Gaspar NoÃ©,161,Fantasy|Drama,2009-05-05,195,7.1,2009,13213205,766619,-12446586,7
1484,0.826039,20000000,17280326,-2719674,12 Rounds,John Cena|Ashley Scott|Brian J. White|Aidan Gillen|Steve Harris,Renny Harlin,108,Action|Adventure|Drama|Thriller,2009-03-19,130,5.9,2009,20328008,17563730,-2764278,6
1486,0.816681,9000000,70000000,61000000,3 Idiots,Aamir Khan|Kareena Kapoor|Madhavan|Sharman Joshi|Boman Irani,Rajkumar Hirani,170,Drama|Comedy|Romance,2009-12-23,662,7.8,2009,9147603,71148030,62000427,8
1487,0.813322999999999,150000000,836297228,686297228,Transformers: Revenge of the Fallen,Shia LaBeouf|Megan Fox|Josh Duhamel|Rainn Wilson|Tyrese Gibson,Michael Bay,150,Science Fiction|Action|Adventure,2009-06-19,2230,6.0,2009,152460065,850012865,697552800,6
1488,0.811236,24000000,68729358,44729358,The Men Who Stare at Goats,George Clooney|Ewan McGregor|Jeff Bridges|Kevin Spacey|Robert Patrick,Grant Heslov,93,Comedy|War,2009-10-17,435,5.8,2009,24393610,69856549,45462939,6
1490,0.796760999999999,40000000,60462347,20462347,Ninja Assassin,Rain|Naomie Harris|Sung Kang|Randall Duk Kim|Rick Yune,James McTeigue,99,Action|Crime|Thriller,2009-09-29,218,6.1,2009,40656017,61453955,20797938,6
1491,0.790326,20000000,5210988,-14789012,Bandslam,Vanessa Hudgens|Aly Michalka|Gaelan Connell|Lisa Kudrow|Scott Porter,Todd Graff,111,Comedy|Drama|Family|Music,2009-08-06,75,5.5,2009,20328008,5296450,-15031558,5
1492,0.786389999999999,100000000,100086793,86793,Where the Wild Things Are,Max Records|Catherine Keener|Lauren Ambrose|James Gandolfini|Catherine O'Hara,Spike Jonze,101,Family|Fantasy,2009-10-16,312,6.3,2009,101640043,101728259,88216,6
1493,0.786159,85000000,219103655,134103655,It's Complicated,Meryl Streep|Alec Baldwin|Steve Martin|Lake Bell|Mary Kay Place,Nancy Meyers,121,Comedy|Romance,2009-12-23,225,6.2,2009,86394036,222697050,136303014,6
1498,0.760048,100000000,68688831,-31311169,Land of the Lost,Will Ferrell|Anna Friel|Danny McBride|Jorma Taccone|Matt Lauer,Brad Silberling,102,Adventure|Comedy|Science Fiction,2009-06-05,220,5.4,2009,101640043,69815357,-31824686,5
1499,0.756385,60000000,122233971,62233971,Invictus,Morgan Freeman|Matt Damon|Tony Kgoroge|Patrick Mofokeng|Matt Stern,Clint Eastwood,134,Drama|History,2009-12-10,675,6.9,2009,60984026,124238661,63254635,7
1500,0.748763,70000000,104945765,34945765,Planet 51,Dwayne Johnson|Seann William Scott|Jessica Biel|Justin Long|Gary Oldman,Jorge Blanco|Javier Abad|Marcos MartÃ­nez,91,Science Fiction|Animation|Family|Comedy|Adventure,2009-11-19,354,5.7,2009,71148030,106666921,35518891,6
1506,0.717595,60000000,62357900,2357900,Year One,Jack Black|Michael Cera|Olivia Wilde|Oliver Platt|David Cross,Harold Ramis,97,Comedy|Adventure,2009-06-18,312,4.5,2009,60984026,63380596,2396570,4
1507,0.713022,4500000,744816,-3755184,Life During Wartime,Ally Sheedy|Paul Reubens|Shirley Henderson|Allison Janney|Michael Kenneth Williams,Todd Solondz,97,Comedy|Drama,2009-10-10,11,5.1,2009,4573801,757031,-3816770,5
1508,0.710966,12000000,1644755,-10355245,Ondine,Colin Farrell|Alicja Bachleda-CuruÅ›|Dervla Kirwan|Alison Barry|Marion O'Dwyer,Neil Jordan,111,Drama|Romance,2009-09-14,36,6.2,2009,12196805,1671729,-10525076,6
1510,0.694443,15000000,100734718,85734718,My Bloody Valentine,Jensen Ackles|Jaime King|Kerr Smith|Betsy Rue|Edi Gathegi,Patrick Lussier,101,Mystery|Horror,2009-01-16,151,5.3,2009,15246006,102386811,87140805,5
1514,0.6642,35000000,92219310,57219310,Old Dogs,Robin Williams|John Travolta|Seth Green|Justin Long|Matt Dillon,Walt Becker,88,Comedy|Family,2009-11-24,124,5.2,2009,35574015,93731746,58157731,5
1516,0.661609,70000000,39041505,-30958495,Agora,Rachel Weisz|Max Minghella|Oscar Isaac|Ashraf Barhom|Michael Lonsdale,Alejandro AmenÃ¡bar,127,Adventure|Drama|History,2009-05-17,238,6.6,2009,71148030,39681802,-31466228,7
1518,0.652939,8000000,10629321,2629321,The Boondock Saints II: All Saints Day,"Sean Patrick Flanery|Norman Reedus|Billy Connolly|Clifton Collins, Jr.|Julie Benz",Troy Duffy,118,Action|Thriller|Crime,2009-11-24,151,5.9,2009,8131203,10803646,2672443,6
1519,0.643829,25000000,10589102,-14410898,The Bad Lieutenant: Port of Call - New Orleans,Nicolas Cage|Eva Mendes|Val Kilmer|Fairuza Balk|Shawn Hatosy,Werner Herzog,122,Drama|Crime,2009-09-11,157,5.8,2009,25410010,10762767,-14647243,6
1520,0.643164,30000000,61808775,31808775,The Imaginarium of Doctor Parnassus,Christopher Plummer|Heath Ledger|Johnny Depp|Jude Law|Colin Farrell,Terry Gilliam,123,Adventure|Fantasy|Mystery,2009-10-01,502,6.2,2009,30492013,62822465,32330452,6
1521,0.642045,20000000,1017401,-18982599,Horsemen,"Dennis Quaid|Zhang Ziyi|Lou Taylor Pucci|Clifton Collins, Jr.|Barry Shabaka Henley",Jonas Ã…kerlund,90,Crime|Drama|Horror|Mystery|Thriller,2009-02-06,63,6.0,2009,20328008,1034086,-19293922,6
1522,0.630068,20000000,22942221,2942221,Armored,Columbus Short|Laurence Fishburne|Skeet Ulrich|Amaury Nolasco|Matt Dillon,NimrÃ³d Antal,88,Action|Crime|Drama|Thriller,2009-12-04,117,5.6,2009,20328008,23318483,2990475,6
1527,0.608282,40000000,28169671,-11830329,Cirque du Freak: The Vampire's Assistant,John C. Reilly|Josh Hutcherson|Chris Massoglia|Patrick Fugit|Salma Hayek,Paul Weitz,109,Adventure|Fantasy|Action|Thriller,2009-10-23,218,5.5,2009,40656017,28631665,-12024352,5
1529,0.606857,9000000,985117,-8014883,Leaves of Grass,Susan Sarandon|Richard Dreyfuss|Keri Russell|Melanie Lynskey|Edward Norton,Tim Blake Nelson,104,Comedy|Crime|Drama|Thriller,2009-09-13,67,5.6,2009,9147603,1001273,-8146330,6
1530,0.60652,7500000,26096852,18596852,An Education,Carey Mulligan|Olivia Williams|Peter Sarsgaard|Alfred Molina|Cara Seymour,Lone Scherfig,100,Drama|Romance,2009-10-29,234,6.8,2009,7623003,26524851,18901848,7
1531,0.604388,75000000,61458982,-13541018,Funny People,Adam Sandler|Seth Rogen|Leslie Mann|Eric Bana|Jonah Hill,Judd Apatow,146,Comedy|Drama,2009-07-31,213,5.5,2009,76230032,62466935,-13763097,5
1533,0.598075,25000000,163670000,138670000,Up in the Air,George Clooney|Vera Farmiga|Anna Kendrick|Jason Bateman|Melanie Lynskey,Jason Reitman,109,Drama|Romance,2009-09-05,751,6.6,2009,25410010,166354259,140944249,7
1534,0.595489,65000000,44091067,-20908933,Astro Boy,Nicolas Cage|Kristen Bell|Bill Nighy|Donald Sutherland|Freddie Highmore,David Bowers,94,Animation|Action|Family|Science Fiction,2009-10-15,284,6.0,2009,66066028,44814179,-21251849,6
1535,0.59517,50000000,60161391,10161391,The International,Clive Owen|Naomi Watts|Armin Mueller-Stahl|Ulrich Thomsen|BrÃ­an F. O'Byrne,Tom Tykwer,118,Drama|Thriller|Crime,2009-02-03,207,5.8,2009,50820021,61148063,10328042,6
1538,0.582225,14000000,875386,-13124614,Universal Soldier: Regeneration,Jean-Claude Van Damme|Dolph Lundgren|Andrei Arlovski|Mike Pyle|Corey Johnson,John Hyams,97,Adventure|Action|Science Fiction|Thriller,2009-10-01,64,5.3,2009,14229606,889742,-13339864,5
1539,0.580292,85000000,363164265,278164265,Fast & Furious,Vin Diesel|Paul Walker|Jordana Brewster|Michelle Rodriguez|John Ortiz,Justin Lin,107,Action|Crime|Drama|Thriller,2009-04-02,1661,6.4,2009,86394036,369120316,282726280,6
1542,0.576401,20000000,17436509,-2563491,Capitalism: A Love Story,Michael Moore|Thora Birch|William Black|Elijah Cummings|Baron Hill,Michael Moore,120,Documentary,2009-09-06,78,6.9,2009,20328008,17722475,-2605533,7
1546,0.565345,15000000,39421467,24421467,Halloween II,Scout Taylor-Compton|Sheri Moon Zombie|Tyler Mane|Chase Wright Vanek|Brad Dourif,Rob Zombie,105,Horror,2009-08-28,131,5.2,2009,15246006,40067996,24821990,5
1550,0.549975,35000000,155545279,120545279,Hannah Montana: The Movie,Miley Cyrus|Billy Ray Cyrus|Emily Osment|Jason Earles|Taylor Swift,Peter Chelsom,102,Comedy|Drama|Family|Music|Romance,2009-04-10,247,5.8,2009,35574015,158096289,122522274,6
1552,0.544071,15000000,8786375,-6213625,Banlieue 13 - Ultimatum,Cyril Raffaelli|David Belle|Philippe Torreton|Daniel Duval|Elodie Yung,Patrick Alessandrin,101,Action|Thriller|Crime,2009-02-18,193,5.9,2009,15246006,8930475,-6315531,6
1554,0.53923,45000000,57881056,12881056,Aliens in the Attic,Carter Jenkins|Austin Butler|Kevin Nealon|Robert Hoffman|Doris Roberts,John Schultz,86,Adventure|Comedy|Family|Fantasy|Science Fiction,2009-07-31,146,5.1,2009,45738019,58830330,13092311,5
1558,0.536017,3400000,9444018,6044018,The Collector,Josh Stewart|Michael Reilly Burke|Andrea Roth|Juan FernÃ¡ndez|Madeline Zima,Marcus Dunstan,88,Horror|Thriller,2009-07-09,172,6.2,2009,3455761,9598903,6143142,6
1561,0.534693,3000000,18097,-2981903,Women in Trouble,Carla Gugino|Adrianne Palicki|Connie Britton|Marley Shelton|Garcelle Beauvais,Sebastian Gutierrez,92,Comedy|Drama,2009-11-13,11,4.5,2009,3049201,18393,-3030808,4
1562,0.52916,10000000,42333295,32333295,The Fourth Kind,Milla Jovovich|Will Patton|Hakeem Kae-Kazim|Corey Johnson|Enzo Cilenti,Olatunde Osunsanmi,98,Science Fiction|Thriller,2009-11-06,244,5.6,2009,10164004,43027579,32863575,6
1564,0.520419,15000000,5024782,-9975218,Solitary Man,Michael Douglas|Jesse Eisenberg|Susan Sarandon|Mary-Louise Parker|Jenna Fischer,Brian Koppelman|David Levien,90,Comedy|Drama|Romance,2009-09-07,42,5.7,2009,15246006,5107190,-10138816,6
1568,0.510379,800000,867714,67714,The Disappearance of Alice Creed,Gemma Arterton|Martin Compston|Eddie Marsan,J Blakeson,100,Crime|Drama|Thriller,2009-09-12,74,6.3,2009,813120,881944,68824,6
1569,0.508705,78146652,60000000,-18146652,Duplicity,Clive Owen|Julia Roberts|Paul Giamatti|Tom Wilkinson|Lisa Roberts Gillan,Tony Gilroy,125,Thriller,2009-03-19,124,5.5,2009,79428291,60984026,-18444265,5
1577,0.492366,8500000,4440055,-4059945,Bright Star,Abbie Cornish|Ben Whishaw|Paul Schneider|Kerry Fox|Edie Martin,Jane Campion,119,Drama|Romance,2009-11-05,65,6.3,2009,8639403,4512873,-4126530,6
1582,0.480074,9500000,17164377,7664377,Adventureland,Jesse Eisenberg|Kristen Stewart|Martin Starr|Kristen Wiig|Bill Hader,Greg Mottola,107,Comedy,2009-04-03,400,6.3,2009,9655804,17445880,7790076,6
1583,0.478888,8000000,10848783,2848783,Extract,Jason Bateman|Mila Kunis|Kristen Wiig|Ben Affleck|J.K. Simmons,Mike Judge,92,Comedy,2009-09-03,94,5.8,2009,8131203,11026707,2895504,6
1585,0.476687,3500000,44462,-3455538,Defendor,Woody Harrelson|Kat Dennings|Elias Koteas|Sandra Oh|Clark Johnson,Peter Stebbings,101,Drama|Action|Comedy|Crime,2009-09-12,85,6.3,2009,3557401,45191,-3512210,6
1588,0.472113,80000000,53825515,-26174485,Nine,Judi Dench|Daniel Day-Lewis|Marion Cotillard|PenÃ©lope Cruz|Sophia Loren,Rob Marshall,112,Drama|Music|Romance,2009-12-03,95,5.0,2009,81312034,54708276,-26603758,5
1590,0.471747,6500000,1521261,-4978739,The Messenger,Ben Foster|Woody Harrelson|Jena Malone|Eamonn Walker|Samantha Morton,Oren Moverman,113,Drama|History,2009-11-13,61,6.9,2009,6606602,1546210,-5060392,7
1593,0.461154,17000000,14899417,-2100583,Away We Go,John Krasinski|Maya Rudolph|Carmen Ejogo|Catherine O'Hara|Jeff Daniels,Sam Mendes,98,Drama|Comedy|Romance,2009-06-05,103,6.6,2009,17278807,15143773,-2135034,7
1594,0.458932,17000000,20455276,3455276,My Life in Ruins,Nia Vardalos|Richard Dreyfuss|Alexis Georgoulis|Alistair McGowan|Harland Williams,Donald Petrie,95,Comedy|Romance,2009-02-06,56,5.7,2009,17278807,20790751,3511944,6
1595,0.457298,30000000,95714875,65714875,My Sister's Keeper,Cameron Diaz|Alec Baldwin|Abigail Breslin|Joan Cusack|Sofia Vassilieva,Nick Cassavetes,109,Drama,2009-06-26,354,7.0,2009,30492013,97284640,66792627,7
1599,0.447106,60000000,31720158,-28279842,The Soloist,Robert Downey Jr.|Jamie Foxx|Catherine Keener|Nelsan Ellis|Michael Bunin,Joe Wright,109,Drama,2009-04-24,133,6.5,2009,60984026,32240382,-28743644,6
1601,0.441444,19000000,91379051,72379051,Friday the 13th,Derek Mears|Jared Padalecki|Danielle Panabaker|Amanda Righetti|Travis Van Winkle,Marcus Nispel,97,Horror,2009-02-11,275,5.6,2009,19311608,92877707,73566099,6
1603,0.438147,25000000,1037335,-23962665,Crossing Over,Harrison Ford|Ray Liotta|Ashley Judd|Jim Sturgess|Cliff Curtis,Wayne Kramer,113,Drama,2009-02-27,49,5.8,2009,25410010,1054347,-24355663,6
1607,0.429492,7300000,10329747,3029747,Harry Brown,Michael Caine|Emily Mortimer|Iain Glen|Lee Oakes|Liam Cunningham,Daniel Barber,103,Thriller|Crime|Drama|Action,2009-11-11,172,6.6,2009,7419723,10499159,3079436,7
1608,0.427479,80000000,122444772,42444772,Surrogates,Bruce Willis|Radha Mitchell|Rosamund Pike|James Cromwell|Ving Rhames,Jonathan Mostow,89,Action|Science Fiction|Thriller,2009-09-24,755,5.7,2009,81312034,124452919,43140885,6
1612,0.426205,50000000,12764201,-37235799,Street Fighter: The Legend of Chun-Li,Kristin Kreuk|Chris Klein|Neal McDonough|Michael Clarke Duncan|Moon Bloodgood,Andrzej Bartkowiak,97,Action|Adventure|Science Fiction|Thriller,2009-02-27,71,4.1,2009,50820021,12973539,-37846482,4
1613,0.424415,35000000,73034460,38034460,Hotel for Dogs,Emma Roberts|Jake T. Austin|Don Cheadle|Johnny Simmons|Kyla Pratt,Thor Freudenthal,100,Comedy|Family,2009-01-16,108,5.6,2009,35574015,74232256,38658241,6
1618,0.415099,20000000,73830340,53830340,Obsessed,BeyoncÃ© Knowles|Idris Elba|Ali Larter|Jerry O'Connell|Bonnie Perlman,Steve Shill,108,Drama|Thriller,2009-04-24,67,5.5,2009,20328008,75041189,54713181,5
1619,0.41491,15000000,113221,-14886779,Tetro,Vincent Gallo|Maribel VerdÃº|Klaus Maria Brandauer|Alden Ehrenreich|Silvia PÃ©rez,Francis Ford Coppola,127,Drama|Mystery,2009-06-11,19,6.7,2009,15246006,115077,-15130929,7
1625,0.409005,15000000,16633035,1633035,Whip It,Ellen Page|Landon Pigg|Drew Barrymore|Sarah Habel|Shannon Eagen,Drew Barrymore,111,Drama,2009-09-13,214,6.6,2009,15246006,16905823,1659817,7
1637,0.395616,45000000,7810000,-37190000,Solomon Kane,James Purefoy|Pete Postlethwaite|Alice Krige|Mackenzie Crook|Max von Sydow,Michael J. Bassett,104,Adventure|Fantasy|Action|Science Fiction,2009-09-16,230,5.5,2009,45738019,7938087,-37799932,5
1639,0.394989,4000000,143191,-3856809,Survival of the Dead,Alan van Sprang|Kenneth Welsh|Kathleen Munroe|Devon Bostick|Richard Fitzpatrick,George A. Romero,90,Horror|Science Fiction,2009-09-09,35,4.6,2009,4065601,145539,-3920062,5
1644,0.391859,150000000,341131793,191131793,X-Men Origins: Wolverine,Hugh Jackman|Liev Schreiber|Danny Huston|Lynn Collins|Ryan Reynolds,Gavin Hood,107,Adventure|Action|Thriller|Science Fiction,2009-04-28,2784,6.2,2009,152460065,346726502,194266437,6
1648,0.388026,4000000,4100000,100000,S. Darko,Daveigh Chase|Elizabeth Berkley|Briana Evigan|James Lafferty|Ed Westwick,Chris Fisher,103,Thriller|Crime|Science Fiction|Mystery,2009-04-28,63,3.8,2009,4065601,4167241,101640,4
1653,0.378522,2900000,296557,-2603443,Black Dynamite,Michael Jai White|Arsenio Hall|Tommy Davidson|Kevin Chapman|Richard Edson,Scott Sanders,90,Action|Comedy,2009-10-16,102,7.4,2009,2947561,301420,-2646141,7
1655,0.376543,6000000,6670712,670712,City Island,Andy GarcÃ­a|Julianna Margulies|Steven Strait|Dominik GarcÃ­a-Lorido|Ezra Miller,Raymond De Felitta,104,Drama|Comedy,2009-03-06,51,6.3,2009,6098402,6780114,681712,6
1658,0.370497,40000000,19258519,-20741481,Amelia,Hilary Swank|Richard Gere|Aaron Abrams|Ewan McGregor|Christopher Eccleston,Mira Nair,111,Drama|Adventure|Romance,2009-10-22,41,5.3,2009,40656017,19574367,-21081650,5
1666,0.363832,25000000,4388563,-20611437,Beyond a Reasonable Doubt,Michael Douglas|Jesse Metcalfe|Amber Tamblyn|Joel David Moore|Orlando Jones,Peter Hyams,105,Drama,2009-02-05,42,5.6,2009,25410010,4460537,-20949473,6
1674,0.353203,8000000,29010817,21010817,New in Town,RenÃ©e Zellweger|Harry Connick Jr.|J.K. Simmons|Siobhan Fallon|Mike O'Brien,Jonas Elmer,97,Comedy|Romance,2009-01-30,50,5.3,2009,8131203,29486606,21355403,5
1675,0.348842,25000000,2336172,-22663828,Me and Orson Welles,Zac Efron|Claire Danes|Christian McKay|Imogen Poots|Zoe Kazan,Richard Linklater,114,Comedy|Drama|Romance,2009-11-25,24,6.4,2009,25410010,2374486,-23035524,6
1676,0.347707,40000000,28972508,-11027492,Shorts,Jimmy Bennett|Kat Dennings|Jolie Vanier|William H. Macy|James Spader,Robert Rodriguez,89,Comedy|Family,2009-08-21,20,4.8,2009,40656017,29447669,-11208348,5
1699,0.319532,12500000,27206120,14706120,Sorority Row,Rumer Willis|Briana Evigan|Jamie Chung|Leah Pipes|Teri Andrzejewski,Stewart Hendler,101,Horror|Mystery|Thriller,2009-09-09,92,5.3,2009,12705005,27652312,14947307,5
1722,0.292324,23000000,9366227,-13633773,ChÃ©ri,Michelle Pfeiffer|Kathy Bates|Rupert Friend|Felicity Jones|Iben Hjejle,Stephen Frears,86,Drama|Comedy|Romance,2009-02-10,29,5.8,2009,23377209,9519837,-13857372,6
1724,0.290674,10000000,7022728,-2977272,The Joneses,David Duchovny|Demi Moore|Amber Heard|Benjamin Hollingsworth|Lauren Hutton,Derrick Borte,96,Comedy|Drama,2009-09-13,117,6.0,2009,10164004,7137903,-3026101,6
1728,0.285353,20000000,18599102,-1400898,Fired Up!,Nicholas D'Agosto|Eric Christian Olsen|Sarah Roemer|Molly Sims|Danneel Ackles,Will Gluck,90,Comedy|Romance,2009-02-20,103,5.9,2009,20328008,18904135,-1423873,6
1733,0.278387,75,134,59,Wanted,Salman Khan|Ayesha Takia|Mahesh Manjrekar|Prakash Raj|Vinod Khanna,Prabhu Deva,129,Action|Comedy|Crime|Thriller,2009-09-18,18,4.9,2009,76,136,60,5
1734,0.278321,10000000,295750,-9704250,World's Greatest Dad,Robin Williams|Alexie Gilmore|Daryl Sabara|Geoff Pierson|Henry Simmons,Bobcat Goldthwait,99,Comedy|Romance,2009-08-20,67,6.3,2009,10164004,300600,-9863404,6
1736,0.272422,1700000,1007962,-692038,The Girlfriend Experience,Sasha Grey|Chris Santos|Peter Zizzo|Timothy J. Cox|Timothy Davis,Steven Soderbergh,77,Comedy|Drama,2009-01-20,41,5.5,2009,1727880,1024493,-703387,5
1756,0.249295,15000000,6405245,-8594755,Post Grad,Alexis Bledel|Zach Gilford|Rodrigo Santoro|Jane Lynch|Carol Burnett,Vicky Jenson,89,Comedy,2009-08-21,63,5.1,2009,15246006,6510293,-8735713,5
1758,0.118533,1000000,1296971,296971,Paper Heart,Michael Cera|Charlyne Yi|Jake Johnson|Gill Summers|Martin Starr,Nicholas Jasenovec,88,Comedy|Drama|Romance,2009-07-31,17,5.1,2009,1016400,1318241,301841,5
1774,0.226009,7000000,39462438,32462438,Crazy Heart,Jeff Bridges|Maggie Gyllenhaal|Colin Farrell|Robert Duvall|Paul Herman,Scott Cooper,112,Drama|Music|Romance,2009-12-16,126,6.4,2009,7114803,40109639,32994836,6
1780,0.220819,2000000,7306,-1992694,Stolen Lives,Jon Hamm|Josh Lucas|Rhona Mitra|James Van Der Beek|Jessica Chastain,Anders Anderson,97,Crime|Drama|Mystery|Thriller,2009-10-10,12,6.0,2009,2032800,7425,-2025375,6
1797,0.182881,2500000,352810,-2147190,Like Dandelion Dust,Mira Sorvino|Barry Pepper|Cole Hauser|Kate Levering,Jon Gunn,100,Drama|Family,2009-02-05,11,7.0,2009,2541001,358596,-2182405,7
1800,0.190162,7000000,1429299,-5570701,I Hope They Serve Beer in Hell,Matt Czuchry|Jesse Bradford|Marika Dominczyk|Traci Lords|Geoff Stults,Bob Gosse,106,Comedy|Drama,2009-09-25,11,5.6,2009,7114803,1452740,-5662063,6
1818,0.159638,1500000,56000,-1444000,Beautiful,Deborra-Lee Furness|Peta Wilson|Aaron Jeffery|Asher Keddie|Erik Thomson,Dean O'Flaherty,97,Drama|Mystery|Thriller,2009-04-27,10,4.4,2009,1524600,56918,-1467682,4
1829,0.145905,58000000,85280250,27280250,Did You Hear About The Morgans?,Hugh Grant|Sarah Jessica Parker|Mary Steenburgen|Sam Elliott|Natalia Klimas,Marc Lawrence,103,Comedy,2009-12-17,181,5.0,2009,58951225,86678883,27727658,5
1831,0.145081,5000000,38610009,33610009,The Grudge 3,Johanna Braddy|Gil McKinney|Emi Ikehata|Jadie-Rose Hobson|Beau Mirchoff,Toby Wilkins,90,Horror|Thriller,2009-05-12,74,5.4,2009,5082002,39243229,34161227,5
1853,0.114458,250000,232732,-17268,Big Fan,Patton Oswalt|Kevin Corrigan|Michael Rapaport|Marcia Jean Kurtz|Serafina Fiore,Robert D. Siegel,91,Comedy|Drama,2009-01-18,16,5.7,2009,254100,236548,-17552,6
1866,0.166371,25000000,20719451,-4280549,Mao's Last Dancer,Chi Cao|Chengwu Guo|Wen Bin Huang|Joan Chen|Bruce Greenwood,Bruce Beresford,117,Drama|Romance,2009-10-01,16,6.7,2009,25410010,21059258,-4350752,7
1871,0.092519,31192,10000,-21192,Down Terrace,Robert Hill|Robin Hill|Julia Deakin|David Schaal|Tony Way,Ben Wheatley,89,Drama|Action|Comedy,2009-09-01,15,6.5,2009,31703,10164,-21539,6
1919,9.363643,160000000,825500000,665500000,Inception,Leonardo DiCaprio|Joseph Gordon-Levitt|Ellen Page|Tom Hardy|Ken Watanabe,Christopher Nolan,148,Action|Thriller|Science Fiction|Mystery|Adventure,2010-07-14,9767,7.9,2010,160000000,825500000,665500000,8
1920,5.70486,200000000,623933331,423933331,Iron Man 2,Robert Downey Jr.|Gwyneth Paltrow|Don Cheadle|Scarlett Johansson|Mickey Rourke,Jon Favreau,124,Adventure|Action|Science Fiction,2010-04-28,4920,6.6,2010,200000000,623933331,423933331,7
1921,5.57295,200000000,1025467110,825467110,Alice in Wonderland,Mia Wasikowska|Johnny Depp|Anne Hathaway|Helena Bonham Carter|Crispin Glover,Tim Burton,108,Family|Fantasy|Adventure,2010-03-03,2853,6.3,2010,200000000,1025467110,825467110,6
1922,5.29318,13000000,327803731,314803731,Black Swan,Natalie Portman|Mila Kunis|Vincent Cassel|Barbara Hershey|Winona Ryder,Darren Aronofsky,108,Drama|Mystery|Thriller,2010-12-02,2597,7.1,2010,13000000,327803731,314803731,7
1923,4.840588,250000000,954305868,704305868,Harry Potter and the Deathly Hallows: Part 1,Daniel Radcliffe|Emma Watson|Rupert Grint|Ralph Fiennes|Helena Bonham Carter,David Yates,146,Adventure|Fantasy|Family,2010-10-17,3467,7.4,2010,250000000,954305868,704305868,7
1924,3.791881,69000000,543513985,474513985,Despicable Me,Steve Carell|Jason Segel|Russell Brand|Julie Andrews|Will Arnett,Pierre Coffin|Chris Renaud,95,Action|Animation|Family,2010-07-08,4851,7.1,2010,69000000,543513985,474513985,7
1925,3.74884,80000000,274470394,194470394,The Expendables,Sylvester Stallone|Jason Statham|Dolph Lundgren|Eric Roberts|Randy Couture,Sylvester Stallone,103,Action|Thriller,2010-08-03,2025,5.9,2010,80000000,274470394,194470394,6
1926,3.560424,165000000,494878759,329878759,How to Train Your Dragon,Jay Baruchel|Gerard Butler|Craig Ferguson|America Ferrera|Jonah Hill,Dean DeBlois|Chris Sanders,98,Fantasy|Adventure|Animation|Family,2010-03-05,2949,7.4,2010,165000000,494878759,329878759,7
1927,3.176169,80000000,294804195,214804195,Shutter Island,Leonardo DiCaprio|Mark Ruffalo|Ben Kingsley|Emily Mortimer|Michelle Williams,Martin Scorsese,138,Drama|Thriller|Mystery,2010-02-18,3554,7.6,2010,80000000,294804195,214804195,8
1928,2.911727,170000000,400062763,230062763,TRON: Legacy,Garrett Hedlund|Jeff Bridges|Olivia Wilde|Bruce Boxleitner|Yaya DaCosta,Joseph Kosinski,125,Adventure|Action|Science Fiction,2010-12-10,2026,6.3,2010,170000000,400062763,230062763,6
1929,2.865684,260000000,591794936,331794936,Tangled,Zachary Levi|Mandy Moore|Donna Murphy|Ron Perlman|M.C. Gainey,Nathan Greno|Byron Howard,100,Animation|Family,2010-11-24,2019,7.3,2010,260000000,591794936,331794936,7
1930,2.711136,200000000,1063171911,863171911,Toy Story 3,Tom Hanks|Tim Allen|Ned Beatty|Joan Cusack|Michael Keaton,Lee Unkrich,103,Animation|Family|Comedy,2010-06-16,2924,7.5,2010,200000000,1063171911,863171911,7
1931,2.586787,110000000,293329073,183329073,Salt,Angelina Jolie|Liev Schreiber|Corey Stoll|Chiwetel Ejiofor|Daniel Olbrychski,Phillip Noyce,100,Action|Thriller|Crime|Mystery,2010-07-21,1433,6.2,2010,110000000,293329073,183329073,6
1932,2.440611,18000000,35692920,17692920,127 Hours,James Franco|Kate Mara|Amber Tamblyn|ClÃ©mence PoÃ©sy|Lizzy Caplan,Danny Boyle,94,Adventure|Drama|Thriller,2010-11-05,1645,6.9,2010,18000000,35692920,17692920,7
1933,2.332359,8000000,74952305,66952305,Easy A,Emma Stone|Stanley Tucci|Amanda Bynes|Cam Gigandet|Lisa Kudrow,Will Gluck,92,Comedy,2010-09-10,1303,6.6,2010,8000000,74952305,66952305,7
1934,2.245241,155000000,415686217,260686217,The Chronicles of Narnia: The Voyage of the Dawn Treader,Skandar Keynes|Georgie Henley|Simon Pegg|Gary Sweet|Arthur Angel,Michael Apted,113,Adventure|Family|Fantasy,2010-08-13,905,6.0,2010,155000000,415686217,260686217,6
1935,2.225609,28000000,96188903,68188903,Kick-Ass,Aaron Taylor-Johnson|ChloÃ« Grace Moretz|Christopher Mintz-Plasse|Nicolas Cage|Mark Strong,Matthew Vaughn,117,Action|Crime,2010-03-22,3085,7.0,2010,28000000,96188903,68188903,7
1936,2.162441,100000000,278346189,178346189,The Tourist,Johnny Depp|Angelina Jolie|Paul Bettany|Timothy Dalton|Steven Berkoff,Florian Henckel von Donnersmarck,103,Action|Thriller|Romance,2010-12-08,1084,6.0,2010,100000000,278346189,178346189,6
1937,2.128799,150000000,335154643,185154643,Prince of Persia: The Sands of Time,Jake Gyllenhaal|Gemma Arterton|Ben Kingsley|Alfred Molina|Steve Toussaint,Mike Newell,116,Adventure|Fantasy|Action|Romance,2010-05-19,1545,6.1,2010,150000000,335154643,185154643,6
1938,2.11831,200000000,310669540,110669540,Robin Hood,Russell Crowe|Cate Blanchett|Mark Strong|Oscar Isaac|LÃ©a Seydoux,Ridley Scott,140,Action,2010-05-12,844,6.1,2010,200000000,310669540,110669540,6
1939,2.100704,38000000,252276927,214276927,True Grit,Jeff Bridges|Hailee Steinfeld|Matt Damon|Josh Brolin|Barry Pepper,Ethan Coen|Joel Coen,110,Drama|Adventure|Western,2010-12-22,1084,7.0,2010,38000000,252276927,214276927,7
1940,2.087252,125000000,232713139,107713139,Clash of the Titans,Sam Worthington|Liam Neeson|Ralph Fiennes|Gemma Arterton|Jason Flemyng,Louis Leterrier,106,Adventure|Fantasy|Action,2010-04-01,1530,5.6,2010,125000000,232713139,107713139,6
1941,2.053855,150000000,215283742,65283742,The Sorcerer's Apprentice,Nicolas Cage|Jay Baruchel|Monica Bellucci|Alfred Molina|Teresa Palmer,Jon Turteltaub,109,Fantasy|Adventure|Action|Comedy|Drama,2010-07-13,871,5.8,2010,150000000,215283742,65283742,6
1943,1.923694,40000000,224920315,184920315,The Social Network,Jesse Eisenberg|Andrew Garfield|Justin Timberlake|Armie Hammer|Max Minghella,David Fincher,120,Drama,2010-09-30,2022,7.1,2010,40000000,224920315,184920315,7
1944,1.906739,60000000,47664559,-12335441,Scott Pilgrim vs. the World,Michael Cera|Mary Elizabeth Winstead|Kieran Culkin|Chris Evans|Anna Kendrick,Edgar Wright,112,Action|Adventure|Comedy,2010-07-27,1258,7.2,2010,60000000,47664559,-12335441,7
1945,1.903671,100000000,310650585,210650585,Little Fockers,Robert De Niro|Ben Stiller|Owen Wilson|Dustin Hoffman|Barbra Streisand,Paul Weitz,98,Comedy|Romance,2010-12-21,717,5.4,2010,100000000,310650585,210650585,5
1946,1.888263,40000000,126248813,86248813,Predators,Topher Grace|Alice Braga|Laurence Fishburne|Adrien Brody|Danny Trejo,NimrÃ³d Antal,107,Action|Science Fiction|Adventure|Thriller,2010-07-03,722,5.8,2010,40000000,126248813,86248813,6
1947,1.878018,95000000,226497209,131497209,Percy Jackson & the Olympians: The Lightning Thief,Logan Lerman|Brandon T. Jackson|Alexandra Daddario|Jake Abel|Sean Bean,Chris Columbus,118,Adventure|Fantasy|Family,2010-02-01,1175,6.0,2010,95000000,226497209,131497209,6
1948,1.874641,100000000,167805466,67805466,Unstoppable,Denzel Washington|Chris Pine|Rosario Dawson|Ethan Suplee|Kevin Corrigan,Tony Scott,98,Action|Thriller,2010-11-04,733,6.2,2010,100000000,167805466,67805466,6
1949,1.820934,165000000,752600867,587600867,Shrek Forever After,Mike Myers|Eddie Murphy|Cameron Diaz|Antonio Banderas|Julie Andrews,Mike Mitchell,93,Comedy|Adventure|Fantasy|Animation|Family,2010-05-16,1191,6.0,2010,165000000,752600867,587600867,6
1950,1.784073,25000000,114977104,89977104,Dear John,Amanda Seyfried|Channing Tatum|Henry Thomas|Richard Jenkins|Scott Porter,Lasse HallstrÃ¶m,115,Drama|Romance|War,2010-02-04,737,6.5,2010,25000000,114977104,89977104,6
1951,1.730679,110000000,177238796,67238796,The A-Team,Liam Neeson|Bradley Cooper|Jessica Biel|Sharlto Copley|Patrick Wilson,Joe Carnahan,117,Thriller|Action|Adventure|Comedy|Crime,2010-06-10,1162,6.2,2010,110000000,177238796,67238796,6
1952,1.720825,58000000,71664962,13664962,RED,Bruce Willis|John Malkovich|Helen Mirren|Mary-Louise Parker|Karl Urban,Robert Schwentke,111,Action|Adventure|Comedy|Crime|Thriller,2010-10-13,2064,6.5,2010,58000000,71664962,13664962,6
1953,1.71986,20000000,31327899,11327899,Machete,Danny Trejo|Michelle Rodriguez|Jessica Alba|Robert De Niro|Lindsay Lohan,Robert Rodriguez|Ethan Maniquis,105,Action|Comedy|Thriller,2010-09-01,753,6.2,2010,20000000,31327899,11327899,6
1954,1.659355,80000000,271430189,191430189,Grown Ups,Adam Sandler|Salma Hayek|Maria Bello|Steve Buscemi|Maya Rudolph,Dennis Dugan,102,Comedy,2010-06-24,1144,6.1,2010,80000000,271430189,191430189,6
1955,1.624483,80000000,157107755,77107755,The Book of Eli,Denzel Washington|Gary Oldman|Michael Gambon|Mila Kunis|Jennifer Beals,Albert Hughes|Allen Hughes,118,Action|Thriller|Science Fiction,2010-01-14,1506,6.5,2010,80000000,157107755,77107755,6
1956,1.618371,55000000,152263880,97263880,Date Night,Steve Carell|Tina Fey|Mark Wahlberg|Taraji P. Henson|Jimmi Simpson,Shawn Levy,97,Comedy,2010-04-08,781,5.9,2010,55000000,152263880,97263880,6
1957,1.614028,37000000,154026136,117026136,The Town,Ben Affleck|Rebecca Hall|Jeremy Renner|Jon Hamm|Blake Lively,Ben Affleck,125,Crime|Drama|Thriller,2010-09-15,930,6.9,2010,37000000,154026136,117026136,7
1959,1.546212,68000000,698491347,630491347,The Twilight Saga: Eclipse,Kristen Stewart|Robert Pattinson|Taylor Lautner|Ashley Greene|Peter Facinelli,David Slade,124,Adventure|Fantasy|Drama|Romance,2010-06-23,1331,5.9,2010,68000000,698491347,630491347,6
1960,1.540322,130000000,321885765,191885765,Megamind,Will Ferrell|Brad Pitt|Tina Fey|Jonah Hill|David Cross,Tom McGrath,95,Animation|Action|Comedy|Family|Science Fiction,2010-10-28,1190,6.6,2010,130000000,321885765,191885765,7
1961,1.538276,150000000,318502923,168502923,The Last Airbender,Noah Ringer|Nicola Peltz|Jackson Rathbone|Dev Patel|Shaun Toub,M. Night Shyamalan,103,Action|Adventure|Family|Fantasy,2010-06-30,732,4.7,2010,150000000,318502923,168502923,5
1962,1.419224,100000000,170432927,70432927,The Other Guys,Will Ferrell|Mark Wahlberg|Eva Mendes|Samuel L. Jackson|Dwayne Johnson,Adam McKay,107,Action|Comedy|Crime,2010-08-06,951,6.1,2010,100000000,170432927,70432927,6
1964,1.396973,1500000,97009150,95509150,Insidious,Patrick Wilson|Rose Byrne|Barbara Hershey|Leigh Whannell|Angus Sampson,James Wan,103,Horror|Thriller,2010-09-13,999,6.7,2010,1500000,97009150,95509150,7
1965,1.386743,30000000,159291809,129291809,Step Up 3D,Rick Malambri|Adam G. Sevani|Joe Slaughter|Sharni Vinson|Alyson Stoner,Jon M. Chu,107,Drama|Romance,2010-08-04,365,6.5,2010,30000000,159291809,129291809,6
1966,1.385499,15000000,414211549,399211549,The King's Speech,Colin Firth|Geoffrey Rush|Helena Bonham Carter|Guy Pearce|Timothy Spall,Tom Hooper,118,Drama|History,2010-09-06,1688,7.4,2010,15000000,414211549,399211549,7
1967,1.365279,30000000,102820008,72820008,Love & Other Drugs,Jake Gyllenhaal|Anne Hathaway|Oliver Platt|Hank Azaria|Gabriel Macht,Edward Zwick,112,Drama|Comedy|Romance,2010-11-22,756,6.5,2010,30000000,102820008,72820008,6
1968,1.36053,30000000,20348249,-9651751,The Way Back,Colin Farrell|Dejan Angelov|DragoÈ™ Bucur|Ed Harris|Jim Sturgess,Peter Weir,133,Drama|Adventure|History,2010-09-03,246,6.7,2010,30000000,20348249,-9651751,7
1969,1.348633,32000000,18409891,-13590109,Repo Men,Jude Law|Forest Whitaker|Alice Braga|Liev Schreiber|Carice van Houten,Miguel Sapochnik,111,Action|Science Fiction|Thriller|Crime,2010-03-18,375,6.1,2010,32000000,18409891,-13590109,6
1970,1.344701,7000000,7644937,644937,Last Night,Keira Knightley|Sam Worthington|Eva Mendes|Guillaume Canet|Griffin Dunne,Massy Tadjedin,90,Drama|Romance,2010-05-11,150,6.1,2010,7000000,7644937,644937,6
1971,1.325302,117000000,261930431,144930431,Knight and Day,Tom Cruise|Cameron Diaz|Peter Sarsgaard|Viola Davis|Jordi MollÃ ,James Mangold,109,Action|Comedy,2010-06-15,1045,5.9,2010,117000000,261930431,144930431,6
1973,1.271623,60000000,204594016,144594016,Eat Pray Love,Julia Roberts|James Franco|Javier Bardem|Billy Crudup|Richard Jenkins,Ryan Murphy,133,Drama,2010-08-12,407,5.7,2010,60000000,204594016,144594016,6
1974,1.271367,1000000,12355734,11355734,Blue Valentine,Ryan Gosling|Michelle Williams|Mike Vogel|John Doman|Faith Wladyka,Derek Cianfrance,112,Drama|Romance,2010-12-27,530,6.9,2010,1000000,12355734,11355734,7
1975,1.255298,40000000,136000000,96000000,The Bounty Hunter,Gerard Butler|Jennifer Aniston|Gio Perez|Siobhan Fallon|Joel Garland,Andy Tennant,110,Action,2010-03-16,553,5.5,2010,40000000,136000000,96000000,5
1976,1.2347,19000000,29922472,10922472,Leap Year,Amy Adams|Matthew Goode|Adam Scott|John Lithgow|Flaminia Cinque,Anand Tucker,100,Romance|Comedy,2010-01-08,283,6.3,2010,19000000,29922472,10922472,6
1977,1.206958,100000000,94882889,-5117111,Green Zone,Matt Damon|Greg Kinnear|Brendan Gleeson|Amy Ryan|Jason Isaacs,Paul Greengrass,115,Action|Adventure|Drama|Thriller,2010-03-11,445,6.3,2010,100000000,94882889,-5117111,6
1978,1.203837,112000000,237382724,125382724,Gulliver's Travels,Emily Blunt|Jason Segel|Jack Black|Amanda Peet|Chris O'Dowd,Rob Letterman,85,Comedy,2010-12-25,375,5.0,2010,112000000,237382724,125382724,5
1979,1.202845,35000000,77477008,42477008,The Back-Up Plan,Jennifer Lopez|Alex O'Loughlin|Danneel Ackles|Eric Christian Olsen|Anthony Anderson,Alan Poul,106,Comedy|Romance,2010-04-23,290,5.7,2010,35000000,77477008,42477008,6
1980,1.166631,44000000,48190704,4190704,Charlie St. Cloud,Zac Efron|Amanda Crew|Kim Basinger|Chris Massoglia|Dave Franco,Burr Steers,99,Drama,2010-05-01,324,6.8,2010,44000000,48190704,4190704,7
1981,1.147365,19000000,49830607,30830607,The Switch,Jason Bateman|Jennifer Aniston|Jeff Goldblum|Juliette Lewis|Todd Louiso,Josh Gordon|Will Speck,101,Comedy|Romance|Drama,2010-05-11,388,5.8,2010,19000000,49830607,30830607,6
1982,1.14644,10000000,2995811,-7004189,The Runaways,Dakota Fanning|Kristen Stewart|Michael Shannon|Riley Keough|Stella Maeve,Floria Sigismondi,106,Drama|Music,2010-03-19,133,6.3,2010,10000000,2995811,-7004189,6
1983,1.145806,52000000,216485654,164485654,Valentine's Day,Jessica Alba|Jessica Biel|Bradley Cooper|Eric Dane|Patrick Dempsey,Garry Marshall,125,Comedy|Romance,2010-02-10,675,5.6,2010,52000000,216485654,164485654,6
1984,1.138389,25000000,36993168,11993168,Don't Be Afraid of the Dark,Katie Holmes|Guy Pearce|Bailee Madison|Alan Dale|Jack Thompson,Troy Nixey,99,Fantasy|Horror|Thriller,2010-11-06,186,5.4,2010,25000000,36993168,11993168,5
1986,1.134397,20000000,136150434,116150434,Saw 3D,Tobin Bell|Costas Mandylor|Betsy Russell|Cary Elwes|Sean Patrick Flanery,Kevin Greutert,90,Horror|Crime,2010-10-21,397,5.8,2010,20000000,136150434,116150434,6
1987,1.125831,40000000,357852395,317852395,The Karate Kid,Jaden Smith|Jackie Chan|Taraji P. Henson|Yu Rong-Guang|Tess Liu,Harald Zwart,140,Action|Adventure|Drama|Family,2010-06-10,1019,6.1,2010,40000000,357852395,317852395,6
1988,1.119731,65000000,211780824,146780824,Due Date,Zach Galifianakis|Robert Downey Jr.|Michelle Monaghan|Jamie Foxx|Juliette Lewis,Todd Phillips,95,Comedy|Drama,2010-11-04,1015,6.2,2010,65000000,211780824,146780824,6
1989,1.111487,8000000,3453043,-4546957,Wild Target,Bill Nighy|Emily Blunt|Rupert Grint|Rupert Everett|Eileen Atkins,Jonathan Lynn,98,Action|Comedy,2010-06-17,101,6.1,2010,8000000,3453043,-4546957,6
1990,1.107689,52000000,52615806,615806,From Paris with Love,John Travolta|Jonathan Rhys Meyers|Kasia Smutniak|Richard Durden|Bing Yin,Pierre Morel,92,Action|Crime|Thriller,2010-02-05,432,6.1,2010,52000000,52615806,615806,6
1991,1.107358,45000000,60222298,15222298,The Ghost Writer,Ewan McGregor|Pierce Brosnan|Jon Bernthal|Kim Cattrall|Tom Wilkinson,Roman Polanski,128,Thriller|Mystery,2010-02-12,357,6.5,2010,45000000,60222298,15222298,6
1992,1.084894,8000000,6491240,-1508760,It's Kind of a Funny Story,Keir Gilchrist|Emma Roberts|Zach Galifianakis|Viola Davis|ZoÃ« Kravitz,Anna Boden|Ryan Fleck,101,Comedy|Drama,2010-07-06,364,6.9,2010,8000000,6491240,-1508760,7
1993,1.078211,30000000,51148651,21148651,The Next Three Days,Russell Crowe|Elizabeth Banks|Brian Dennehy|RZA|Moran Atias,Paul Haggis,133,Romance|Drama|Thriller|Crime,2010-11-18,570,6.8,2010,30000000,51148651,21148651,7
1994,1.074308,35000000,115664037,80664037,A Nightmare on Elm Street,Jackie Earle Haley|Katie Cassidy|Kyle Gallner|Kellan Lutz|Thomas Dekker,Samuel Bayer,95,Horror|Mystery|Thriller,2010-04-30,423,5.5,2010,35000000,115664037,80664037,5
1995,1.065023,25000000,23580000,-1420000,The Losers,Jeffrey Dean Morgan|Zoe Saldana|Chris Evans|Idris Elba|Columbus Short,Sylvain White,97,Action|Adventure|Crime|Mystery|Thriller,2010-04-23,298,6.2,2010,25000000,23580000,-1420000,6
1996,1.054685,25000000,9190869,-15809131,The Fighter,Mark Wahlberg|Christian Bale|Amy Adams|Melissa Leo|Mickey O'Keefe,David O. Russell,116,Drama,2010-12-17,965,7.1,2010,25000000,9190869,-15809131,7
1997,1.047978,40000000,90029656,50029656,Get Him to the Greek,Jonah Hill|Russell Brand|Rose Byrne|Colm Meaney|Sean Combs,Nicholas Stoller,109,Comedy,2010-06-04,359,5.9,2010,40000000,90029656,50029656,6
1999,1.023117,47000000,10539000,-36461000,Jonah Hex,Josh Brolin|John Malkovich|Megan Fox|Michael Fassbender|Will Arnett,Jimmy Hayward,80,Action|Western|Drama|Fantasy|Thriller,2010-06-18,252,4.4,2010,47000000,10539000,-36461000,4
2003,1.004446,20000000,80547866,60547866,Vampires Suck,Chris Riggi|Matt Lanter|Jenn Proske|Ken Jeong|Bradley Dodds,Jason Friedberg|Aaron Seltzer,82,Horror|Comedy,2010-08-18,177,4.3,2010,20000000,80547866,60547866,4
2004,1.003782,2000000,7871522,5871522,Inside Job,Matt Damon|William Ackman|Barack Obama|George W. Bush|Jonathan Alpert,Charles Ferguson,109,Documentary,2010-10-08,171,7.6,2010,2000000,7871522,5871522,8
2005,0.997641,75000000,98159963,23159963,Killers,Katherine Heigl|Ashton Kutcher|Tom Selleck|Catherine O'Hara|Alex Borstein,Robert Luketic,100,Action|Comedy|Thriller|Romance,2010-06-04,530,5.7,2010,75000000,98159963,23159963,6
2006,0.992107,26000000,67918658,41918658,Legion,Paul Bettany|Dennis Quaid|Kevin Durand|Kate Walsh|Doug Jones,Scott Stewart,100,Horror,2010-01-21,376,5.0,2010,26000000,67918658,41918658,5
2008,0.984762,100000000,288347692,188347692,Sex and the City 2,Sarah Jessica Parker|Kristin Davis|Cynthia Nixon|Kim Cattrall|Chris Noth,Michael Patrick King,146,Comedy|Drama|Romance,2010-05-26,275,5.5,2010,100000000,288347692,188347692,5
2009,0.982925,20000000,32005248,12005248,You Again,Kristen Bell|Sigourney Weaver|Betty White|Kristin Chenoweth|Odette Annable,Andy Fickman,105,Comedy|Romance,2010-09-24,213,6.0,2010,20000000,32005248,12005248,6
2010,0.981468,35000000,93246388,58246388,Nanny McPhee and the Big Bang,Emma Thompson|Ralph Fiennes|Maggie Gyllenhaal|Maggie Smith|Rhys Ifans,Susanna White,109,Fantasy|Comedy,2010-03-26,228,6.0,2010,35000000,93246388,58246388,6
2011,0.944055,36000000,64572262,28572262,Hot Tub Time Machine,John Cusack|Lizzy Caplan|Rob Corddry|Craig Robinson|Clark Duke,Steve Pink,101,Science Fiction|Comedy|Adventure,2010-03-26,550,5.9,2010,36000000,64572262,28572262,6
2013,0.919635,20000000,24145613,4145613,Let Me In,Kodi Smit-McPhee|ChloÃ« Grace Moretz|Richard Jenkins|Elias Koteas|Sasha Barrese,Matt Reeves,116,Drama|Horror|Mystery,2010-10-01,353,6.6,2010,20000000,24145613,4145613,7
2014,0.918093,14000000,1755212,-12244788,Flipped,Madeline Carroll|Callan McAuliffe|Anthony Edwards|Aidan Quinn|Rebecca De Mornay,Rob Reiner,90,Comedy|Drama|Romance,2010-08-06,259,7.2,2010,14000000,1755212,-12244788,7
2015,0.914278,80000000,140073390,60073390,Legend of the Guardians: The Owls of Ga'Hoole,Emily Barclay|Abbie Cornish|Essie Davis|Joel Edgerton|Deborra-Lee Furness,Zack Snyder,97,Animation|Adventure|Family|Fantasy,2010-07-10,471,6.5,2010,80000000,140073390,60073390,6
2016,0.912689,32000000,69055695,37055695,Takers,Chris Brown|Hayden Christensen|Matt Dillon|Michael Ealy|Idris Elba,John Luessenhop,107,Action|Crime|Drama|Thriller,2010-08-26,248,6.1,2010,32000000,69055695,37055695,6
2017,0.912122,55000000,89519773,34519773,Burlesque,Cher|Christina Aguilera|Eric Dane|Cam Gigandet|Julianne Hough,Steve Antin,119,Drama|Romance,2010-11-23,341,6.8,2010,55000000,89519773,34519773,7
2018,0.892355999999999,15000000,4882577,-10117423,The Company Men,Ben Affleck|Tommy Lee Jones|Chris Cooper|Kevin Costner|Maria Bello,John Wells,104,Drama,2010-10-21,133,6.4,2010,15000000,4882577,-10117423,6
2019,0.878529,32000000,42045846,10045846,Going the Distance,Drew Barrymore|Justin Long|Christina Applegate|Ron Livingston|Charlie Day,Nanette Burstein,102,Comedy|Drama|Romance,2010-09-01,172,6.0,2010,32000000,42045846,10045846,6
2020,0.878074,24000000,23081726,-918274,Faster,Dwayne Johnson|Billy Bob Thornton|Maggie Grace|Carla Gugino|Tom Berenger,"George Tillman, Jr.",98,Crime|Drama|Action|Thriller,2010-11-23,360,6.2,2010,24000000,23081726,-918274,6
2022,0.875432,3000000,177512032,174512032,Paranormal Activity 2,Katie Featherston|David Bierend|Brian Boland|Molly Ephraim|Seth Ginsberg,Tod Williams,91,Horror|Thriller,2010-10-20,421,5.7,2010,3000000,177512032,174512032,6
2023,0.856916,15000000,9455232,-5544768,Never Let Me Go,Carey Mulligan|Andrew Garfield|Keira Knightley|Domhnall Gleeson|Andrea Riseborough,Mark Romanek,104,Drama|Romance|Science Fiction,2010-09-15,414,6.7,2010,15000000,9455232,-5544768,7
2025,0.856221999999999,20000000,65464324,45464324,The American,George Clooney|Violante Placido|Thekla Reuten|Paolo Bonacelli|Johan Leysen,Anton Corbijn,104,Crime|Drama|Thriller,2010-08-31,290,5.6,2010,20000000,65464324,45464324,6
2027,0.839106999999999,30000000,55583804,25583804,Cop Out,Bruce Willis|Tracy Morgan|Juan Carlos HernÃ¡ndez|Seann William Scott|Michelle Trachtenberg,Kevin Smith,107,Action|Comedy|Crime,2010-02-26,310,5.5,2010,30000000,55583804,25583804,5
2029,0.827664,500000,4242978,3742978,Monsters,Whitney Able|Scoot McNairy|Annalee Jefferies|Kevon Kane|Fernando Lara,Gareth Edwards,94,Drama|Thriller|Science Fiction,2010-06-18,328,6.3,2010,500000,4242978,3742978,6
2031,0.82289,38000000,105610124,67610124,Life as We Know It,Katherine Heigl|Josh Duhamel|Christina Hendricks|Josh Lucas|Jean Smart,Greg Berlanti,115,Comedy|Romance|Drama,2010-10-08,516,6.5,2010,38000000,105610124,67610124,6
2032,0.804348,12000000,6814789,-5185211,Centurion,Michael Fassbender|Olga Kurylenko|David Morrissey|Liam Cunningham|Dominic West,Neil Marshall,97,Drama|Action|Thriller,2010-02-15,198,5.7,2010,12000000,6814789,-5185211,6
2033,0.802711,3200000,5332926,2132926,Beginners,Ewan McGregor|Christopher Plummer|MÃ©lanie Laurent|Goran Visnjic|Kai Lennox,Mike Mills,105,Drama|Romance|Comedy,2010-09-11,204,6.8,2010,3200000,5332926,2132926,7
2036,0.794885,22000000,851517,-21148483,Shelter,Julianne Moore|Jonathan Rhys Meyers|Jeffrey DeMunn|Frances Conroy|Nate Corddry,BjÃ¶rn Stein|MÃ¥ns MÃ¥rlind,112,Horror|Mystery|Thriller,2010-03-27,112,5.5,2010,22000000,851517,-21148483,5
2037,0.791799,22000000,9479718,-12520282,Stone,Frances Conroy|Robert De Niro|Edward Norton|Milla Jovovich,John Curran,105,Drama,2010-10-07,97,4.9,2010,22000000,9479718,-12520282,5
2038,0.789582,15000000,75700498,60700498,Diary of a Wimpy Kid,Zachary Gordon|Robert Capron|ChloÃ« Grace Moretz|Steve Zahn|Rachael Harris,Thor Freudenthal,94,Comedy|Family,2010-03-19,190,5.8,2010,15000000,75700498,60700498,6
2039,0.788144,2000000,572809,-1427191,I Spit on Your Grave,Sarah Butler|Daniel Franzese|Chad Lindberg|Jeff Branson|Rodney Eastman,Steven R. Monroe,108,Thriller|Crime|Horror,2010-06-17,269,6.2,2010,2000000,572809,-1427191,6
2040,0.78688,24000000,83188165,59188165,Piranha 3D,Elisabeth Shue|Adam Scott|Jerry O'Connell|Steven R. McQueen|Jessica Szohr,Alexandre Aja,88,Comedy|Horror,2010-08-20,306,5.2,2010,24000000,83188165,59188165,5
2041,0.778439999999999,40000000,58785180,18785180,Morning Glory,Rachel McAdams|Harrison Ford|Patrick Wilson|Jeff Goldblum|Diane Keaton,Roger Michell,102,Comedy|Drama|Romance,2010-01-12,246,6.1,2010,40000000,58785180,18785180,6
2042,0.773316,12500000,6732980,-5767020,Conviction,Hilary Swank|Minnie Driver|Bailee Madison|Loren Dean|John Pyper-Ferguson,Tony Goldwyn,107,Drama,2010-09-11,87,7.0,2010,12500000,6732980,-5767020,7
2043,0.764791,90000000,16178959,-73821041,The Nutcracker: The Untold Story,Nathan Lane|John Turturro|Frances de la Tour|Elle Fanning|Jonny Coyne,Andrei Konchalovsky,110,Fantasy|Action|Family,2010-11-24,28,5.8,2010,90000000,16178959,-73821041,6
2044,0.761889,1800000,67738090,65938090,The Last Exorcism,Ashley Bell|Patrick Fabian|Iris Bahr|Louis Herthum|Caleb Landry Jones,Daniel Stamm,87,Horror|Drama|Thriller,2010-08-27,179,5.4,2010,1800000,67738090,65938090,5
2045,0.756229,48000000,112462508,64462508,Tooth Fairy,Dwayne Johnson|Stephen Merchant|Ashley Judd|Julie Andrews|Ryan Sheckler,Michael Lembeck,101,Comedy|Family|Fantasy,2010-01-14,282,5.2,2010,48000000,112462508,64462508,5
2047,0.754168,22000000,24188922,2188922,Fair Game,Naomi Watts|Sean Penn|Ty Burrell|Brooke Smith|Bruce McGill,Doug Liman,108,Drama|Thriller,2010-05-20,129,6.4,2010,22000000,24188922,2188922,6
2048,0.745434,10000000,498974,-9501026,The Ward,Lyndsy Fonseca|Amber Heard|Danielle Panabaker|Jared Harris|Mamie Gummer,John Carpenter,88,Horror|Thriller,2010-09-13,166,5.9,2010,10000000,498974,-9501026,6
2050,0.740867,1987650,19152480,17164830,Buried,Ryan Reynolds|JosÃ© Luis GarcÃ­a PÃ©rez|Robert Paterson|Stephen Tobolowsky|Samantha Mathis,Rodrigo CortÃ©s,94,Drama|Thriller|Mystery,2010-09-24,458,6.5,2010,1987650,19152480,17164830,6
2051,0.73988,69000000,86387857,17387857,Dinner for Schmucks,Steve Carell|Paul Rudd|Stephanie Szostak|Jemaine Clement|Zach Galifianakis,Jay Roach,114,Comedy,2010-07-30,324,5.4,2010,69000000,86387857,17387857,5
2055,0.68633,4000000,34705850,30705850,The Kids Are All Right,Julianne Moore|Annette Bening|Mark Ruffalo|Mia Wasikowska|Josh Hutcherson,Lisa Cholodenko,106,Comedy|Drama,2010-07-09,280,6.4,2010,4000000,34705850,30705850,6
2057,0.671484,10000000,66821036,56821036,Skyline,Eric Balfour|Scottie Thompson|David Zayas|Donald Faison|Brittany Daniel,Colin Strause|Greg Strause,100,Science Fiction,2010-11-11,304,4.7,2010,10000000,66821036,56821036,5
2058,0.670027,20000000,45636368,25636368,The Debt,Helen Mirren|Sam Worthington|Jessica Chastain|Tom Wilkinson|CiarÃ¡n Hinds,John Madden,113,Drama|Thriller,2010-04-11,147,6.1,2010,20000000,45636368,25636368,6
2062,0.659749,2000000,13831503,11831503,Winter's Bone,Jennifer Lawrence|John Hawkes|Kevin Breznahan|Dale Dickey|Garret Dillahunt,Debra Granik,100,Drama,2010-06-11,289,6.7,2010,2000000,13831503,11831503,7
2064,0.655955,7000000,46488,-6953512,Ca$h,Sean Bean|Chris Hemsworth|Victoria Profeta|Thampy Antony|Mike Starr,Stephen Milburn Anderson,108,Crime|Thriller|Comedy,2010-01-01,33,5.8,2010,7000000,46488,-6953512,6
2065,0.655878,85000000,112483764,27483764,Cats & Dogs 2 : The Revenge of Kitty Galore,James Marsden|Nick Nolte|Christina Applegate|Bette Midler|Pascale Hutton,Brad Peyton,82,Comedy|Family,2010-07-30,60,5.0,2010,85000000,112483764,27483764,5
2067,0.649289999999999,10000000,6110000,-3890000,MacGruber,Will Forte|Kristen Wiig|Val Kilmer|Ryan Phillippe|Maya Rudolph,Jorma Taccone,90,Action|Adventure|Comedy,2010-05-21,95,5.2,2010,10000000,6110000,-3890000,5
2071,0.640576,120000000,48668907,-71331093,How Do You Know,Reese Witherspoon|Paul Rudd|Owen Wilson|Jack Nicholson|Kathryn Hahn,James L. Brooks,121,Comedy|Drama|Romance,2010-12-17,136,4.9,2010,120000000,48668907,-71331093,5
2077,0.619772,500000,98017,-401983,Rubber,Thomas F. Duffy|David Bowe|Stephen Spinella|Roxane Mesquida|Jack Plotnick,Quentin Dupieux,85,Comedy|Drama|Fantasy|Horror|Mystery,2010-07-09,140,5.6,2010,500000,98017,-401983,6
2079,0.618078,28000000,45236543,17236543,The Spy Next Door,Amber Valletta|Lucas Till|Jackie Chan|Billy Ray Cyrus|George Lopez,Brian Levant,94,Action|Comedy|Family,2010-01-15,210,5.4,2010,28000000,45236543,17236543,5
2080,0.61643,20000000,49779728,29779728,She's Out of My League,Alice Eve|Jay Baruchel|Mike Vogel|Krysten Ritter|Debra Jo Rupp,Jim Field Smith,104,Comedy|Romance,2010-03-11,318,5.9,2010,20000000,49779728,29779728,6
2083,0.602854,12000000,204940,-11795060,Henry's Crime,Keanu Reeves|Vera Farmiga|James Caan|Judy Greer|Fisher Stevens,Malcolm Venville,108,Action|Comedy|Thriller,2010-01-14,49,5.8,2010,12000000,204940,-11795060,6
2085,0.599676,25000000,4644108,-20355892,London Boulevard,Keira Knightley|Colin Farrell|Anna Friel|Ray Winstone|Jamie Campbell Bower,William Monahan,103,Drama|Crime,2010-11-10,151,5.5,2010,25000000,4644108,-20355892,5
2086,0.598275,50000000,105197635,55197635,Hereafter,Matt Damon|Bryce Dallas Howard|George McLaren|Thierry Neuvic|Cyndi Mayo Davis,Clint Eastwood,129,Drama|Fantasy,2010-10-15,279,5.5,2010,50000000,105197635,55197635,5
2088,0.597254,25000000,19829957,-5170043,My Soul to Take,Max Thieriot|John Magaro|Denzel Whitaker|Zena Grey|Nick Lashaway,Wes Craven,107,Drama|Horror|Mystery|Thriller,2010-10-08,75,5.2,2010,25000000,19829957,-5170043,5
2089,0.59643,30000000,967000,-29033000,TEKKEN,Jon Foo|Kelly Overton|Cary-Hiroyuki Tagawa|Ian Anthony Dale|Luke Goss,Dwight H. Little,92,Crime|Drama|Action|Thriller|Science Fiction,2010-03-20,110,5.0,2010,30000000,967000,-29033000,5
2091,0.591206,25000000,15478800,-9521200,The Conspirator,Evan Rachel Wood|James McAvoy|Kevin Kline|Robin Wright|Alexis Bledel,Robert Redford,122,Crime|Drama|History,2010-09-10,78,5.9,2010,25000000,15478800,-9521200,6
2093,0.579188,21000000,49050886,28050886,Death at a Funeral,Zoe Saldana|James Marsden|Martin Lawrence|Peter Dinklage|Danny Glover,Neil LaBute,92,Comedy,2010-04-15,134,5.7,2010,21000000,49050886,28050886,6
2096,0.564203,7000000,382946,-6617054,Hesher,Joseph Gordon-Levitt|Natalie Portman|Rainn Wilson|Audrey Wasilewski|Frank Collison,Spencer Susser,106,Drama,2010-01-22,104,6.2,2010,7000000,382946,-6617054,6
2097,0.554060999999999,5000000,1000000,-4000000,Animal Kingdom,James Frecheville|Ben Mendelsohn|Joel Edgerton|Guy Pearce|Luke Ford,David MichÃ´d,113,Drama|Thriller|Crime,2010-06-03,117,6.7,2010,5000000,1000000,-4000000,7
2098,0.552064999999999,50000000,83761844,33761844,Marmaduke,Owen Wilson|Emma Stone|George Lopez|Christopher Mintz-Plasse|Steve Coogan,Tom Dey,87,Family|Comedy,2010-06-04,75,4.9,2010,50000000,83761844,33761844,5
2103,0.535535,70000000,134748021,64748021,Wall Street: Money Never Sleeps,Michael Douglas|Shia LaBeouf|Josh Brolin|Carey Mulligan|Frank Langella,Oliver Stone,133,Drama|Crime,2010-09-02,325,5.8,2010,70000000,134748021,64748021,6
2107,0.534192,18000000,871279,-17128721,Carlos,Edgar RamÃ­rez|Alexander Scheer|Fadi Abi Samra|Nora von WaldstÃ¤tten|Talal El-Jordi,Olivier Assayas,338,Crime|Drama|Thriller|History,2010-05-19,35,6.2,2010,18000000,871279,-17128721,6
2115,0.514465,8000000,18124262,10124262,Another Year,Jim Broadbent|Lesley Manville|Ruth Sheen|Oliver Maltman|Peter Wight,Mike Leigh,129,Comedy|Drama,2010-11-05,46,6.7,2010,8000000,18124262,10124262,7
2117,0.513857,5000000,2614773,-2385227,Everything Must Go,Rebecca Hall|Will Ferrell|Glenn Howerton|Laura Dern|Christopher Jordan Wallace,Dan Rush,97,Comedy|Drama|Romance,2010-10-15,111,5.8,2010,5000000,2614773,-2385227,6
2119,0.512957,20000000,54956140,34956140,The Crazies,Timothy Olyphant|Radha Mitchell|Joe Anderson|Danielle Panabaker|Christie Lynn Smith,Breck Eisner,101,Mystery|Horror|Action,2010-02-26,320,6.1,2010,20000000,54956140,34956140,6
2123,0.498635,5000000,5129058,129058,Rabbit Hole,Nicole Kidman|Sandra Oh|Dianne Wiest|Aaron Eckhart|Tammy Blanchard,John Cameron Mitchell,91,Drama,2010-12-16,73,6.6,2010,5000000,5129058,129058,7
2125,0.495162,20000000,39300000,19300000,Alpha and Omega,Hayden Panettiere|Justin Long|Dennis Hopper|Christina Ricci|Danny Glover,Anthony Bell|Ben Gluck,88,Family|Animation,2010-09-17,84,5.5,2010,20000000,39300000,19300000,5
2134,0.470249,80000000,201584141,121584141,Yogi Bear,Dan Aykroyd|Justin Timberlake|Anna Faris|Tom Cavanagh|Christine Taylor,Eric Brevig,80,Comedy|Family|Animation|Adventure,2010-12-11,146,5.1,2010,80000000,201584141,121584141,5
2137,0.455662,5773100,18144030,12370930,StreetDance 3D,Nichola Burley|Rachel McDowall|Richard Winsor|Eleanor Bron|Patrick Baladi,Max Giwa|Dania Pasquini,98,Drama,2010-05-19,54,5.8,2010,5773100,18144030,12370930,6
2142,0.443893,2500000,324138,-2175862,Super,Rainn Wilson|Ellen Page|Liv Tyler|Kevin Bacon|Gregg Henry,James Gunn,96,Comedy|Action|Drama,2010-09-09,211,6.6,2010,2500000,324138,-2175862,7
2143,0.443807,20000000,346594,-19653406,The Tempest,Helen Mirren|Felicity Jones|Reeve Carney|David Strathairn|Tom Conti,Julie Taymor,110,Fantasy|Drama,2010-12-10,16,6.1,2010,20000000,346594,-19653406,6
2158,0.406941,15000000,20529194,5529194,Country Strong,Gwyneth Paltrow|Garrett Hedlund|Tim McGraw|Leighton Meester|Marshall Chapman,Shana Feste,117,Drama|Romance,2010-12-22,49,5.9,2010,15000000,20529194,5529194,6
2164,0.393626,27000000,16504936,-10495064,"Tomorrow, When the War Began",Caitlin Stasey|Rachel Hurd-Wood|Phoebe Tonkin|Deniz Akdeniz|Lincoln Lewis,Stuart Beattie,103,Action|Adventure|Drama,2010-08-08,112,6.5,2010,27000000,16504936,-10495064,6
2171,0.375979,31000000,15134293,-15865707,Extraordinary Measures,Harrison Ford|Brendan Fraser|Keri Russell|Courtney B. Vance|Meredith Droeger,Tom Vaughan,105,Drama,2010-01-21,44,5.8,2010,31000000,15134293,-15865707,6
2173,0.368927,10000000,33583175,23583175,Devil,Chris Messina|Jacob Vargas|Bojana NovakoviÄ‡|Logan Marshall-Green|Bokeem Woodbine,John Erick Dowdle,80,Horror|Mystery|Thriller,2010-01-13,433,5.6,2010,10000000,33583175,23583175,6
2187,0.312595,14000000,21409028,7409028,Our Family Wedding,Forest Whitaker|America Ferrera|Carlos Mencia|Regina King|Lance Gross,Rick Famuyiwa,103,Comedy,2010-03-12,26,5.9,2010,14000000,21409028,7409028,6
2191,0.332904,100000,1000000,900000,Halo Legends,Andy McAvin,Shinji Aramaki|Hideki Futamura,93,Action|Animation|Science Fiction,2010-02-16,19,7.2,2010,100000,1000000,900000,7
2193,0.328667,30000000,8454301,-21545699,Barney's Version,Paul Giamatti|Dustin Hoffman|Rosamund Pike|Minnie Driver|Rachelle Lefevre,Richard J. Lewis,134,Comedy|Drama,2010-10-26,70,6.9,2010,30000000,8454301,-21545699,7
2196,0.3261,80000000,74901339,-5098661,Edge of Darkness,Mel Gibson|Ray Winstone|Danny Huston|Shawn Roberts|Denis O'Hare,Martin Campbell,117,Crime|Drama|Mystery|Thriller,2010-01-29,276,6.0,2010,80000000,74901339,-5098661,6
2201,0.318587,4600000,1163967,-3436033,4.3.2.1,Emma Roberts|Noel Clarke|Ophelia Lovibond|Tamsin Egerton|Shanika Warren-Markland,Noel Clarke|Mark Davis,117,Action|Thriller|Crime|Romance,2010-06-02,37,5.9,2010,4600000,1163967,-3436033,6
2202,0.315527,4000000,55125,-3944875,Dirty Girl,Juno Temple|Jeremy Dozier|Milla Jovovich|Mary Steenburgen|Dwight Yoakam,Abe Sylvia,90,Drama|Comedy,2010-09-12,36,6.2,2010,4000000,55125,-3944875,6
2207,0.346071,30000,3045943,3015943,Catfish,Megan Faccio|Melody C. Roscher|Ariel Schulman|Angela Wesselman-Pierce|Nev Schulman,Henry Joost|Ariel Schulman,87,Documentary,2010-09-17,125,6.4,2010,30000,3045943,3015943,6
2208,0.302377,35000000,39340177,4340177,Furry Vengeance,Brendan Fraser|Ken Jeong|Brooke Shields|Angela Kinsey|Rob Riggle,Roger Kumble,92,Comedy,2010-04-02,75,4.7,2010,35000000,39340177,4340177,5
2209,0.301054,12500000,1083683,-11416317,Casino Jack,Kevin Spacey|Kelly Preston|Hannah Endicott-Douglas|Rachelle Lefevre|Barry Pepper,George Hickenlooper,108,Crime|Comedy|Drama,2010-09-16,43,6.0,2010,12500000,1083683,-11416317,6
2212,0.29666,2500000,52604,-2447396,Hatchet II,Danielle Harris|Kane Hodder|Parry Shen|Tony Todd|Tom Holland,Adam Green,89,Horror|Comedy|Thriller,2010-08-26,42,5.1,2010,2500000,52604,-2447396,5
2220,0.283241,20000000,4634062,-15365938,Dylan Dog: Dead of Night,Brandon Routh|Peter Stormare|Sam Huntington|Taye Diggs|Anita Briem,Kevin Munroe,107,Action|Comedy|Horror|Mystery|Science Fiction,2010-10-26,69,4.9,2010,20000000,4634062,-15365938,5
2227,0.275607,30000,617000,587000,Howl,James Franco|Jon Hamm|Mary-Louise Parker|Treat Williams|Jeff Daniels,Rob Epstein|Jeffrey Friedman,84,Drama,2010-08-26,45,6.8,2010,30000,617000,587000,7
2228,0.27519,3000000,103735,-2896265,Freakonomics,Zoe Sloane|Jade Viggiano|Amancaya Aguilar|Kahiry Bess|Alisha Naragsheth,Alex Gibney|Rachel Grady|Heidi Ewing|Seth Gordon|Eugene Jarecki|Morgan Spurlock,93,Documentary,2010-10-01,25,6.7,2010,3000000,103735,-2896265,7
2230,0.271381,12500000,3878993,-8621007,The Perfect Game,"Clifton Collins, Jr.|Cheech Marin|MoisÃ©s Arias|Emilie de Ravin|Jake T. Austin",William Dear,118,Drama|Family,2010-04-01,12,5.7,2010,12500000,3878993,-8621007,6
2237,0.2596,650000,33245,-616755,Stake Land,Danielle Harris|Kelly McGillis|Nick Damici|Connor Paolo|Gregory Jones,Jim Mickle,98,Drama|Horror|Action|Thriller|Science Fiction,2010-09-30,143,6.2,2010,650000,33245,-616755,6
2244,0.25054,42500000,11087569,-31412431,The Warrior's Way,Kate Bosworth|Jang Dong-gun|Geoffrey Rush|Danny Huston|Ti Lung,Sngmoo Lee,100,Adventure|Fantasy|Action|Western|Thriller,2010-12-02,74,6.4,2010,42500000,11087569,-31412431,6
2246,0.246578,10000000,4349187,-5650813,Burke & Hare,Simon Pegg|Andy Serkis|Isla Fisher|Tom Wilkinson|Tim Curry,John Landis,91,Comedy|Thriller,2010-10-29,75,6.0,2010,10000000,4349187,-5650813,6
2254,0.241541,10000000,55089,-9944911,Inhale,Rosanna Arquette|Diane Kruger|Dermot Mulroney|Sam Shepard|Jordi MollÃ ,Baltasar KormÃ¡kur,100,Drama|Action|Thriller,2010-08-27,21,5.9,2010,10000000,55089,-9944911,6
2255,0.240403,967686,4270000,3302314,Four Lions,Riz Ahmed|Nigel Lindsay|Kayvan Novak|Adeel Akhtar|Arsher Ali,Chris Morris,101,Comedy|Crime|Drama,2010-05-07,262,7.0,2010,967686,4270000,3302314,7
2275,0.216503,1500000,187716,-1312284,Waste Land,Vik Muniz,Lucy Walker,90,Documentary|Foreign,2010-01-24,23,7.8,2010,1500000,187716,-1312284,8
2277,0.214381,7000000,453079,-6546921,The Extra Man,Kevin Kline|Paul Dano|Katie Holmes|John C. Reilly|Dan Hedaya,Shari Springer Berman|Robert Pulcini,108,Comedy,2010-08-01,18,5.9,2010,7000000,453079,-6546921,6
2283,0.385851,4500000,123820,-4376180,The Romantics,Katie Holmes|Anna Paquin|Josh Duhamel|Dianna Agron|Adam Brody,Galt Niederhoffer,95,Comedy|Drama|Romance,2010-09-10,46,4.8,2010,4500000,123820,-4376180,5
2303,0.181532,7000000,3218666,-3781334,Balada triste de trompeta,Santiago Segura|Antonio de la Torre|RaÃºl ArÃ©valo|Fran Perea|Carolina Bang,Ãlex de la Iglesia,101,Drama|Action|Thriller|Foreign,2010-12-17,44,6.2,2010,7000000,3218666,-3781334,6
2338,0.140251,20000000,60072596,40072596,Why Did I Get Married Too?,Tyler Perry|Janet Jackson|Jill Scott|Sharon Leal|Malik Yoba,Tyler Perry,121,Comedy|Romance,2010-04-02,21,6.0,2010,20000000,60072596,40072596,6
2343,0.131526,60000000,296221663,236221663,Resident Evil: Afterlife,Milla Jovovich|Wentworth Miller|Ali Larter|Kim Coates|Kacey Barnfield,Paul W.S. Anderson,97,Action|Adventure|Horror|Science Fiction,2010-09-09,882,5.8,2010,60000000,296221663,236221663,6
2359,0.276322,10000000,1068682,-8931318,Vanishing on 7th Street,Hayden Christensen|Thandie Newton|John Leguizamo|Neal Huff|Jacob Latimore,Brad Anderson,92,Drama|Horror|Thriller,2010-09-11,83,4.8,2010,10000000,1068682,-8931318,5
2378,0.028227,10000000,5000000,-5000000,Action Replayy,Akshay Kumar|Aishwarya Rai Bachchan|Neha Dhupia|Aditya Roy Kapoor|Randhir Kapoor,Vipul Amrutlal Shah,100,Drama|Comedy|Romance|Foreign,2010-11-05,11,4.9,2010,10000000,5000000,-5000000,5
2387,0.06324,35000000,60251371,25251371,Secretariat,Diane Lane|John Malkovich|Scott Glenn|Dylan Walsh|Fred Dalton Thompson,Randall Wallace,123,Drama,2010-08-20,52,6.6,2010,35000000,60251371,25251371,7
2398,0.028456,3,43,40,Boy,James Rolleston|Craig Hall|Taika Waititi|Te Aho Aho Eketone-Whitu|Ei Kura Albert,Taika Waititi,87,Drama|Comedy,2010-02-14,26,7.3,2010,3,43,40,7
2409,8.947905,63000000,100853753,37853753,Fight Club,Edward Norton|Brad Pitt|Meat Loaf|Jared Leto|Helena Bonham Carter,David Fincher,139,Drama,1999-10-14,5923,8.1,1999,82470329,132022892,49552563,8
2410,7.753899,63000000,463517383,400517383,The Matrix,Keanu Reeves|Laurence Fishburne|Carrie-Anne Moss|Hugo Weaving|Gloria Foster,Lilly Wachowski|Lana Wachowski,136,Action|Science Fiction,1999-03-30,6351,7.8,1999,82470329,606768749,524298420,8
2411,3.55571999999999,15000000,356296601,341296601,American Beauty,Kevin Spacey|Annette Bening|Thora Birch|Wes Bentley|Mena Suvari,Sam Mendes,122,Drama,1999-09-15,1756,7.7,1999,19635792,466411079,446775287,8
2412,3.526029,115000000,924317558,809317558,Star Wars: Episode I - The Phantom Menace,Liam Neeson|Ewan McGregor|Natalie Portman|Jake Lloyd|Ian McDiarmid,George Lucas,136,Adventure|Action|Science Fiction,1999-05-19,2823,6.3,1999,150541077,1209980530,1059439453,6
2413,2.94377,80000000,415885488,335885488,The Mummy,Brendan Fraser|Rachel Weisz|John Hannah|Arnold Vosloo|Kevin J. O'Connor,Stephen Sommers,124,Adventure|Fantasy|Horror|Action|Thriller,1999-05-06,1562,6.3,1999,104724227,544416081,439691854,6
2414,2.719461,60000000,284600000,224600000,The Green Mile,Tom Hanks|Michael Clarke Duncan|David Morse|Bonnie Hunt|James Cromwell,Frank Darabont,189,Fantasy|Drama|Crime,1999-12-10,2299,8.0,1999,78543170,372556440,294013270,8
2415,2.578731,40000000,672806292,632806292,The Sixth Sense,Bruce Willis|Haley Joel Osment|Toni Collette|Olivia Williams|Mischa Barton,M. Night Shyamalan,107,Mystery|Thriller|Drama,1999-08-02,1753,7.5,1999,52362113,880738991,828376878,7
2416,2.129874,135000000,361832400,226832400,The World Is Not Enough,Pierce Brosnan|Sophie Marceau|Robert Carlyle|Denise Richards|Robbie Coltrane,Michael Apted,128,Adventure|Action|Thriller,1999-11-08,509,6.0,1999,176722134,473657733,296935599,6
2417,2.069357,10500000,75902208,65402208,Cruel Intentions,Sarah Michelle Gellar|Ryan Phillippe|Reese Witherspoon|Selma Blair|Louise Fletcher,Roger Kumble,97,Drama|Romance|Thriller,1999-03-05,505,6.5,1999,13745054,99360001,85614947,6
2418,2.065619,100000000,206071502,106071502,Sleepy Hollow,Johnny Depp|Ian McDiarmid|Christina Ricci|Casper Van Dien|Michael Gough,Tim Burton,105,Drama|Fantasy|Thriller|Mystery,1999-11-18,932,6.7,1999,130905284,269758486,138853202,7
2420,1.825695,11000000,235483004,224483004,American Pie,Jason Biggs|Chris Klein|Thomas Ian Nicholas|Alyson Hannigan|Shannon Elizabeth,Paul Weitz|Chris Weitz,95,Comedy|Romance,1999-07-09,1405,6.4,1999,14399581,308259696,293860115,6
2421,1.820318,66000000,212404396,146404396,Entrapment,Sean Connery|Catherine Zeta-Jones|Will Patton|Maury Chaykin|Ving Rhames,Jon Amiel,112,Romance|Drama|Mystery,1999-04-30,355,5.9,1999,86397487,278048579,191651092,6
2422,1.810197,90000000,485015179,395015179,Toy Story 2,Tom Hanks|Tim Allen|Kelsey Grammer|Joan Cusack|Don Rickles,John Lasseter|Lee Unkrich|Ash Brannon,92,Animation|Comedy|Family,1999-10-30,2272,7.2,1999,117814756,634910500,517095744,7
2423,1.769152,16000000,53478166,37478166,10 Things I Hate About You,Julia Stiles|Heath Ledger|Joseph Gordon-Levitt|Larisa Oleynik|Larry Miller,Gil Junger,97,Comedy|Romance|Drama,1999-03-30,947,7.2,1999,20944845,70005745,49060900,7
2424,1.72385,42000000,363889678,321889678,Notting Hill,Julia Roberts|Hugh Grant|Gina McKee|Tim McInnerny|Rhys Ifans,Roger Michell,124,Comedy,1999-05-13,688,6.8,1999,54980219,476350818,421370599,7
2425,1.560867,33000000,310940086,277940086,Austin Powers: The Spy Who Shagged Me,Mike Myers|Heather Graham|Michael York|Robert Wagner|Rob Lowe,Jay Roach,95,Crime|Adventure|Action|Comedy|Science Fiction,1999-06-08,583,6.0,1999,43198743,407037004,363838261,6
2426,1.43163,2000000,11540607,9540607,Boys Don't Cry,Hilary Swank|ChloÃ« Sevigny|Peter Sarsgaard|Brendan Sexton III|Alicia Goranson,Kimberly Peirce,118,Crime|Drama,1999-09-02,170,7.0,1999,2618105,15107264,12489159,7
2427,1.427794,90000000,60289912,-29710088,The Insider,Al Pacino|Russell Crowe|Christopher Plummer|Diane Venora|Bruce McGill,Michael Mann,157,Drama|Thriller,1999-10-28,249,7.1,1999,117814756,78922680,-38892076,7
2428,1.348628,45000000,90683916,45683916,Galaxy Quest,Tim Allen|Sigourney Weaver|Alan Rickman|Tony Shalhoub|Sam Rockwell,Dean Parisot,102,Comedy|Family|Science Fiction,1999-12-23,406,6.6,1999,58907378,118710038,59802660,7
2429,1.329827,65000000,162091208,97091208,Eyes Wide Shut,Tom Cruise|Nicole Kidman|Madison Eginton|Jackie Sawiris|Sydney Pollack,Stanley Kubrick,159,Drama,1999-07-14,623,6.8,1999,85088435,212185957,127097522,7
2430,1.328465,13000000,22863596,9863596,Being John Malkovich,John Cusack|Cameron Diaz|Catherine Keener|John Malkovich|Orson Bean,Spike Jonze,112,Fantasy|Drama|Comedy,1999-09-30,607,7.1,1999,17017687,29929655,12911968,7
2431,1.320079,80000000,176885658,96885658,Analyze This,Robert De Niro|Billy Crystal|Lisa Kudrow|Chazz Palminteri|Joe Viterelli,Harold Ramis,103,Comedy|Crime,1999-03-05,260,6.3,1999,104724227,231552674,126828447,6
2432,1.309249,133000000,300135367,167135367,Stuart Little,Michael J. Fox|Geena Davis|Hugh Laurie|Jonathan Lipnicki|Nathan Lane,Rob Minkoff,84,Fantasy,1999-12-17,502,5.6,1999,174104028,392893056,218789028,6
2433,1.254522,73000000,151493655,78493655,The Bone Collector,Denzel Washington|Angelina Jolie|Queen Latifah|Michael Rooker|Michael McGlone,Phillip Noyce,118,Drama|Mystery|Thriller|Crime,1999-11-01,463,6.5,1999,95560857,198313200,102752343,6
2434,1.221973,170000000,222104681,52104681,Wild Wild West,Will Smith|Kevin Kline|Kenneth Branagh|Salma Hayek|M. Emmet Walsh,Barry Sonnenfeld,106,Action|Adventure|Comedy|Drama|Science Fiction,1999-06-29,626,5.2,1999,222538983,290746764,68207781,5
2435,1.189386,160000000,61698899,-98301101,The 13th Warrior,Antonio Banderas|Vladimir Kulich|Dennis StorhÃ¸i|Daniel Southern|Clive Russell,John McTiernan,102,Adventure|Fantasy|Action,1999-08-27,275,6.2,1999,209448455,80767119,-128681336,6
2436,1.17388799999999,100000000,211989043,111989043,End of Days,Arnold Schwarzenegger|Gabriel Byrne|Kevin Pollak|Robin Tunney|CCH Pounder,Peter Hyams,121,Action|Fantasy|Horror|Mystery,1999-11-23,247,5.4,1999,130905284,277504860,146599576,5
2437,1.152354,24000000,88545092,64545092,The Cider House Rules,Tobey Maguire|Charlize Theron|Delroy Lindo|Paul Rudd|Michael Caine,Lasse HallstrÃ¶m,126,Drama,1999-12-17,145,6.6,1999,31417268,115910204,84492936,7
2438,1.150934,70000000,23159305,-46840695,The Iron Giant,Jennifer Aniston|Harry Connick Jr.|Vin Diesel|Cloris Leachman|James Gammon,Brad Bird,86,Adventure|Animation|Family|Fantasy|Science Fiction,1999-08-06,877,7.5,1999,91633699,30316754,-61316945,7
2439,1.139223,60000000,73648228,13648228,Deep Blue Sea,Thomas Jane|Saffron Burrows|LL Cool J|Michael Rapaport|Samuel L. Jackson,Renny Harlin,105,Horror|Action|Thriller|Science Fiction,1999-07-27,336,5.5,1999,78543170,96409422,17866252,5
2441,1.050599,90000000,161626121,71626121,Payback,Mel Gibson|Kris Kristofferson|Gregg Henry|Maria Bello|David Paymer,Paul Abascal|Brian Helgeland,100,Drama|Action|Thriller|Crime,1999-02-04,305,6.5,1999,117814756,211577133,93762377,6
2442,1.03785,70000000,309457509,239457509,Runaway Bride,Julia Roberts|Richard Gere|Joan Cusack|Rita Wilson|HÃ©ctor Elizondo,Garry Marshall,116,Comedy|Romance,1999-07-30,253,5.7,1999,91633699,405096233,313462534,6
2443,1.022028,10000000,103166989,93166989,She's All That,Freddie Prinze Jr.|Rachael Leigh Cook|Matthew Lillard|Paul Walker|Jodi Lyn O'Keefe,Robert Iscove,95,Comedy|Romance,1999-01-29,248,5.6,1999,13090528,135051040,121960512,6
2444,0.993492,70000000,177841558,107841558,Double Jeopardy,Tommy Lee Jones|Ashley Judd|Bruce Greenwood|Annabeth Gish|Benjamin Weir,Bruce Beresford,105,Drama|Mystery|Thriller|Crime,1999-09-24,144,6.1,1999,91633699,232803997,141170298,6
2445,0.992316,6000000,30471,-5969529,The Boondock Saints,Willem Dafoe|Norman Reedus|Sean Patrick Flanery|David Della Rocco|David Ferry,Troy Duffy,108,Action|Thriller|Crime,1999-01-22,521,7.1,1999,7854317,39888,-7814429,7
2446,0.968204,10000000,12827813,2827813,Office Space,Ron Livingston|Jennifer Aniston|David Herman|Ajay Naidu|Diedrich Bader,Mike Judge,89,Comedy|Crime,1999-02-19,669,7.3,1999,13090528,16792285,3701757,7
2447,0.941202,6000000,10409377,4409377,The Virgin Suicides,James Woods|Kathleen Turner|Kirsten Dunst|Josh Hartnett|A.J. Cook,Sofia Coppola,97,Drama|Romance,1999-04-21,460,7.0,1999,7854317,13626424,5772107,7
2448,0.937873,100000000,93700000,-6300000,Bicentennial Man,Robin Williams|Sam Neill|Embeth Davidtz|Oliver Platt|Kiersten Warren,Chris Columbus,131,Comedy|Science Fiction,1999-12-17,538,6.7,1999,130905284,122658251,-8247033,7
2449,0.934621,25000,248000000,247975000,The Blair Witch Project,Heather Donahue|Michael C. Williams|Joshua Leonard|Bob Griffith|Jim King,Daniel Myrick|Eduardo SÃ¡nchez,81,Horror|Mystery,1999-07-14,522,6.3,1999,32726,324645105,324612379,6
2450,0.920974,38000000,58401898,20401898,The Ninth Gate,Johnny Depp|Frank Langella|Lena Olin|Emmanuelle Seigner|Barbara Jefford,Roman Polanski,133,Horror|Mystery|Thriller,1999-08-24,384,6.2,1999,49744008,76451170,26707162,6
2451,0.92088,50000000,73956241,23956241,The Hurricane,Denzel Washington|Vicellous Reon Shannon|Deborah Kara Unger|Liev Schreiber|John Hannah,Norman Jewison,146,Drama,1999-09-17,226,7.3,1999,65452642,96812627,31359985,7
2452,0.907305,16000000,18564088,2564088,The Thirteenth Floor,Craig Bierko|Armin Mueller-Stahl|Gretchen Mol|Vincent D'Onofrio|Dennis Haysbert,Josef Rusnak,100,Thriller|Science Fiction|Mystery,1999-04-16,189,6.5,1999,20944845,24301372,3356527,6
2453,0.876587,34200000,234801895,200601895,Big Daddy,Adam Sandler|Joey Lauren Adams|Kristy Swanson|Cole Sprouse|Jon Stewart,Dennis Dugan,93,Comedy|Drama,1999-06-25,479,6.2,1999,44769607,307368089,262598482,6
2455,0.823494,40000000,96618699,56618699,8MM,Nicolas Cage|Joaquin Phoenix|James Gandolfini|Chris Bauer|Anthony Heald,Joel Schumacher,123,Thriller|Crime|Mystery,1999-02-25,248,6.0,1999,52362113,126478982,74116869,6
2456,0.82073,10000000,30652890,20652890,Dogma,Ben Affleck|Matt Damon|Linda Fiorentino|Jason Mewes|Chris Rock,Kevin Smith,130,Fantasy|Comedy|Adventure,1999-11-12,472,6.6,1999,13090528,40126252,27035724,7
2459,0.778786,80000000,91188905,11188905,The Haunting,Liam Neeson|Catherine Zeta-Jones|Owen Wilson|Lili Taylor|Bruce Dern,Jan de Bont,113,Horror|Thriller|Fantasy|Mystery,1999-07-23,178,5.3,1999,104724227,119371095,14646868,5
2460,0.746054,75000000,93888180,18888180,Forces of Nature,Sandra Bullock|Ben Affleck|Maura Tierney|Steve Zahn|Blythe Danner,Bronwen Hughes,105,Comedy,1999-03-12,81,5.2,1999,98178963,122904589,24725626,5
2461,0.744837,35000000,40263020,5263020,Blast from the Past,Brendan Fraser|Alicia Silverstone|Christopher Walken|Sissy Spacek|Nathan Fillion,Hugh Wilson,112,Comedy|Romance,1999-02-12,114,6.2,1999,45816849,52706420,6889571,6
2463,0.731802,80000000,118880016,38880016,Message in a Bottle,Kevin Costner|Robin Wright|Paul Newman|John Savage|Illeana Douglas,Luis Mandoki,131,Drama,1999-02-22,112,5.7,1999,104724227,155620223,50895996,6
2464,0.72669,60000000,149705852,89705852,The General's Daughter,John Travolta|Madeleine Stowe|James Cromwell|Timothy Hutton|Leslie Stefanson,Simon West,116,Crime|Drama|Mystery|Thriller,1999-06-18,103,5.9,1999,78543170,195972871,117429701,6
2465,0.725013,29000000,50041732,21041732,Stigmata,Patricia Arquette|Gabriel Byrne|Jonathan Pryce|Nia Long|Thomas Kopache,Rupert Wainwright,103,Horror|Thriller,1999-09-10,103,5.8,1999,37962532,65507271,27544739,6
2466,0.716336,12000000,21133087,9133087,Stir of Echoes,Kevin Bacon|Zachary David Cope|Kathryn Erbe|Illeana Douglas|Kevin Dunn,David Koepp,99,Horror|Mystery|Thriller,1999-09-10,155,6.3,1999,15708634,27664327,11955693,6
2469,0.682531,37000000,48451803,11451803,Magnolia,Julianne Moore|William H. Macy|John C. Reilly|Tom Cruise|Philip Baker Hall,Paul Thomas Anderson,188,Drama,1999-12-08,430,7.3,1999,48434955,63425970,14991015,7
2470,0.671069999999999,51000000,36911617,-14088383,The Bachelor,Chris O'Donnell|RenÃ©e Zellweger|Artie Lange|Hal Holbrook|Ed Asner,Gary Sinyor,101,Comedy,1999-11-05,46,4.5,1999,66761695,48319257,-18442438,4
2471,0.654013,75000000,14010690,-60989310,Virus,Jamie Lee Curtis|William Baldwin|Donald Sutherland|Joanna Pacula|Marshall Bell,John Bruno,99,Horror|Action|Science Fiction,1999-01-14,60,4.9,1999,98178963,18340733,-79838230,5
2472,0.640331,40000000,128798265,88798265,The Talented Mr. Ripley,Matt Damon|Gwyneth Paltrow|Jude Law|Cate Blanchett|Philip Seymour Hoffman,Anthony Minghella,139,Thriller|Crime|Drama,1999-12-25,435,6.9,1999,52362113,168603735,116241622,7
2473,0.637814,27000000,56870414,29870414,Lake Placid,Bill Pullman|Bridget Fonda|Oliver Platt|Brendan Gleeson|Betty White,Steve Miner,82,Horror|Comedy|Action|Science Fiction|Thriller,1999-07-15,112,5.3,1999,35344426,74446377,39101951,5
2474,0.63765,34000000,4217115,-29782885,Detroit Rock City,Giuseppe Andrews|James DeBello|Edward Furlong|Sam Huntington|Lin Shaye,Adam Rifkin,95,Comedy,1999-08-13,38,6.4,1999,44507796,5520426,-38987370,6
2475,0.636432,68000000,29762011,-38237989,Mystery Men,Hank Azaria|Janeane Garofalo|William H. Macy|Kel Mitchell|Jenifer Lewis,Kinka Usher,121,Adventure|Fantasy|Action|Comedy|Science Fiction,1999-08-06,115,5.4,1999,89015593,38960045,-50055548,5
2477,0.617279,80000000,90874570,10874570,Fantasia 2000,Steve Martin|Quincy Jones|Bette Midler|James Earl Jones|Penn Jillette,Paul Brizzi|Hendel Butoy|Francis Glebas|Eric Goldberg|Don Hahn|Pixote Hunt|James Algar|GaÃ«tan Brizzi,74,Music|Animation|Family|Fantasy,1999-12-31,168,6.9,1999,104724227,118959614,14235387,7
2478,0.614402,6500000,28451622,21951622,Go,Sarah Polley|Katie Holmes|Jay Mohr|Timothy Olyphant|William Fichtner,Doug Liman,98,Crime|Comedy|Thriller,1999-04-09,82,6.9,1999,8508843,37244676,28735833,7
2479,0.614007,25000000,84565230,59565230,Never Been Kissed,Drew Barrymore|David Arquette|Michael Vartan|Molly Shannon|Jenny Bicks,Raja Gosnell,107,Romance|Comedy|Drama,1999-04-09,196,5.7,1999,32726321,110700355,77974034,6
2482,0.585123,75000000,108000000,33000000,Three Kings,George Clooney|Mark Wahlberg|Ice Cube|Spike Jonze|Cliff Curtis,David O. Russell,114,Action|Adventure|Comedy,1999-09-27,412,6.3,1999,98178963,141377707,43198744,6
2483,0.581756,82000000,47434430,-34565570,Man on the Moon,Jim Carrey|Courtney Love|Bob Zmuda|Danny DeVito|Gerry Becker,MiloÅ¡ Forman,118,Comedy|Drama|Romance,1999-12-22,226,6.6,1999,107342333,62094175,-45248158,7
2484,0.566661,25000000,13000000,-12000000,Brokedown Palace,Claire Danes|Kate Beckinsale|Bill Pullman|Jacqueline Kim|Lou Diamond Phillips,Jonathan Kaplan,100,Drama|Thriller,1999-08-13,52,6.3,1999,32726321,17017687,-15708634,6
2486,0.548097,19000000,40846082,21846082,House on Haunted Hill,Geoffrey Rush|Famke Janssen|Taye Diggs|Peter Gallagher|Chris Kattan,William Malone,93,Horror|Mystery|Thriller,1999-10-29,84,5.6,1999,24872004,53469679,28597675,6
2490,0.508128,48000000,124305181,76305181,The Thomas Crown Affair,Pierce Brosnan|Rene Russo|Denis Leary|Ben Gazzara|Frankie Faison,John McTiernan,113,Drama|Comedy|Crime|Romance,1999-08-06,196,6.7,1999,62834536,162722051,99887515,7
2491,0.503460999999999,64000000,74608570,10608570,Random Hearts,Harrison Ford|Kristin Scott Thomas|Charles S. Dutton|Bonnie Hunt|Dennis Haysbert,Sydney Pollack,133,Drama|Romance,1999-10-08,32,5.3,1999,83779382,97666560,13887178,5
2492,0.501242,15000000,2856712,-12143288,eXistenZ,Jennifer Jason Leigh|Jude Law|Ian Holm|Willem Dafoe|Don McKellar,David Cronenberg,97,Action|Thriller|Science Fiction|Horror,1999-04-14,229,6.6,1999,19635792,3739586,-15896206,7
2493,0.498365,23000000,10827816,-12172184,The End of the Affair,Ralph Fiennes|Stephen Rea|Julianne Moore|James Bolam|Ian Hart,Neil Jordan,102,Drama,1999-12-03,24,6.1,1999,30108215,14174183,-15934032,6
2494,0.49601,65000000,117758500,52758500,Blue Streak,Martin Lawrence|Luke Wilson|Dave Chappelle|Peter Greene|Nicole Ari Parker,Les Mayfield,93,Thriller|Action|Comedy|Crime,1999-09-17,202,6.0,1999,85088435,154152099,69063664,6
2495,0.480421,21000000,17762705,-3237295,The Rage: Carrie 2,Emily Bergl|Jason London|Amy Irving|J. Smith-Cameron|Dylan Bruno,Katt Shea,104,Horror|Thriller|Science Fiction,1999-03-11,33,5.1,1999,27490109,23252319,-4237790,5
2497,0.47074,10000000,5241315,-4758685,Black and White,Robert Downey Jr.|Scott Caan|Stacy Edwards|Allan Houston|Gaby Hoffmann,James Toback,98,Drama,1999-09-04,11,4.7,1999,13090528,6861158,-6229370,5
2500,0.454992,25000000,15156200,-9843800,The Corruptor,Mark Wahlberg|Chow Yun-fat|Byron Mann|Kim Chan|Ric Young,James Foley,110,Action|Crime|Mystery|Thriller,1999-03-12,30,6.1,1999,32726321,19840266,-12886055,6
2504,0.418611,45000000,10667893,-34332107,Universal Soldier: The Return,Jean-Claude Van Damme|Kiana Tom|Bill Goldberg|Michael Jai White|Heidi Schanz,Mic Rodgers,82,Action|Science Fiction,1999-08-05,74,4.5,1999,58907378,13964835,-44942543,4
2511,0.393985,70000000,11263966,-58736034,Chill Factor,Cuba Gooding Jr.|Skeet Ulrich|Peter Firth|David Paymer|Daniel Hugh Kelly,Hugh Johnson,101,Action|Comedy|Thriller,1999-09-01,16,5.4,1999,91633699,14745126,-76888573,5
2513,0.383326,80000000,73345029,-6654971,Life,Eddie Murphy|Martin Lawrence|Obba BabatundÃ©|Nick Cassavetes|Bernie Mac,Ted Demme,108,Comedy|Crime|Drama,1999-04-16,87,6.6,1999,104724227,96012518,-8711709,7
2514,0.382872,23000000,18653615,-4346385,Anywhere But Here,Susan Sarandon|Natalie Portman|Hart Bochner|Eileen Ryan|Ray Baker,Wayne Wang,114,Drama|Comedy|Romance,1999-11-12,42,5.9,1999,30108215,24418567,-5689648,6
2515,0.378188,75000000,19598588,-55401412,The Astronaut's Wife,Johnny Depp|Charlize Theron|Joe Morton|Clea DuVall|Nick Cassavetes,Rand Ravich,109,Drama|Science Fiction|Thriller,1999-08-26,132,5.4,1999,98178963,25655587,-72523376,5
2516,0.88284,65000000,36850101,-28149899,My Favorite Martian,Jeff Daniels|Elizabeth Hurley|Daryl Hannah|Christopher Lloyd|Wallace Shawn,Donald Petrie,94,Comedy|Drama|Family|Science Fiction,1999-02-11,43,5.2,1999,85088435,48238729,-36849706,5
2518,0.274419,10000000,3193102,-6806898,The Limey,Terence Stamp|Lesley Ann Warren|Luis GuzmÃ¡n|Barry Newman|Joe Dallesandro,Steven Soderbergh,89,Drama|Action|Thriller|Crime|Mystery,1999-05-15,38,6.6,1999,13090528,4179939,-8910589,7
2519,0.35206,25,13,-12,Angela's Ashes,Emily Watson|Robert Carlyle|Joe Breen|Michael Legge|Ciaran Owens,Alan Parker,145,Drama,1999-12-25,24,7.0,1999,32,17,-15,7
2520,0.573718,50000000,58900031,8900031,The Story of Us,Bruce Willis|Michelle Pfeiffer|Rob Reiner|Colleen Rennison|Jake Sandvig,Rob Reiner,95,Comedy|Drama|Romance,1999-10-13,42,5.9,1999,65452642,77103253,11650611,6
2521,0.257547,8000000,17843379,9843379,Drive Me Crazy,Melissa Joan Hart|Stephen Collins|Adrian Grenier|Susan May Pratt|Ali Larter,John Schultz,91,Drama|Comedy|Romance|Family,1999-10-01,34,5.9,1999,10472422,23357926,12885504,6
2524,1.104937,24000000,16290976,-7709024,Muppets from Space,Steve Whitmire|Dave Goelz|Bill Barretta|Frank Oz|Jerry Nelson,Tim Hill,87,Fantasy|Comedy|Science Fiction|Family,1999-07-14,50,5.7,1999,31417268,21325748,-10091520,6
2526,0.333245,14000000,18535191,4535191,An Ideal Husband,Cate Blanchett|Minnie Driver|Rupert Everett|Julianne Moore|Jeremy Northam,Oliver Parker,97,Drama|Comedy|Romance,1999-04-15,23,6.4,1999,18326739,24263544,5936805,6
2529,0.328409,17000000,65535067,48535067,Deuce Bigalow: Male Gigolo,Rob Schneider|William Forsythe|Eddie Griffin|Arija Bareikis|Oded Fehr,Mike Mitchell,88,Comedy,1999-12-10,154,5.3,1999,22253898,85788866,63534968,5
2531,0.323791,25000000,4152230,-20847770,Idle Hands,Devon Sawa|Seth Green|Jessica Alba|Vivica A. Fox|Christopher Hart,Rodman Flender|Christian P. Della Penna,92,Thriller|Comedy|Horror,1999-04-30,83,6.1,1999,32726321,5435488,-27290833,6
2532,0.322499,55000000,100230832,45230832,Any Given Sunday,Al Pacino|Cameron Diaz|Dennis Quaid|James Woods|Jamie Foxx,Oliver Stone,150,Drama,1999-12-16,231,6.8,1999,71997906,131207455,59209549,7
2533,0.322339,38000000,28121100,-9878900,The Deep End of the Ocean,Michelle Pfeiffer|Treat Williams|Whoopi Goldberg|Jonathan Jackson|Cory Buck,Ulu Grosbard,106,Drama|Mystery,1999-03-12,26,5.8,1999,49744008,36812006,-12932002,6
2535,0.312827,600000,4000000,3400000,Human Traffic,John Simm|Danny Dyer|Lorraine Pilkington|Shaun Parkes|Nicola Reynolds,Justin Kerrigan,99,Comedy|Drama,1999-06-04,42,6.8,1999,785431,5236211,4450780,7
2536,0.312759,7000000,14011454,7011454,In Too Deep,Omar Epps|LL Cool J|Nia Long|Stanley Tucci|Hill Harper,Michael Rymer,97,Drama|Action|Thriller|Crime,1999-08-25,10,6.5,1999,9163369,18341733,9178364,6
2538,0.377269,13000000,8946237,-4053763,Teaching Mrs. Tingle,Helen Mirren|Katie Holmes|Jeffrey Tambor|Molly Ringwald|Vivica A. Fox,Kevin Williamson,96,Comedy|Thriller,1999-08-11,39,5.3,1999,17017687,11711097,-5306590,5
2550,0.285902,10000000,10571408,571408,Drop Dead Gorgeous,Kirsten Dunst|Ellen Barkin|Denise Richards|Amy Adams|Kirstie Alley,Michael Patrick Jann,98,Comedy,1999-07-23,41,6.2,1999,13090528,13838531,748003,6
2553,0.066504,9000000,34573780,25573780,The Best Man,Nia Long|Morris Chestnut|Harold Perrineau|Terrence Howard|Sanaa Lathan,Malcolm D. Lee,120,Drama|Comedy,1999-10-22,22,7.8,1999,11781475,45258905,33477430,8
2554,0.231418,6000000,4398989,-1601011,Simply Irresistible,Sarah Michelle Gellar|Sean Patrick Flanery|Dylan Baker|Patricia Clarkson|Lawrence Gilliard Jr.,Mark Tarlov,95,Comedy,1999-02-05,28,6.2,1999,7854317,5758509,-2095808,6
2555,0.272771,27000000,14859394,-12140606,Music of the Heart,Meryl Streep|Angela Bassett|Cloris Leachman|Aidan Quinn|Michael Angarano,Wes Craven,124,Drama,1999-10-29,25,6.7,1999,35344426,19451732,-15892694,7
2560,0.260903,28000000,8888143,-19111857,"Mystery, Alaska",Russell Crowe|Hank Azaria|Mary McCormack|Burt Reynolds|Colm Meaney,Jay Roach,119,Comedy|Drama,1999-10-01,35,5.8,1999,36653479,11635048,-25018431,6
2561,0.257431,50000000,13260050,-36739950,The Mod Squad,Claire Danes|Giovanni Ribisi|Omar Epps|Dennis Farina|Josh Brolin,Scott Silver,92,Action|Mystery|Thriller,1999-03-26,18,4.5,1999,65452642,17358106,-48094536,4
2563,0.25073,6000000,25059640,19059640,The Wood,Omar Epps|Richard T. Jones|Taye Diggs|Malinda Williams|Sean Nelson,Rick Famuyiwa,106,Comedy|Drama|Romance,1999-07-16,24,7.6,1999,7854317,32804393,24950076,8
2565,0.246669,6000000,6852450,852450,200 Cigarettes,Ben Affleck|Casey Affleck|Dave Chappelle|Kate Hudson|Janeane Garofalo,Risa Bramon Garcia,101,Comedy|Drama|Romance,1999-02-26,25,6.5,1999,7854317,8970219,1115902,6
2567,0.242797,75000000,29000000,-46000000,The Out-of-Towners,Steve Martin|Goldie Hawn|John Cleese|Mark McKinney|Jessica Cauffiel,Sam Weisman,90,Comedy,1999-04-02,20,5.2,1999,98178963,37962532,-60216431,5
2571,0.235223,60000000,66976317,6976317,Joan of Arc,Milla Jovovich|Dustin Hoffman|Faye Dunaway|John Malkovich|Vincent Cassel,Luc Besson,148,Adventure|Drama|Action|History|War,1999-10-18,209,6.1,1999,78543170,87675538,9132368,6
2576,0.216242,20000000,1531251,-18468749,Beowulf,Christopher Lambert|Rhona Mitra|Oliver Cotton|GÃ¶tz Otto|Vincent Hammond,Graham Baker,95,Action|Science Fiction|Thriller|Adventure|Horror,1999-04-01,27,4.5,1999,26181056,2004488,-24176568,4
2577,0.212029,24000000,8434146,-15565854,Play It to the Bone,Antonio Banderas|Woody Harrelson|Lolita Davidovich|Tom Sizemore|Lucy Liu,Ron Shelton,124,Comedy|Drama,1999-12-25,20,5.3,1999,31417268,11040742,-20376526,5
2580,0.204411,1700000,1943649,243649,"Happy, Texas",Steve Zahn|William H. Macy|Jeremy Northam|Ally Walker|Ron Perlman,Mark Illsley,98,Comedy|Crime,1999-12-03,13,5.3,1999,2225389,2544339,318950,5
2584,0.198126,38000000,635096,-37364904,Ride with the Devil,Tobey Maguire|Skeet Ulrich|Jeffrey Wright|Jewel|Jonathan Rhys Meyers,Ang Lee,138,Drama|War|Romance|Western,1999-11-24,15,6.6,1999,49744008,831374,-48912634,7
2586,0.195048,3000000,3076820,76820,Jawbreaker,Rose McGowan|Julie Benz|Rebecca Gayheart|Carol Kane|Pam Grier,Darren Stein,87,Comedy,1999-01-30,48,5.6,1999,3927158,4027719,100561,6
2589,0.187319,13000000,27500000,14500000,Dick,Kirsten Dunst|Michelle Williams|Will Ferrell|Dan Hedaya|Bruce McCulloch,Andrew Fleming,94,Comedy,1999-08-04,33,5.7,1999,17017687,35998953,18981266,6
2591,0.173433,25000000,12000000,-13000000,The King and I,Miranda Richardson|Martin Vidnovic|Ian Richardson|Darrell Hammond|Christiane Noll,Richard Rich,87,Animation|Drama|Family,1999-03-19,14,4.7,1999,32726321,15708634,-17017687,5
2596,0.163336999999999,7000000,7292175,292175,Outside Providence,Shawn Hatosy|Amy Smart|Alec Baldwin|Jon Abrahams|Richard Jenkins,Michael Corrente,96,Romance|Comedy|Drama,1999-08-16,12,5.6,1999,9163369,9545842,382473,6
2610,0.118187,450000,2049595,1599595,Trick,Tori Spelling|Christian Campbell|John Paul Pitoc|Brad Beyer,Jim Fall,89,Comedy|Romance,1999-07-23,10,6.5,1999,589073,2683028,2093955,6
2611,0.116694,12000000,36450736,24450736,Baby Geniuses,Kathleen Turner|Christopher Lloyd|Kim Cattrall|Peter MacNicol|Dom DeLuise,Bob Clark,97,Comedy|Family|Science Fiction,1999-03-12,34,3.8,1999,15708634,47715939,32007305,4
2617,0.238748,3800000,28200000,24400000,East Is East,Om Puri|Linda Bassett|Ian Aspinall|Jimi Mistry|Archie Panjabi,Damien O'Donnell,97,Comedy,1999-05-14,24,6.5,1999,4974400,36915290,31940890,6
2618,0.090186,1,100,99,Lost & Found,David Spade|Sophie Marceau|Ever Carradine|Stephanie Chang|Neal MacMillan,Jeff Pollack,95,Comedy|Romance,1999-04-23,14,4.8,1999,1,130,129,5
2624,0.079104,12000000,21001563,9001563,Tea with Mussolini,Cher|Judi Dench|Joan Plowright|Maggie Smith|Lily Tomlin,Franco Zeffirelli,117,Comedy|Drama|War,1999-03-25,17,5.7,1999,15708634,27492155,11783521,6
2633,8.575419,93000000,871368364,778368364,The Lord of the Rings: The Fellowship of the Ring,Elijah Wood|Ian McKellen|Viggo Mortensen|Liv Tyler|Orlando Bloom,Peter Jackson,178,Adventure|Fantasy|Action,2001-12-18,6079,7.8,2001,114528394,1073079785,958551391,8
2634,8.021423,125000000,976475550,851475550,Harry Potter and the Philosopher's Stone,Daniel Radcliffe|Rupert Grint|Emma Watson|John Cleese|Robbie Coltrane,Chris Columbus,152,Adventure|Fantasy|Family,2001-11-16,4265,7.2,2001,153936014,1202518036,1048582022,7
2635,4.436367,15000000,20117339,5117339,Mulholland Drive,Naomi Watts|Laura Harring|Ann Miller|Dan Hedaya|Justin Theroux,David Lynch,147,Thriller|Drama|Mystery,2001-05-16,709,7.4,2001,18472321,24774263,6301942,7
2636,3.851009,6000000,1270522,-4729478,Donnie Darko,Jake Gyllenhaal|Patrick Swayze|Drew Barrymore|Maggie Gyllenhaal|Holmes Osborne,Richard Kelly,113,Fantasy|Drama|Mystery,2001-01-18,1777,7.5,2001,7388928,1564632,-5824296,7
2637,3.204295,115000000,562816256,447816256,"Monsters, Inc.",John Goodman|Billy Crystal|Mary Gibbs|Steve Buscemi|James Coburn,Lee Unkrich|David Silverman|Pete Docter,92,Fantasy|Animation|Family|Comedy,2001-11-01,3899,7.3,2001,141621133,693101531,551480398,7
2638,2.971372,100000000,235926552,135926552,A.I. Artificial Intelligence,Haley Joel Osment|Frances O'Connor|Sam Robards|Jake Thomas|Jude Law,Steven Spielberg,146,Drama|Science Fiction|Adventure,2001-06-29,1133,6.6,2001,123148811,290540745,167391934,7
2639,2.918566,60000000,484409218,424409218,Shrek,Mike Myers|Eddie Murphy|Cameron Diaz|John Lithgow|Vincent Cassel,Andrew Adamson|Vicky Jenson,90,Adventure|Animation|Comedy|Family|Fantasy,2001-05-16,2284,7.1,2001,73889287,596544195,522654908,7
2640,2.717399,25000000,281929795,256929795,Bridget Jones's Diary,RenÃ©e Zellweger|Colin Firth|Hugh Grant|Gemma Jones|Jim Broadbent,Sharon Maguire,97,Comedy|Romance|Drama,2001-04-13,751,6.5,2001,30787202,347193192,316405990,6
2641,2.642249,85000000,450717150,365717150,Ocean's Eleven,George Clooney|Brad Pitt|Matt Damon|Andy GarcÃ­a|Julia Roberts,Steven Soderbergh,116,Thriller|Crime,2001-12-07,2645,7.0,2001,104676489,555052814,450376325,7
2642,2.478879,140000000,449220945,309220945,Pearl Harbor,Ben Affleck|Josh Hartnett|Kate Beckinsale|Cuba Gooding Jr.|Jon Voight,Michael Bay,183,History|Romance|War,2001-05-21,1044,6.6,2001,172408336,553210255,380801919,7
2643,2.449323,98000000,433013274,335013274,The Mummy Returns,Brendan Fraser|Rachel Weisz|John Hannah|Arnold Vosloo|Oded Fehr,Stephen Sommers,130,Action|Adventure|Drama|Fantasy|Horror,2001-04-28,1372,5.8,2001,120685835,533250701,412564866,6
2644,2.217239,120000000,186053725,66053725,Atlantis: The Lost Empire,Michael J. Fox|Corey Burton|Claudia Christian|James Garner|John Mahoney,Gary Trousdale|Kirk Wise,95,Animation|Family|Adventure|Science Fiction,2001-06-02,689,6.5,2001,147778574,229122951,81344377,6
2645,2.179727,115000000,274703340,159703340,Lara Croft: Tomb Raider,Angelina Jolie|Jon Voight|Iain Glen|Noah Taylor|Daniel Craig,Simon West,100,Adventure|Fantasy|Action|Thriller,2001-06-11,1510,5.6,2001,141621133,338293898,196672765,6
2646,2.169826,60000000,313542341,253542341,A Beautiful Mind,Russell Crowe|Ed Harris|Jennifer Connelly|Christopher Plummer|Paul Bettany,Ron Howard,135,Drama|Romance,2001-12-11,1786,7.5,2001,73889287,386123667,312234380,7
2647,2.116602,30000000,287553595,257553595,American Pie 2,Jason Biggs|Thomas Ian Nicholas|Chris Klein|Seann William Scott|Eddie Kaye Thomas,J.B. Rogers,108,Comedy|Romance,2001-08-10,777,5.9,2001,36944643,354118835,317174192,6
2648,2.061559,37000000,165335153,128335153,The Princess Diaries,Anne Hathaway|Julie Andrews|Heather Matarazzo|Robert Schwartzman|HÃ©ctor Elizondo,Garry Marshall,115,Comedy|Family|Romance,2001-08-03,534,6.3,2001,45565060,203608276,158043216,6
2649,1.925281,52500000,179213434,126713434,Moulin Rouge!,Nicole Kidman|Ewan McGregor|John Leguizamo|Jim Broadbent|Richard Roxburgh,Baz Luhrmann,127,Romance|Drama|Music,2001-03-09,714,7.2,2001,64653126,220699214,156046088,7
2650,1.862114,100000000,362211740,262211740,Planet of the Apes,Mark Wahlberg|Tim Roth|Helena Bonham Carter|Michael Clarke Duncan|Kris Kristofferson,Tim Burton,119,Thriller|Science Fiction|Action|Adventure,2001-07-25,702,5.5,2001,123148811,446059453,322910642,5
2651,1.857978,21000000,71441250,50441250,The Royal Tenenbaums,Gene Hackman|Anjelica Huston|Ben Stiller|Gwyneth Paltrow|Luke Wilson,Wes Anderson,110,Comedy|Drama,2001-10-05,679,7.3,2001,25861250,87979050,62117800,7
2652,1.846848,53000000,83282296,30282296,Blow,Johnny Depp|PenÃ©lope Cruz|Ethan Suplee|Ray Liotta|Franka Potente,Ted Demme,124,Crime|Drama,2001-04-04,788,7.3,2001,65268870,102561157,37292287,7
2653,1.839325,70000000,96976270,26976270,Enemy at the Gates,Jude Law|Rachel Weisz|Ed Harris|Joseph Fiennes|Bob Hoskins,Jean-Jacques Annaud,131,War,2001-03-13,583,7.1,2001,86204168,119425124,33220956,7
2654,1.735123,92000000,172989651,80989651,Black Hawk Down,Josh Hartnett|Ewan McGregor|Jason Isaacs|Tom Sizemore|William Fichtner,Ridley Scott,144,Action|History|War,2001-12-28,1201,7.1,2001,113296906,213034699,99737793,7
2655,1.69775299999999,18000000,141774679,123774679,Legally Blonde,Reese Witherspoon|Luke Wilson|Selma Blair|Matthew Davis|Victor Garber,Robert Luketic,96,Comedy,2001-07-13,480,6.1,2001,22166786,174593832,152427046,6
2656,1.692141,65000000,117487473,52487473,A Knight's Tale,Heath Ledger|Rufus Sewell|Shannyn Sossamon|Paul Bettany|Laura Fraser,Brian Helgeland,132,Adventure|Drama|Romance|Action,2001-05-11,521,6.5,2001,80046727,144684426,64637699,6
2657,1.581446,28000000,60780981,32780981,Zoolander,Ben Stiller|Owen Wilson|Christine Taylor|Will Ferrell|Milla Jovovich,Ben Stiller,89,Comedy,2001-09-28,791,6.1,2001,34481667,74851055,40369388,6
2658,1.456526,16000000,66468332,50468332,Not Another Teen Movie,Chyler Leigh|Chris Evans|Jaime Pressly|Eric Christian Olsen|Mia Kirshner,Joel Gallen,89,Comedy,2001-12-07,223,5.3,2001,19703809,81854960,62151151,5
2659,1.450364,45000000,141220678,96220678,Scary Movie 2,Anna Faris|Marlon Wayans|James DeBello|Shawn Wayans|David Cross,Keenen Ivory Wayans,83,Comedy,2001-07-04,474,5.5,2001,55416965,173911586,118494621,5
2660,1.447916,90000000,347325802,257325802,Rush Hour 2,"Chris Tucker|Jackie Chan|Zhang Ziyi|Roselyn SÃ¡nchez|Ernie Reyes, Jr.",Brett Ratner,90,Action|Comedy|Crime|Thriller,2001-08-03,622,6.5,2001,110833930,427727597,316893667,6
2661,1.446063,45000000,104876233,59876233,Training Day,Denzel Washington|Ethan Hawke|Scott Glenn|Tom Berenger|Harris Yulin,Antoine Fuqua,122,Action|Crime|Drama|Thriller,2001-10-05,1029,7.2,2001,55416965,129153834,73736869,7
2662,1.406682,17000000,209947037,192947037,The Others,Nicole Kidman|Christopher Eccleston|Alakina Mann|James Bentley|Eric Sykes,Alejandro AmenÃ¡bar,101,Horror|Drama|Mystery|Thriller,2001-08-02,872,7.1,2001,20935297,258547281,237611984,7
2663,1.213215,25000000,80936232,55936232,Jimmy Neutron: Boy Genius,Debi Derryberry|Megan Cavanagh|Mark DeCarlo|Jeffrey Garcia|Patrick Stewart,John A. Davis,83,Adventure|Fantasy|Animation|Action|Comedy,2001-12-21,139,5.5,2001,30787202,99672007,68884805,5
2664,1.20913,22000000,33788161,11788161,Jay and Silent Bob Strike Back,Kevin Smith|Jason Mewes|Ben Affleck|Jeff Anderson|Brian O'Halloran,Kevin Smith,104,Comedy,2001-08-22,244,6.3,2001,27092738,41609718,14516980,6
2665,1.195555,28000000,77516304,49516304,Serendipity,John Cusack|Kate Beckinsale|Jeremy Piven|Bridget Moynahan|Eugene Levy,Peter Chelsom,90,Comedy|Romance,2001-10-05,310,6.6,2001,34481667,95460407,60978740,7
2666,1.134012,60000000,93375151,33375151,Cats & Dogs,Jeff Goldblum|Elizabeth Perkins|Alexander Pollock|Miriam Margolyes|Tobey Maguire,Lawrence Guterman,87,Comedy|Family,2001-07-04,182,5.0,2001,73889287,114990388,41101101,5
2667,1.131878,68000000,203388341,135388341,Vanilla Sky,Tom Cruise|PenÃ©lope Cruz|Cameron Diaz|Kurt Russell|Jason Lee,Cameron Crowe,136,Drama|Mystery|Romance|Science Fiction|Thriller,2001-12-10,628,6.3,2001,83741191,250470325,166729134,6
2669,1.065364,25000000,64437847,39437847,Kiss of the Dragon,Jet Li|Bridget Fonda|TchÃ©ky Karyo|Max Ryan|Ric Young,Chris Nahon,98,Action|Crime|Thriller,2001-07-06,152,6.3,2001,30787202,79354442,48567240,6
2670,1.063015,92000000,143049560,51049560,Spy Game,Robert Redford|Brad Pitt|Catherine McCormack|Stephen Dillane|Larry Bryggman,Tony Scott,126,Action|Crime|Thriller,2001-11-18,342,6.5,2001,113296906,176163833,62866927,6
2671,1.062734,102000000,147080413,45080413,Swordfish,John Travolta|Hugh Jackman|Halle Berry|Don Cheadle|Sam Shepard,Dominic Sena,99,Action|Crime|Thriller,2001-06-07,606,6.0,2001,125611787,181127780,55515993,6
2672,1.061903,40000000,141069860,101069860,Shallow Hal,Gwyneth Paltrow|Jack Black|Jason Alexander|Joe Viterelli|Bruce McGill,Bobby Farrelly|Peter Farrelly,114,Comedy|Romance,2001-11-01,394,5.5,2001,49259524,173725856,124466332,5
2675,0.976997,30000000,17833000,-12167000,AntiTrust,Ryan Phillippe|Rachael Leigh Cook|Tim Robbins|Claire Forlani|Richard Roundtree,Peter Howitt,108,Action|Crime|Drama,2001-01-12,82,5.6,2001,36944643,21961127,-14983516,6
2676,0.974222,137000000,85131830,-51868170,Final Fantasy: The Spirits Within,Donald Sutherland|Ming-Na Wen|Alec Baldwin|Ving Rhames|Steve Buscemi,Hironobu Sakaguchi|Motonori Sakakibara,106,Adventure|Action|Animation|Fantasy|Science Fiction,2001-07-02,257,5.6,2001,168713871,104838836,-63875035,6
2678,0.945429,42000000,35402320,-6597680,Original Sin,Angelina Jolie|Antonio Banderas|Gregory Itzin|Jack Thompson|Allison Mackie,Michael Cristofer,118,Drama|Thriller|Mystery|Romance,2001-08-03,115,5.8,2001,51722500,43597536,-8124964,6
2679,0.913069,70000000,176104344,106104344,Dr. Dolittle 2,Eddie Murphy|Kristen Wilson|Raven-SymonÃ©|Kyla Pratt|Mandy Moore,Steve Carr,87,Comedy|Family|Romance|Fantasy,2001-06-22,233,4.9,2001,86204168,216870406,130666238,5
2680,0.90472,40000000,91753202,51753202,Behind Enemy Lines,Owen Wilson|Gene Hackman|Gabriel Macht|Charles Malik Whitfield|David Keith,John Moore,106,Action|Drama|Thriller|War,2001-11-17,270,5.9,2001,49259524,112992977,63733453,6
2681,0.899763999999999,10000000,59217789,49217789,Jeepers Creepers,Gina Philips|Justin Long|Jonathan Breck|Patricia Belcher|Eileen Brennan,Victor Salva,90,Horror|Thriller,2001-07-01,384,6.0,2001,12314881,72926003,60611122,6
2684,0.875298999999999,35000000,74558115,39558115,From Hell,Johnny Depp|Heather Graham|Ian Holm|Robbie Coltrane|Ian Richardson,Albert Hughes|Allen Hughes,122,Horror|Mystery|Thriller,2001-10-19,399,6.4,2001,43102084,91817432,48715348,6
2685,0.865406999999999,72000000,27642707,-44357293,The Last Castle,Robert Redford|James Gandolfini|Mark Ruffalo|Steve Burton|Delroy Lindo,Rod Lurie,131,Action|Drama|Thriller,2001-10-19,154,7.1,2001,88667144,34041665,-54625479,7
2686,0.844235,60000000,105178561,45178561,Along Came a Spider,Morgan Freeman|Monica Potter|Michael Wincott|Dylan Baker|Mika Boorem,Lee Tamahori,104,Crime|Mystery|Thriller|Action,2001-04-06,215,5.8,2001,73889287,129526148,55636861,6
2687,0.813396,3000000,18492362,15492362,Super Troopers,Jay Chandrasekhar|Steve Lemme|Kevin Heffernan|Paul Soter|Geoffrey Arend,Jay Chandrasekhar,100,Comedy|Crime|Mystery,2001-01-18,224,6.7,2001,3694464,22773124,19078660,7
2688,0.798104,35000000,94728529,59728529,The Wedding Planner,Jennifer Lopez|Matthew McConaughey|Justin Chambers|Joanna Gleason|Lou Myers,Adam Shankman,103,Comedy,2001-01-26,245,5.4,2001,43102084,116657057,73554973,5
2689,0.787835,48000000,85498534,37498534,Rat Race,Cuba Gooding Jr.|Seth Green|Whoopi Goldberg|Breckin Meyer|Amy Smart,Jerry Zucker,112,Adventure|Comedy,2001-07-30,261,5.9,2001,59111429,105290428,46178999,6
2690,0.781747,19800000,87754044,67954044,Gosford Park,Helen Mirren|Clive Owen|Maggie Smith|Geraldine Somerville|Jeremy Northam,Robert Altman,137,Drama|Mystery|Thriller,2001-11-07,107,6.6,2001,24383464,108068062,83684598,7
2691,0.774598,11000000,16000000,5000000,Jason X,Kane Hodder|Lexa Doig|Chuck Campbell|Lisa Ryder|David Cronenberg,James Isaac,91,Horror|Science Fiction,2001-07-24,138,4.3,2001,13546369,19703809,6157440,4
2692,0.746989,57000000,147845033,90845033,The Mexican,Brad Pitt|Julia Roberts|James Gandolfini|J.K. Simmons|Gene Hackman,Gore Verbinski,123,Action|Comedy|Crime|Romance,2001-03-01,258,5.7,2001,70194822,182069401,111874579,6
2693,0.742951,23000000,36642838,13642838,Joy Ride,Steve Zahn|Paul Walker|Leelee Sobieski|Jessica Bowman|Stuart Stone,John Dahl,97,Mystery|Thriller|Drama,2001-10-05,166,6.2,2001,28324226,45125219,16800993,6
2694,0.731548,22000000,40270895,18270895,I Am Sam,Sean Penn|Michelle Pfeiffer|Dakota Fanning|Dianne Wiest|Marin Hinkle,Jessie Nelson,132,Drama,2001-12-28,292,7.2,2001,27092738,49593128,22500390,7
2699,0.693522,57000000,16991902,-40008098,Rock Star,Mark Wahlberg|Jennifer Aniston|Jason Flemyng|Dominic West|Jason Bonham,Stephen Herek,105,Music|Drama|Comedy,2001-09-04,100,5.9,2001,70194822,20925325,-49269497,6
2701,0.676114,48000000,50315140,2315140,K-PAX,Jeff Bridges|Kevin Spacey|Mary McCormack|Alfre Woodard|Ajay Naidu,Iain Softley,120,Drama|Science Fiction,2001-10-22,330,7.0,2001,59111429,61962496,2851067,7
2704,0.65104,50000000,100020092,50020092,Don't Say a Word,Michael Douglas|Sean Bean|Brittany Murphy|Skye McCole Bartusiak|Guy Torry,Gary Fleder,113,Thriller,2001-09-28,106,6.1,2001,61574405,123173554,61599149,6
2706,0.635377,21150000,39438674,18288674,Crocodile Dundee in Los Angeles,Paul Hogan|Linda Kozlowski|Jere Burns|Jonathan Banks|Alec Wilson,Simon Wincer,92,Adventure|Comedy,2001-04-12,75,4.8,2001,26045973,48568258,22522285,5
2707,0.625438,11000000,13110448,2110448,Frailty,Bill Paxton|Matthew McConaughey|Powers Boothe|Matt O'Leary|Jeremy Sumpter,Bill Paxton,100,Drama|Thriller|Crime,2001-11-17,136,6.8,2001,13546369,16145360,2598991,7
2709,0.612923,53000000,29700000,-23300000,Angel Eyes,Jennifer Lopez|Jim Caviezel|Jeremy Sisto|Terrence Howard|SÃ´nia Braga,Luis Mandoki,102,Drama|Romance|Thriller,2001-05-15,51,5.6,2001,65268870,36575197,-28693673,6
2712,0.589432,31000000,24185781,-6814219,Hearts in Atlantis,Anthony Hopkins|Anton Yelchin|Hope Davis|Mika Boorem|David Morse,Scott Hicks,101,Drama|Mystery,2001-09-07,60,6.3,2001,38176131,29784501,-8391630,6
2714,0.578314999999999,30000000,23619609,-6380391,The Glass House,Leelee Sobieski|Diane Lane|Stellan SkarsgÃ¥rd|Bruce Dern|Kathy Baker,Daniel Sackheim,106,Drama|Thriller,2001-09-14,108,5.3,2001,36944643,29087267,-7857376,5
2715,0.572909,60000000,56359980,-3640020,15 Minutes,Robert De Niro|Charlize Theron|Edward Burns|Kelsey Grammer|Avery Brooks,John Herzfeld,120,Action|Crime|Thriller,2001-03-01,84,5.7,2001,73889287,69406645,-4482642,6
2717,0.565877,32000000,40222729,8222729,Hardball,Keanu Reeves|Diane Lane|Michael B. Jordan|D. B. Sweeney|John Hawkes,Brian Robbins,106,Comedy|Romance,2001-09-14,62,6.4,2001,39407619,49533812,10126193,6
2718,0.561179,80000000,98376292,18376292,Evolution,David Duchovny|Julianne Moore|Orlando Jones|Seann William Scott|Ted Levine,Ivan Reitman,101,Action|Comedy|Science Fiction,2001-06-08,362,5.4,2001,98519049,121149234,22630185,5
2721,0.554186,107000000,87713825,-19286175,Ali,Will Smith|Jamie Foxx|Jon Voight|Mario Van Peebles|Ron Silver,Michael Mann,157,Drama,2001-12-11,253,6.7,2001,131769228,108018533,-23750695,7
2723,0.530702999999999,1500000,373967,-1126033,Session 9,Peter Mullan|David Caruso|Stephen Gevedon|Josh Lucas|Brendan Sexton III,Brad Anderson,100,Horror|Mystery,2001-08-10,94,6.0,2001,1847232,460535,-1386697,6
2724,0.526992,68000000,71069884,3069884,The Score,Robert De Niro|Edward Norton|Marlon Brando|Angela Bassett|Paul Soles,Frank Oz,124,Action|Crime|Thriller,2001-07-13,217,6.6,2001,83741191,87521717,3780526,7
2725,0.522846,4000000,44909486,40909486,Monster's Ball,Halle Berry|Billy Bob Thornton|Heath Ledger|Sean Combs|Coronji Calhoun,Marc Forster,111,Drama|Romance,2001-11-11,107,6.4,2001,4925952,55305498,50379546,6
2726,0.521071,17700000,30987695,13287695,Joe Dirt,David Spade|Brittany Daniel|Dennis Miller|Adam Beach|Jaime Pressly,Dennie Gordon,91,Mystery|Adventure|Comedy|Romance|Drama,2001-04-10,122,5.5,2001,21797339,38160978,16363639,5
2728,0.510452,50000000,79958599,29958599,Exit Wounds,Steven Seagal|DMX|Isaiah Washington|Anthony Anderson|Bill Duke,Andrzej Bartkowiak,101,Action|Crime|Thriller,2001-03-13,52,5.0,2001,61574405,98468064,36893659,5
2729,0.509877999999999,21000000,28008462,7008462,The Tailor of Panama,Pierce Brosnan|Geoffrey Rush|Jamie Lee Curtis|Leonor Varela|Brendan Gleeson,John Boorman,109,Drama|Thriller,2001-02-11,45,5.7,2001,25861250,34492088,8630838,6
2730,0.499611,40000000,65754228,25754228,Sweet November,Keanu Reeves|Charlize Theron|Jason Isaacs|Greg Germann|Lauren Graham,Pat O'Connor,119,Drama|Romance,2001-02-16,157,6.5,2001,49259524,80975550,31716026,6
2731,0.499301,12000000,31155435,19155435,How High,Method Man|Redman|Obba BabatundÃ©|Mike Epps|Anna Maria Horsford,Jesse Dylan,93,Comedy,2001-12-21,126,6.5,2001,14777857,38367547,23589690,6
2733,0.493288,11000000,23430766,12430766,Tomcats,Jerry O'Connell|Shannon Elizabeth|Jake Busey|Horatio Sanz|Bernie Casey,Gregory Poirier,95,Comedy|Romance,2001-03-30,37,4.8,2001,13546369,28854709,15308340,5
2735,0.472538,72000000,37317558,-34682442,The Majestic,Jim Carrey|Martin Landau|Laurie Holden|David Ogden Stiers|Hal Holbrook,Frank Darabont,152,Drama|Romance,2001-12-21,82,6.5,2001,88667144,45956129,-42711015,6
2736,0.471789,62000000,18720175,-43279825,3000 Miles to Graceland,Kurt Russell|Kevin Costner|Courteney Cox|Christian Slater|Kevin Pollak,Demian Lichtenstein,125,Action|Adventure|Comedy|Thriller|Crime,2001-02-23,85,5.4,2001,76352263,23053673,-53298590,5
2738,0.467091,100000,490475,390475,Tape,Uma Thurman|Ethan Hawke|Robert Sean Leonard,Richard Linklater,86,Drama,2001-01-26,28,6.6,2001,123148,604014,480866,7
2741,0.453846,2079000,4099000,2020000,Dil Chahta Hai,Aamir Khan|Saif Ali Khan|Akshaye Khanna|Preity Zinta|Sonali Kulkarni,Farhan Akhtar,183,Drama|Romance,2001-07-24,32,7.3,2001,2560263,5047869,2487606,7
2742,0.451722,28000000,14010832,-13989168,Ghosts of Mars,Natasha Henstridge|Ice Cube|Jason Statham|Clea DuVall|Pam Grier,John Carpenter,98,Action|Horror|Science Fiction,2001-08-24,135,4.6,2001,34481667,17254173,-17227494,5
2743,0.447612,22000000,19351569,-2648431,Saving Silverman,Jason Biggs|Steve Zahn|Jack Black|Amanda Peet|Amanda Detmer,Dennis Dugan,90,Comedy|Romance|Crime,2001-02-09,75,5.2,2001,27092738,23831227,-3261511,5
2745,0.443923,48000000,35743308,-12256692,Riding in Cars with Boys,Drew Barrymore|Steve Zahn|Adam Garcia|Brittany Murphy|Logan Lerman,Penny Marshall,132,Comedy|Drama|Romance,2001-10-19,54,6.4,2001,59111429,44017459,-15093970,6
2747,0.439101,75000000,13596911,-61403089,Osmosis Jones,Chris Rock|Laurence Fishburne|David Hyde Pierce|Brandy Norwood|Bill Murray,Bobby Farrelly|Peter Farrelly,95,Adventure|Animation|Action|Comedy|Family,2001-08-07,128,5.6,2001,92361608,16744434,-75617174,6
2751,0.421293,14000000,10424470,-3575530,Head Over Heels,Monica Potter|Freddie Prinze Jr.|Shalom Harlow|Ivana MiliÄeviÄ‡|Sarah Murdoch,Mark Waters,86,Comedy|Romance,2001-02-02,43,5.3,2001,17240833,12837610,-4403223,5
2753,0.414311,38000000,207283925,169283925,The Fast and the Furious,Paul Walker|Vin Diesel|Michelle Rodriguez|Jordana Brewster|Rick Yune,Rob Cohen,106,Action|Crime|Thriller,2001-06-22,2505,6.4,2001,46796548,255267690,208471142,6
2754,0.40848,6000000,705308,-5294692,Human Nature,Patricia Arquette|Tim Robbins|Rhys Ifans|Miranda Otto|Rosie Perez,Michel Gondry,96,Drama|Comedy,2001-05-18,30,5.7,2001,7388928,868578,-6520350,6
2755,0.405522,13000000,91038276,78038276,Save the Last Dance,Julia Stiles|Sean Patrick Thomas|Kerry Washington|Fredro Starr|Terry Kinney,Thomas Carter,112,Drama|Family|Romance|Music,2001-01-12,194,6.4,2001,16009345,112112555,96103210,6
2760,0.386262,35000000,147934180,112934180,Spy Kids,Alexa PenaVega|Daryl Sabara|Antonio Banderas|Carla Gugino|Alan Cumming,Robert Rodriguez,88,Action|Comedy|Family|Adventure,2001-03-18,467,5.5,2001,43102084,182179184,139077100,5
2761,0.38279,35000000,29400000,-5600000,The Pledge,Jack Nicholson|Aaron Eckhart|Helen Mirren|Robin Wright|Vanessa Redgrave,Sean Penn,123,Crime|Drama|Mystery|Thriller,2001-01-09,84,6.1,2001,43102084,36205750,-6896334,6
2764,0.381751,75000000,67631903,-7368097,Bandits,Bruce Willis|Billy Bob Thornton|Cate Blanchett|Troy Garity|William Converse-Roberts,Barry Levinson,123,Action|Comedy|Crime|Romance,2001-10-12,173,6.1,2001,92361608,83287884,-9073724,6
2765,0.380227,22000000,84772742,62772742,The Animal,Rob Schneider|Colleen Haskell|John C. McGinley|Ed Asner|Guy Torry,Luke Greenfield,84,Action|Comedy,2001-06-01,145,4.5,2001,27092738,104396624,77303886,4
2766,0.379856,15000000,12000000,-3000000,Knockaround Guys,Barry Pepper|Andy Davoli|Seth Green|Vin Diesel|John Malkovich,Brian Koppelman|David Levien,92,Crime|Thriller,2001-09-07,46,5.7,2001,18472321,14777857,-3694464,6
2769,0.541416,13000000,16929123,3929123,Crazy/Beautiful,Kirsten Dunst|Jay Hernandez|Bruce Davison|Herman Osorio|Miguel Castro,John Stockwell,99,Drama|Romance,2001-06-29,57,6.6,2001,16009345,20848013,4838668,7
2772,0.20867,94000000,54744738,-39255262,Driven,Kip Pardue|Robert Sean Leonard|Til Schweiger|Estella Warren|Sylvester Stallone,Renny Harlin,116,Action,2001-04-27,90,4.8,2001,115759882,67417494,-48342388,5
2773,0.348262,24000000,14782676,-9217324,Out Cold,Jason London|Lee Majors|Zach Galifianakis|David Koechner|Willie Garson,Brendan Malloy|Emmett Malloy,89,Comedy,2001-11-21,28,6.1,2001,29555714,18204689,-11351025,6
2777,0.328665,35000000,13678913,-21321087,American Outlaws,Colin Farrell|Scott Caan|Ali Larter|Gabriel Macht|Gregory Smith,Les Mayfield,94,Action|Western,2001-08-17,26,5.8,2001,43102084,16845418,-26256666,6
2778,0.324227,87000000,351692268,264692268,Hannibal,Anthony Hopkins|Julianne Moore|Gary Oldman|Ray Liotta|David Andrews,Ridley Scott,131,Crime|Drama|Thriller|Horror,2001-02-08,772,6.3,2001,107139466,433104848,325965382,6
2779,0.323191,75000000,54249294,-20750706,Domestic Disturbance,John Travolta|Vince Vaughn|Teri Polo|Matt O'Leary|Steve Buscemi,Harold Becker,89,Mystery|Thriller|Crime,2001-10-30,50,5.4,2001,92361608,66807360,-25554248,5
2782,0.501163,10000000,44460850,34460850,Recess: School's Out,Rickey D'Shon Collins|Jason Davis|Ashley Johnson|Courtland Mead|Pamela Adlon,Chuck Sheetz,83,Animation|Comedy|Family,2001-01-27,42,6.5,2001,12314881,54753008,42438127,6
2793,0.299969,34000000,19693891,-14306109,Summer Catch,Freddie Prinze Jr.|Jessica Biel|Fred Ward|Matthew Lillard|Brian Dennehy,Mike Tollin,108,Drama|Comedy|Romance,2001-08-22,35,4.8,2001,41870595,24252792,-17617803,5
2794,0.274314,5000000,295206,-4704794,Wet Hot American Summer,Janeane Garofalo|David Hyde Pierce|Michael Showalter|Marguerite Moreau|Paul Rudd,David Wain,97,Comedy,2001-07-27,163,6.5,2001,6157440,363542,-5793898,6
2800,0.353327,1500000,416925,-1083075,The Believer,Ryan Gosling|Summer Phoenix|Theresa Russell|Billy Zane|Joshua Harto,Henry Bean,98,Drama,2001-01-19,78,6.8,2001,1847232,513438,-1333794,7
2801,0.269944,12000000,17292381,5292381,Max Keeble's Big Move,Alex D. Linz|Zena Grey|Nora Dunn|Larry Miller|Josh Peck,Tim Hill,86,Comedy|Family|Fantasy|Science Fiction,2001-10-05,18,5.3,2001,14777857,21295361,6517504,5
2802,0.263042,75000000,5409517,-69590483,Monkeybone,Brendan Fraser|Bridget Fonda|John Turturro|Chris Kattan|Giancarlo Esposito,Henry Selick,93,Adventure|Fantasy|Animation|Action|Comedy,2001-02-23,37,4.0,2001,92361608,6661755,-85699853,4
2805,0.251798,250000,4186931,3936931,Lovely & Amazing,Catherine Keener|Brenda Blethyn|Emily Mortimer|Jake Gyllenhaal|James Le Gros,Nicole Holofcener,91,Comedy|Drama|Romance,2001-08-31,10,6.3,2001,307872,5156155,4848283,6
2810,0.239869,11000000,23978402,12978402,Corky Romano,Chris Kattan|Vinessa Shaw|Peter Falk|Peter Berg|Chris Penn,Rob Pritts,86,Action|Comedy|Crime,2001-10-12,20,4.4,2001,13546369,29529117,15982748,4
2820,0.167033,93000000,368780809,275780809,Jurassic Park III,Sam Neill|William H. Macy|TÃ©a Leoni|Trevor Morgan|Alessandro Nivola,Joe Johnston,92,Adventure|Action|Thriller|Science Fiction,2001-07-18,1366,5.6,2001,114528394,454149183,339620789,6
2823,0.20688,57000000,62112895,5112895,Captain Corelli's Mandolin,Nicolas Cage|PenÃ©lope Cruz|Christian Bale|Irene Papas|Gerasimos Skiadaressis,John Madden,131,Drama|History|Romance,2001-08-17,67,5.6,2001,70194822,76491292,6296470,6
2832,0.195196,1000000,10013424,9013424,Kissing Jessica Stein,Jennifer Westfeldt|Tovah Feldshuh|Esther Wurmfeld|Hillel Friedman|Jon Hamm,Charles Herman-Wurmfeld,97,Comedy,2001-04-21,22,5.9,2001,1231488,12331412,11099924,6
2836,0.191566,40000000,27053815,-12946185,The Musketeer,Catherine Deneuve|Mena Suvari|Stephen Rea|Tim Roth|Justin Chambers,Peter Hyams,104,Action|Adventure|Drama,2001-09-07,32,5.1,2001,49259524,33316451,-15943073,5
2837,0.189393,7000000,3646994,-3353006,The Cat's Meow,Kirsten Dunst|Edward Herrmann|Eddie Izzard|Cary Elwes|Joanna Lumley,Peter Bogdanovich,114,Drama|Mystery|Thriller,2001-08-03,19,5.7,2001,8620416,4491229,-4129187,6
2840,0.185009,700000,1667192,967192,L.I.E. Long Island Expressway,Paul Dano|Bruce Altman|Brian Cox|Billy Kay|James Costa,Michael Cuesta,97,Drama,2001-01-20,13,5.2,2001,862041,2053127,1191086,5
2845,0.164669,6000000,2025238,-3974762,Novocaine,Chelcie Ross|Steve Martin|Laura Dern|Lynne Thigpen|Polly Noonan,David Atkins,95,Comedy|Crime|Thriller,2001-11-23,12,5.9,2001,7388928,2494056,-4894872,6
2846,0.26321,11000000,13276953,2276953,Sugar & Spice,Marla Sokoloff|Marley Shelton|Melissa George|Mena Suvari|Rachel Blanchard,Francine McDougall,81,Crime|Comedy,2001-01-24,31,5.4,2001,13546369,16350409,2804040,5
2849,0.148963,10000000,7316658,-2683342,Bones,Snoop Dogg|Pam Grier|Michael T. Weiss|Clifton Powell|Katharine Isabelle,Ernest R. Dickerson,96,Action|Horror|Thriller,2001-10-24,17,4.0,2001,12314881,9010377,-3304504,4
2854,0.12891,7000000,10229331,3229331,The Wash,Dr. Dre|Snoop Dogg|DJ Pooh|Angell Conwell|Bruce Bruce,DJ Pooh,93,Action|Comedy,2001-11-16,15,5.6,2001,8620416,12597299,3976883,6
2855,0.128169,15000000,163169,-14836831,Down,Naomi Watts|James Marshall|Michael Ironside|Edward Herrmann|Dan Hedaya,Dick Maas,111,Action|Horror|Mystery|Thriller,2001-05-11,10,3.7,2001,18472321,200940,-18271381,4
2856,0.126065,5000000,5476060,476060,Made,Vince Vaughn|Jon Favreau|Sean Combs|Famke Janssen|Peter Falk,Jon Favreau,94,Action|Comedy|Thriller,2001-07-13,19,5.8,2001,6157440,6743702,586262,6
2865,0.089976,16000000,29381649,13381649,Baby Boy,Tyrese Gibson|Taraji P. Henson|Omar Gooding|Ving Rhames|Snoop Dogg,John Singleton,130,Drama|Comedy|Crime,2001-06-27,29,7.4,2001,19703809,36183151,16479342,7
2875,8.46666799999999,185000000,1001921825,816921825,The Dark Knight,Christian Bale|Michael Caine|Heath Ledger|Aaron Eckhart|Gary Oldman,Christopher Nolan,152,Drama|Action|Crime|Thriller,2008-07-16,8432,8.1,2008,187365527,1014733032,827367505,8
2876,5.678119,180000000,521311860,341311860,WALLÂ·E,Ben Burtt|Elissa Knight|Jeff Garlin|Fred Willard|John Ratzenberger,Andrew Stanton,98,Animation|Family,2008-06-22,4209,7.6,2008,182301594,527977683,345676089,8
2877,4.977955,140000000,585174222,445174222,Iron Man,Robert Downey Jr.|Terrence Howard|Jeff Bridges|Gwyneth Paltrow|Leslie Bibb,Jon Favreau,126,Action|Science Fiction|Adventure,2008-04-30,6220,7.3,2008,141790128,592656630,450866502,7
2878,3.647612,25000000,226830568,201830568,Taken,Liam Neeson|Famke Janssen|Maggie Grace|Katie Cassidy|Holly Valance,Pierre Morel,93,Action|Thriller|Crime,2008-02-18,3075,7.2,2008,25319665,229730967,204411302,7
2879,3.16167,185000000,786636033,601636033,Indiana Jones and the Kingdom of the Crystal Skull,Harrison Ford|Cate Blanchett|Shia LaBeouf|Ray Winstone|Karen Allen,Steven Spielberg,122,Adventure|Action,2008-05-21,1537,5.6,2008,187365527,796694459,609328932,6
2880,3.107665,37000000,392616625,355616625,Twilight,Kristen Stewart|Robert Pattinson|Billy Burke|Taylor Lautner|Peter Facinelli,Catherine Hardwicke,122,Adventure|Fantasy|Drama|Romance,2008-11-20,2013,5.8,2008,37473105,397636870,360163765,6
2881,3.086676,200000000,586090727,386090727,Quantum of Solace,Daniel Craig|Olga Kurylenko|Mathieu Amalric|Judi Dench|Giancarlo Giannini,Marc Forster,106,Adventure|Action|Thriller|Crime,2008-10-30,2149,6.0,2008,202557326,593584854,391027528,6
2882,3.036644,130000000,631744560,501744560,Kung Fu Panda,Jack Black|Dustin Hoffman|Angelina Jolie|Jackie Chan|Lucy Liu,Mark Osborne|John Stevenson,90,Animation|Family,2008-06-04,1938,6.8,2008,131662262,639822446,508160184,7
2883,2.90047,19000000,18755936,-244064,Sex Drive,Josh Zuckerman|Amanda Crew|Clark Duke|James Marsden|Seth Green,Sean Anders,109,Comedy|Adventure|Romance,2008-10-16,167,5.9,2008,19242946,18995761,-247185,6
2884,2.543535,52000000,609841637,557841637,Mamma Mia!,Meryl Streep|Pierce Brosnan|Amanda Seyfried|Colin Firth|Stellan SkarsgÃ¥rd,Phyllida Lloyd,108,Comedy|Romance,2008-06-30,805,6.2,2008,52664904,617639458,564974554,6
2885,2.537342,150000000,333932083,183932083,The Curious Case of Benjamin Button,Cate Blanchett|Brad Pitt|Tilda Swinton|Julia Ormond|Elle Fanning,David Fincher,166,Fantasy|Drama|Thriller|Mystery|Romance,2008-11-24,1899,7.2,2008,151917995,338201950,186283955,7
2886,2.511394,145000000,401128639,256128639,The Mummy: Tomb of the Dragon Emperor,Brendan Fraser|Jet Li|John Hannah|Maria Bello|Luke Ford,Rob Cohen,112,Adventure|Fantasy|Action|Thriller,2008-07-01,826,5.1,2008,146854061,406257724,259403663,5
2887,2.349544,150000000,163712074,13712074,The Incredible Hulk,Edward Norton|Liv Tyler|Tim Roth|William Hurt|Tim Blake Nelson,Louis Leterrier,114,Science Fiction|Action|Adventure,2008-06-12,1868,6.1,2008,151917995,165805400,13887405,6
2888,2.245306,33000000,269958228,236958228,Gran Torino,Clint Eastwood|Christopher Carley|Bee Vang|Ahney Her|Brian Haley,Clint Eastwood,116,Drama,2008-12-09,1809,7.6,2008,33421958,273410085,239988127,8
2889,2.217084,150000000,603900354,453900354,Madagascar: Escape 2 Africa,Ben Stiller|Jada Pinkett Smith|David Schwimmer|Chris Rock|Cedric the Entertainer,Eric Darnell|Tom McGrath,89,Family|Animation,2008-10-30,1147,6.1,2008,151917995,611622206,459704211,6
2890,2.188028,85000000,160388063,75388063,Hellboy II: The Golden Army,Ron Perlman|Selma Blair|Jeffrey Tambor|Doug Jones|John Hurt,Guillermo del Toro,120,Adventure|Fantasy|Science Fiction,2008-07-11,927,6.4,2008,86086863,162438886,76352023,6
2891,2.017536,85000000,222231186,137231186,Jumper,Hayden Christensen|Jamie Bell|Samuel L. Jackson|Rachel Bilson|Michael Rooker,Doug Liman,88,Adventure|Fantasy|Science Fiction,2008-02-10,1082,5.9,2008,86086863,225072774,138985911,6
2892,1.996757,45000000,101702060,56702060,Journey to the Center of the Earth,Brendan Fraser|Josh Hutcherson|Anita Briem|Seth Meyers|Jean Michel ParÃ©,Eric Brevig,93,Action|Science Fiction|Adventure|Comedy|Family,2008-07-10,704,5.7,2008,45575398,103002486,57427088,6
2893,1.982998,75000000,258270008,183270008,Wanted,Angelina Jolie|James McAvoy|Morgan Freeman|Thomas Kretschmann|Terence Stamp,Timur Bekmambetov,110,Action|Thriller|Crime,2008-06-12,1670,6.3,2008,75958997,261572412,185613415,6
2895,1.929591,15000000,377910544,362910544,Slumdog Millionaire,Dev Patel|Freida Pinto|Anil Kapoor|Mia Drake Inderbitzin|Saurabh Shukla,Danny Boyle|Loveleen Tandan,120,Drama|Romance,2008-05-12,1547,7.5,2008,15191799,382742747,367550948,7
2896,1.886872,30000000,108979549,78979549,Transporter 3,Jason Statham|FranÃ§ois BerlÃ©and|Natalya Rudakova|Robert Knepper|David Atrakchi,Olivier Megaton,104,Action|Adventure|Thriller|Crime,2008-11-26,719,5.9,2008,30383599,110373030,79989431,6
2897,1.845165,75000000,200276000,125276000,Valkyrie,Tom Cruise|Carice van Houten|Kenneth Branagh|Bill Nighy|Terence Stamp,Bryan Singer,121,Drama|Thriller|History|War,2008-12-25,725,6.6,2008,75958997,202836855,126877858,7
2898,1.841839,105000000,266000000,161000000,"10,000 BC",Steven Strait|Camilla Belle|Cliff Curtis|Nathanael Baring|Mo Zinal,Roland Emmerich,109,Adventure|Action|Drama|Fantasy,2008-02-22,586,5.2,2008,106342596,269401244,163058648,5
2899,1.800286,150000000,624029371,474029371,Hancock,Will Smith|Charlize Theron|Jason Bateman|Jae Head|Eddie Marsan,Peter Berg,92,Fantasy|Action,2008-07-01,1764,6.0,2008,151917995,632008606,480090611,6
2900,1.742288,15000000,42000000,27000000,The Hurt Locker,Jeremy Renner|Anthony Mackie|Brian Geraghty|Guy Pearce|Ralph Fiennes,Kathryn Bigelow,131,Drama|Thriller|War,2008-10-10,1207,7.2,2008,15191799,42537038,27345239,7
2901,1.682909,35000000,170000000,135000000,What Happens in Vegas,Ashton Kutcher|Cameron Diaz|Lake Bell|Queen Latifah|Treat Williams,Tom Vaughan,99,Comedy|Romance,2008-05-07,573,5.8,2008,35447532,172173727,136726195,6
2902,1.628345,225000000,419651413,194651413,The Chronicles of Narnia: Prince Caspian,Ben Barnes|William Moseley|Anna Popplewell|Skandar Keynes|Georgie Henley,Andrew Adamson,150,Adventure|Family|Fantasy,2008-05-15,891,6.1,2008,227876992,425017341,197140349,6
2903,1.622426,92000000,188072649,96072649,Tropic Thunder,Ben Stiller|Robert Downey Jr.|Jack Black|Jay Baruchel|Brandon T. Jackson,Ben Stiller,107,Action|Comedy,2008-08-09,970,6.4,2008,93176370,190477465,97301095,6
2904,1.611632,80000000,178066569,98066569,Eagle Eye,Shia LaBeouf|Michelle Monaghan|Rosario Dawson|Michael Chiklis|Anthony Mackie,D.J. Caruso,118,Mystery|Thriller|Action,2008-09-25,645,6.2,2008,81022930,180343441,99320511,6
2905,1.61062,12500000,20416563,7916563,The Boy in the Striped Pyjamas,Vera Farmiga|David Thewlis|Rupert Friend|David Hayman|Asa Butterfield,Mark Herman,94,War|Drama,2008-05-07,746,7.6,2008,12659832,20677622,8017790,8
2906,1.605544,50000000,113244290,63244290,Rambo,Sylvester Stallone|Julie Benz|Matthew Marsden|Reynaldo Gallegos|Jake La Botz,Sylvester Stallone,92,Action|Thriller,2008-01-24,570,6.2,2008,50639331,114692303,64052972,6
2907,1.583079,45000000,73762516,28762516,Death Race,Jason Statham|Joan Allen|Ian McShane|Tyrese Gibson|Natalie Martinez,Paul W.S. Anderson,105,Action|Thriller|Science Fiction,2008-08-22,743,5.9,2008,45575398,74705690,29130292,6
2908,1.561177,23000000,150816700,127816700,Step Up 2: The Streets,Briana Evigan|Robert Hoffman|Will Kemp|Cassie Ventura|Adam G. Sevani,Jon M. Chu,98,Music|Drama|Romance,2008-02-14,369,6.4,2008,23294092,152745137,129451045,6
2909,1.559851,80000000,233093859,153093859,The Day the Earth Stood Still,Keanu Reeves|Jennifer Connelly|Kathy Bates|Jaden Smith|John Cleese,Scott Derrickson,103,Drama|Science Fiction|Thriller,2008-12-10,585,5.1,2008,81022930,236074344,155051414,5
2911,1.531599,55000000,168167691,113167691,Seven Pounds,Will Smith|Rosario Dawson|Sarah Jane Morris|Woody Harrelson|Michael Ealy,Gabriele Muccino,123,Drama,2008-12-18,1235,7.4,2008,55703264,170317989,114614725,7
2912,1.499784,25000000,170764026,145764026,Cloverfield,Lizzy Caplan|Jessica Lucas|Odette Annable|Michael Stahl-David|Mike Vogel,Matt Reeves,85,Action|Thriller|Science Fiction,2008-01-15,1373,6.4,2008,25319665,172947523,147627858,6
2913,1.480497,150000000,309979994,159979994,Bolt,John Travolta|Miley Cyrus|Susie Essman|Mark Walton|Malcolm McDowell,Chris Williams|Byron Howard,96,Animation|Family|Adventure|Comedy,2008-11-20,1119,6.3,2008,151917995,313943594,162025599,6
2914,1.475988,30000000,105173115,75173115,Forgetting Sarah Marshall,Jason Segel|Kristen Bell|Mila Kunis|Russell Brand|Bill Hader,Nicholas Stoller,111,Comedy|Romance|Drama,2008-04-17,750,6.3,2008,30383599,106517925,76134326,6
2915,1.468543,130000000,49554002,-80445998,Australia,Nicole Kidman|Hugh Jackman|Essie Davis|David Wenham|Bryan Brown,Baz Luhrmann,165,Drama,2008-11-18,411,6.3,2008,131662262,50187630,-81474632,6
2916,1.462377,70000000,225990978,155990978,Yes Man,Jim Carrey|Zooey Deschanel|Rhys Darby|Sasha Alexander|Fionnula Flanagan,Peyton Reed,104,Comedy|Romance,2008-12-09,1032,6.3,2008,70895064,228880641,157985577,6
2917,1.462242,60000000,244082376,184082376,Marley & Me,Owen Wilson|Jennifer Aniston|Eric Dane|Kathleen Turner|Alan Arkin,David Frankel,115,Comedy|Family,2008-12-25,820,6.8,2008,60767198,247203367,186436169,7
2918,1.446456,70000000,113280098,43280098,Body of Lies,Leonardo DiCaprio|Russell Crowe|Mark Strong|Ali Suliman|Simon McBurney,Ridley Scott,128,Action|Drama|Thriller,2008-10-10,530,6.5,2008,70895064,114728569,43833505,6
2919,1.435434,37000000,163720069,126720069,Burn After Reading,George Clooney|Frances McDormand|Tilda Swinton|Brad Pitt|Richard Jenkins,Ethan Coen|Joel Coen,96,Comedy|Drama,2008-09-05,738,6.3,2008,37473105,165813497,128340392,6
2920,1.400898,30000000,160259319,130259319,27 Dresses,Katherine Heigl|James Marsden|Malin Ã…kerman|Judy Greer|Edward Burns,Anne Fletcher,111,Comedy|Romance,2008-01-10,610,6.1,2008,30383599,162308496,131924897,6
2921,1.380024,60000000,57490374,-2509626,Inkheart,Brendan Fraser|Sienna Guillory|Andy Serkis|Eliza Bennett|Paul Bettany,Iain Softley,106,Adventure|Family|Fantasy,2008-12-11,302,5.8,2008,60767198,58225482,-2541716,6
2922,1.377239,35000000,69823199,34823199,21,Jim Sturgess|Kevin Spacey|Kate Bosworth|Aaron Yoo|Liza Lapira,Robert Luketic,123,Drama|Crime,2008-03-27,907,6.5,2008,35447532,70716002,35268470,6
2923,1.354387,20000000,64822796,44822796,The Bank Job,Jason Statham|Saffron Burrows|Stephen Campbell Moore|Daniel Mays|James Faulkner,Roger Donaldson,112,Thriller|Crime|Drama,2008-02-28,413,6.4,2008,20255732,65651661,45395929,6
2924,1.351237,65000000,128107642,63107642,Step Brothers,Will Ferrell|John C. Reilly|Mary Steenburgen|Richard Jenkins|Adam Scott,Adam McKay,98,Comedy,2008-07-25,678,6.6,2008,65831131,129745707,63914576,7
2926,1.34132,70000000,111231041,41231041,Fool's Gold,Matthew McConaughey|Kate Hudson|Donald Sutherland|Ewen Bremner|Alexis Dziena,Andy Tennant,112,Comedy,2008-02-07,281,5.3,2008,70895064,112653311,41758247,5
2927,1.300453,20000000,41627431,21627431,Never Back Down,Sean Faris|Amber Heard|Cam Gigandet|Djimon Hounsou|Evan Peters,Jeff Wadlow,115,Drama|Action,2008-03-04,276,6.5,2008,20255732,42159705,21903973,6
2928,1.273395,27000000,101624843,74624843,Pineapple Express,Seth Rogen|James Franco|Danny McBride|Gary Cole|Rosie Perez,David Gordon Green,111,Action|Comedy,2008-08-06,719,6.6,2008,27345239,102924282,75579043,7
2929,1.254928,6000000,44703995,38703995,The Wrestler,Mickey Rourke|Marisa Tomei|Evan Rachel Wood|Ajay Naidu|Judah Friedlander,Darren Aronofsky,109,Drama|Romance,2008-09-07,539,7.0,2008,6076719,45275608,39198889,7
2930,1.22837,80000000,212874442,132874442,Bedtime Stories,Adam Sandler|Keri Russell|Guy Pearce|Courteney Cox|Lucy Lawless,Adam Shankman,99,Fantasy|Comedy|Family|Romance,2008-12-24,599,5.8,2008,81022930,215596389,134573459,6
2931,1.210534,20500000,10089373,-10410627,Punisher: War Zone,Ray Stevenson|Dominic West|Julie Benz|Colin Salmon|Doug Hutchison,Lexi Alexander,102,Action|Crime,2008-12-05,147,5.5,2008,20762125,10218382,-10543743,5
2932,1.172718,35000000,85416905,50416905,Max Payne,Mark Wahlberg|Mila Kunis|Beau Bridges|Ludacris|Chris O'Donnell,John Moore,100,Action,2008-10-16,359,5.3,2008,35447532,86509099,51061567,5
2933,1.169851,35000000,72436439,37436439,Mirrors,Kiefer Sutherland|Paula Patton|Amy Smart|Cameron Boyce|Erica Gluck,Alexandre Aja,110,Horror|Thriller|Mystery,2008-08-15,238,6.0,2008,35447532,73362657,37915125,6
2934,1.14205499999999,40000000,151161491,111161491,Vantage Point,Dennis Quaid|Matthew Fox|Forest Whitaker|Sigourney Weaver|William Hurt,Pete Travis,90,Drama|Action|Thriller|Crime,2008-02-01,455,6.2,2008,40511465,153094337,112582872,6
2935,1.133017,24000000,42105111,18105111,Zack and Miri Make a Porno,Seth Rogen|Elizabeth Banks|Jennifer Schwalbach Smith|Jason Mewes|Gerry Bednob,Kevin Smith,102,Comedy,2008-09-18,439,6.0,2008,24306879,42643493,18336614,6
2936,1.121487,80000000,230685453,150685453,Get Smart,Steve Carell|Anne Hathaway|Dwayne Johnson|Alan Arkin|Terence Stamp,Peter Segal,110,Action|Comedy|Thriller,2008-06-19,637,5.9,2008,81022930,233635143,152612213,6
2937,1.103468,28000000,92380927,64380927,Role Models,Seann William Scott|Paul Rudd|Elizabeth Banks|Christopher Mintz-Plasse|Bobb'e J. Thompson,David Wain,99,Comedy,2008-02-03,328,6.3,2008,28358025,93562168,65204143,6
2942,1.064766,70000000,72108608,2108608,Babylon A.D.,Vin Diesel|Michelle Yeoh|MÃ©lanie Thierry|Lambert Wilson|Charlotte Rampling,Mathieu Kassovitz,101,Action|Adventure|Science Fiction|Thriller,2008-08-20,436,5.4,2008,70895064,73030634,2135570,5
2944,1.054819,15000000,32002538,17002538,In Bruges,Colin Farrell|Brendan Gleeson|Ralph Fiennes|ClÃ©mence PoÃ©sy|Thekla Reuten,Martin McDonagh,107,Comedy|Drama|Crime,2008-02-08,794,7.3,2008,15191799,32411742,17219943,7
2945,1.043504,55000000,113020255,58020255,Changeling,Angelina Jolie|Jeffrey Donovan|John Malkovich|Geoff Pierson|Amy Ryan,Clint Eastwood,141,Crime|Drama|Mystery,2008-01-30,642,7.1,2008,55703264,114465403,58762139,7
2946,1.019335,90000000,162839667,72839667,The Spiderwick Chronicles,Freddie Highmore|Mary-Louise Parker|Nick Nolte|Sarah Bolger|Andrew McCarthy,Mark Waters,95,Adventure|Family|Fantasy,2008-02-14,276,6.2,2008,91150797,164921838,73771041,6
2947,1.01377,12000000,43493123,31493123,Harold & Kumar Escape from Guantanamo Bay,John Cho|Kal Penn|Neil Patrick Harris|Rob Corddry|Jack Conley,Jon Hurwitz|Hayden Schlossberg,107,Comedy|Adventure,2008-04-25,317,6.0,2008,12153439,44049253,31895814,6
2953,0.95684,20000000,65569869,45569869,Street Kings,Keanu Reeves|Forest Whitaker|Chris Evans|Hugh Laurie|Martha Higareda,David Ayer,109,Action|Crime|Drama|Thriller,2008-04-10,173,6.2,2008,20255732,66408286,46152554,6
2954,0.951793,9000000,32973937,23973937,Nick and Norah's Infinite Playlist,Michael Cera|Kat Dennings|Aaron Yoo|Alexis Dziena|Ari Graynor,Peter Sollett,89,Comedy|Drama|Music|Romance,2008-10-03,213,6.4,2008,9115079,33395562,24280483,6
2955,0.943042,80000000,163733697,83733697,Four Christmases,Reese Witherspoon|Vince Vaughn|Robert Duvall|Mary Steenburgen|Dwight Yoakam,Seth Gordon,88,Comedy|Romance|Drama,2008-11-26,221,5.3,2008,81022930,165827299,84804369,5
2957,0.938555,7000000,8900000,1900000,Stargate: The Ark of Truth,Ben Browder|Amanda Tapping|Christopher Judge|Michael Shanks|Beau Bridges,Robert C. Cooper,97,Adventure|Science Fiction,2008-03-11,106,6.8,2008,7089506,9013801,1924295,7
2958,0.931752,25000000,70442940,45442940,The House Bunny,Anna Faris|Emma Stone|Kat Dennings|Katharine McPhee|Rumer Willis,Fred Wolf,97,Romance|Comedy,2008-08-22,299,5.6,2008,25319665,71343668,46024003,6
2960,0.900342,8500000,68282844,59782844,Star Wars: The Clone Wars,Matt Lanter|Ashley Eckstein|James Arnold Taylor|Tom Kane|Dee Bradley Baker,Dave Filoni,98,Thriller|Animation|Action|Science Fiction|Adventure,2008-08-05,261,6.0,2008,8608686,69155951,60547265,6
2961,0.892309,10800000,113857533,103057533,Saw V,Tobin Bell|Costas Mandylor|Scott Patterson|Betsy Russell|Mark Rolston,David Hackl,92,Horror|Thriller|Crime,2008-10-23,437,5.9,2008,10938095,115313387,104375292,6
2962,0.885215,62000000,41819064,-20180936,The Love Guru,Mike Myers|Jessica Alba|Justin Timberlake|Romany Malco|Meagan Good,Marco Schnabel,87,Comedy|Romance,2008-06-20,144,4.5,2008,62792771,42353789,-20438982,4
2963,0.879116,120000000,93945766,-26054234,Speed Racer,Emile Hirsch|Christina Ricci|Matthew Fox|Susan Sarandon|Scott Porter,Lana Wachowski|Lilly Wachowski,135,Family|Action|Science Fiction,2008-05-09,194,5.6,2008,121534396,95147016,-26387380,6
2964,0.866771,15000000,96408652,81408652,Vicky Cristina Barcelona,Scarlett Johansson|Rebecca Hall|Javier Bardem|PenÃ©lope Cruz|Christopher Evan Welch,Woody Allen,96,Drama|Romance,2008-08-15,563,6.7,2008,15191799,97641394,82449595,7
2965,0.865104999999999,85000000,297138014,212138014,Horton Hears a Who!,Jim Carrey|Steve Carell|Carol Burnett|Seth Rogen|Will Arnett,Jimmy Hayward|Steve Martino,88,Animation|Comedy|Family|Adventure|Fantasy,2008-03-03,558,6.2,2008,86086863,300937408,214850545,6
2968,0.826564,55000000,127906624,72906624,The Forbidden Kingdom,Jackie Chan|Jet Li|Michael Angarano|Li Bingbing|Collin Chou,Rob Minkoff,104,Action|Adventure|Fantasy,2008-04-18,243,6.2,2008,55703264,129542119,73838855,6
2971,0.822759,60000000,73174566,13174566,Righteous Kill,Robert De Niro|Carla Gugino|50 Cent|Al Pacino|Donnie Wahlberg,Jon Avnet,101,Action|Adventure|Crime|Drama|Thriller,2008-09-11,195,5.8,2008,60767198,74110222,13343024,6
2972,0.802785,15000000,5926410,-9073590,Transsiberian,Woody Harrelson|Emily Mortimer|Kate Mara|Eduardo Noriega|Thomas Kretschmann,Brad Anderson,111,Thriller|Crime|Mystery,2008-01-18,71,6.3,2008,15191799,6002188,-9189611,6
2973,0.798582,22000000,23530831,1530831,Traitor,Don Cheadle|Guy Pearce|Neal McDonough|SaÃ¯d Taghmaoui|Alyy Khan,Jeffrey Nachmanoff,114,Drama|Action|Thriller|Crime,2008-08-23,98,6.2,2008,22281305,23831711,1550406,6
2974,0.787623,90000000,201596308,111596308,You Don't Mess With the Zohan,Adam Sandler|John Turturro|Emmanuelle Chriqui|Nick Swardson|Lainie Kazan,Dennis Dugan,113,Comedy|Action,2008-06-05,606,5.6,2008,91150797,204174046,113023249,6
2975,0.785951,32000000,51155219,19155219,Defiance,Daniel Craig|Liev Schreiber|Jamie Bell|Alexa Davalos|Allan Corduner,Edward Zwick,137,Action|Drama|History|War,2008-12-31,344,6.6,2008,32409172,51809322,19400150,7
2977,0.774511,35000000,32483410,-2516590,Untraceable,Diane Lane|Billy Burke|Colin Hanks|Joseph Cross|Mary Beth Hurt,Gregory Hoblit,101,Drama,2008-01-22,119,5.8,2008,35447532,32898763,-2548769,6
2980,0.764367,9000000,82391145,73391145,The Strangers,Liv Tyler|Scott Speedman|Alex Fisher|Peter Clayton-Luce|Gemma Ward,Bryan Bertino,90,Thriller|Horror|Mystery,2008-05-29,241,5.9,2008,9115079,83444650,74329571,6
2982,0.759672999999999,20000000,54586584,34586584,Milk,Sean Penn|Emile Hirsch|James Franco|Josh Brolin|Diego Luna,Gus Van Sant,128,History|Drama,2008-11-26,325,7.1,2008,20255732,55284562,35028830,7
2983,0.749838,50000000,7033683,-42966317,Outlander,Jim Caviezel|Sophia Myles|Jack Huston|Ron Perlman|John Hurt,Howard McCain,115,Fantasy|Action|Science Fiction,2008-04-24,167,6.0,2008,50639331,7123620,-43515711,6
2984,0.748854,30000000,68369434,38369434,The X Files: I Want to Believe,David Duchovny|Gillian Anderson|Amanda Peet|Billy Connolly|Xzibit,Chris Carter,104,Drama|Mystery|Science Fiction|Thriller,2008-07-24,312,5.4,2008,30383599,69243648,38860049,5
2985,0.743689,20000000,50907234,30907234,Doubt,Amy Adams|Philip Seymour Hoffman|Meryl Streep|Viola Davis|Alice Drummond,John Patrick Shanley,104,Drama|Mystery,2008-11-27,197,6.7,2008,20255732,51558166,31302434,7
2988,0.721663,55000000,17869048,-37130952,City of Ember,Saoirse Ronan|Harry Treadaway|Mary Kay Place|Bill Murray|Martin Landau,Gil Kenan,90,Adventure|Family|Fantasy,2008-10-07,358,6.1,2008,55703264,18097532,-37605732,6
2989,0.720175,40000000,84601681,44601681,Made of Honor,Patrick Dempsey|Michelle Monaghan|Kevin McKidd|Chris Messina|Richmond Arquette,Paul Weiland,101,Comedy|Romance,2008-05-02,240,5.8,2008,40511465,85683451,45171986,6
2992,0.715969,25000000,17741298,-7258702,Deception,Hugh Jackman|Ewan McGregor|Michelle Williams|Bruce Altman|Andrew Ginsburg,Marcel Langenegger,107,Drama|Thriller|Crime|Mystery,2008-04-24,107,5.8,2008,25319665,17968149,-7351516,6
2993,0.714882,18000000,25739015,7739015,RockNRolla,Mark Strong|Tom Wilkinson|Toby Kebbell|Gerard Butler|Tom Hardy,Guy Ritchie,114,Action|Crime|Thriller,2008-09-04,508,6.8,2008,18230159,26068130,7837971,7
2994,0.709809,12000000,56309766,44309766,The Eye,Jessica Alba|Alessandro Nivola|Parker Posey|Rade Serbedzija|Fernanda Romero,David Moreau|Xavier Palud,98,Drama|Horror|Thriller,2008-02-01,171,5.6,2008,12153439,57029778,44876339,6
2995,0.702302,13000000,14894347,1894347,Elegy,PenÃ©lope Cruz|Ben Kingsley|Patricia Clarkson|Peter Sarsgaard|Dennis Hopper,Isabel Coixet,112,Drama|Romance,2008-08-08,37,6.3,2008,13166226,15084795,1918569,6
2996,0.696406,45000000,42487390,-2512610,Bangkok Dangerous,Nicolas Cage|Shahkrit Yamnarm|Charlie Yeung|Panward Hemmanee|Nirattisai Kaljaruek,Oxide Pang Chun|Danny Pang,99,Action|Crime|Thriller,2008-08-21,231,5.0,2008,45575398,43030660,-2544738,5
2997,0.68675,30000000,84646831,54646831,Meet the Spartans,Sean Maguire|Carmen Electra|Ken Davitian|Kevin Sorbo|Diedrich Bader,Jason Friedberg|Aaron Seltzer,84,Comedy,2008-01-24,182,4.0,2008,30383599,85729179,55345580,4
2998,0.68078,25000000,11207130,-13792870,Stop-Loss,Ryan Phillippe|Abbie Cornish|Joseph Gordon-Levitt|Channing Tatum|Josef Sommer,Kimberly Peirce,113,Drama|War,2008-03-28,37,6.1,2008,25319665,11350431,-13969234,6
3002,0.666414,25000000,19844979,-5155021,Blindness,Mark Ruffalo|Julianne Moore|Gael GarcÃ­a Bernal|Danny Glover|Alice Braga,Fernando Meirelles,121,Drama|Mystery|Science Fiction|Thriller,2008-05-14,187,6.3,2008,25319665,20098729,-5220936,6
3003,0.66173,60000000,39031337,-20968663,The Spirit,Gabriel Macht|Scarlett Johansson|Samuel L. Jackson|Eva Mendes|Paz Vega,Frank Miller,103,Action|Comedy|Thriller|Crime|Science Fiction,2008-12-25,205,4.6,2008,60767198,39530416,-21236782,5
3005,0.651467,11500000,186702,-11313298,Nothing But the Truth,Kate Beckinsale|Matt Dillon|Angela Bassett|Alan Alda|Preston Bailey,Rod Lurie,108,Drama|Thriller,2008-12-19,58,6.1,2008,11647046,189089,-11457957,6
3007,0.646243999999999,20000000,20211394,211394,Appaloosa,Viggo Mortensen|Ed Harris|RenÃ©e Zellweger|Jeremy Irons|Timothy Spall,Ed Harris,115,Drama|Western|Crime,2008-09-26,154,6.2,2008,20255732,20469829,214097,6
3008,0.645064,18000000,382174,-17617826,The Informers,Billy Bob Thornton|Kim Basinger|Mickey Rourke|Winona Ryder|Jon Foster,Gregor Jordan,98,Action|Adventure|Crime|Drama|Thriller,2008-11-05,29,4.3,2008,18230159,387060,-17843099,4
3009,0.642656,60000000,163403799,103403799,The Happening,Mark Wahlberg|Zooey Deschanel|John Leguizamo|Spencer Breslin|Betty Buckley,M. Night Shyamalan,91,Thriller|Science Fiction,2008-06-11,490,4.8,2008,60767198,165493183,104725985,5
3010,0.634961,30000000,22211426,-7788574,Doomsday,Rhona Mitra|Bob Hoskins|Malcolm McDowell|Alexander Siddig|David O'Hara,Neil Marshall,105,Action|Thriller|Science Fiction,2008-03-14,162,5.8,2008,30383599,22495435,-7888164,6
3011,0.634256,12000000,7070330,-4929670,The Secret of Moonacre,Ioan Gruffudd|Dakota Blue Richards|Tim Curry|Augustus Prew|Natascha McElhone,GÃ¡bor CsupÃ³,103,Adventure|Fantasy|Drama|Science Fiction|Romance,2008-09-06,52,5.7,2008,12153439,7160735,-4992704,6
3014,0.630893,2000000,11125849,9125849,Vals Im Bashir,Ari Folman|Ron Ben-Yishai|Dror Harazi|Ronny Dayag,Ari Folman,90,Drama|Animation|War,2008-06-04,168,7.7,2008,2025573,11268111,9242538,8
3017,0.620489,65000000,415252786,350252786,Sex and the City,Sarah Jessica Parker|Kim Cattrall|Cynthia Nixon|Kristin Davis|Chris Noth,Michael Patrick King,145,Comedy|Drama|Romance,2008-05-12,309,6.1,2008,65831131,420562471,354731340,6
3018,0.615524,15000000,8762890,-6237110,The Rocker,Rainn Wilson|Josh Gad|Christina Applegate|Emma Stone|Teddy Geiger,Peter Cattaneo,102,Comedy|Music,2008-08-20,78,5.4,2008,15191799,8874937,-6316862,5
3020,0.6067,60000000,50877145,-9122855,The Tale of Despereaux,Matthew Broderick|Dustin Hoffman|Emma Watson|Tracey Ullman|Kevin Kline,Robert Stevenhagen|Sam Fell,100,Animation|Comedy|Family,2008-10-29,174,5.7,2008,60767198,51527692,-9239506,6
3023,0.598695,35000000,25871834,-9128166,Superhero Movie,Drake Bell|Sara Paxton|Leslie Nielsen|Christopher McDonald|Jeffrey Tambor,Craig Mazin,85,Action|Comedy|Science Fiction,2008-03-27,170,4.9,2008,35447532,26202647,-9244885,5
3024,0.595488,11000000,38105395,27105395,The Secret Life of Bees,Dakota Fanning|Queen Latifah|Jennifer Hudson|Sophie Okonedo|Alicia Keys,Gina Prince-Bythewood,114,Adventure|Drama,2008-09-17,80,7.2,2008,11140652,38592634,27451982,7
3026,0.593722,15000000,1143856,-13856144,The Other Man,Romola Garai|Antonio Banderas|Laura Linney|Liam Neeson|Abigail Canton,Richard Eyre,90,Drama|Thriller|Mystery|Romance,2008-12-25,25,5.1,2008,15191799,1158482,-14033317,5
3027,0.589940999999999,20000000,149281606,129281606,Beverly Hills Chihuahua,Drew Barrymore|Piper Perabo|Andy GarcÃ­a|George Lopez|Paul RodrÃ­guez,Raja Gosnell,91,Adventure|Comedy|Family,2008-10-03,118,5.1,2008,20255732,151190415,130934683,5
3029,0.579469999999999,35000000,75225693,40225693,Revolutionary Road,Leonardo DiCaprio|Kate Winslet|Michael Shannon|David Harbour|Kathryn Hahn,Sam Mendes,119,Drama|Romance,2008-12-19,430,6.5,2008,35447532,76187576,40740044,6
3031,0.576989,5000000,16174377,11174377,Sunshine Cleaning,Amy Adams|Emily Blunt|Alan Arkin|Mary Lynn Rajskub|Eric Christian Olsen,Christine Jeffs,102,Comedy|Drama,2008-01-18,111,6.2,2008,5063933,16381192,11317259,6
3042,0.531905,8500000,8936663,436663,Ong Bak 2,Tony Jaa|Sarunyu Wongkrachang|à¸ªà¸£à¸žà¸‡à¸©à¹Œ à¸Šà¸²à¸•à¸£à¸µ|Primorata Dejudom,Tony Jaa|Panna Rittikrai,98,Adventure|Action|Thriller,2008-12-04,88,6.2,2008,8608686,9050932,442246,6
3044,0.527397999999999,30000000,31148328,1148328,Pride and Glory,Edward Norton|Jon Voight|Colin Farrell|Noah Emmerich|Jennifer Ehle,Gavin O'Connor,130,Thriller|Crime|Drama,2008-09-09,118,6.3,2008,30383599,31546610,1163011,6
3047,0.518011,6000000,69497,-5930503,"Surfer, Dude",Matthew McConaughey|Jeffrey Nordling|Willie Nelson|Woody Harrelson|Zachary Knighton,S.R. Bindler,85,Comedy,2008-09-05,13,5.0,2008,6076719,70385,-6006334,5
3048,0.517412,30000000,63833449,33833449,Baby Mama,Tina Fey|Amy Poehler|Dax Shepard|Sigourney Weaver|Greg Kinnear,Michael McCullers,99,Comedy,2008-04-23,130,5.8,2008,30383599,64649663,34266064,6
3050,0.513438,7000000,6230276,-769724,College,Drake Bell|Andrew Caldwell|Andree Moss|Carolyn Moss|Wendy Talley,Deb Hagan,94,Comedy,2008-08-28,16,4.8,2008,7089506,6309940,-779566,5
3053,0.505290999999999,20000000,13204291,-6795709,Brideshead Revisited,Matthew Goode|Ben Whishaw|Hayley Atwell|Emma Thompson|Michael Gambon,Julian Jarrold,133,Drama|Romance,2008-07-25,30,6.0,2008,20255732,13373129,-6882603,6
3056,0.499165,20000000,5530764,-14469236,The Brothers Bloom,Rachel Weisz|Adrien Brody|Mark Ruffalo|Rinko Kikuchi|Robbie Coltrane,Rian Johnson,114,Adventure|Comedy|Drama|Romance,2008-09-09,110,6.8,2008,20255732,5601483,-14654249,7
3057,0.498026,60000000,50650079,-9349921,Meet Dave,Eddie Murphy|Elizabeth Banks|Gabrielle Union|Scott Caan|Ed Helms,Brian Robbins,90,Comedy|Science Fiction|Adventure|Family,2008-07-08,205,5.1,2008,60767198,51297723,-9469475,5
3059,0.481188,12000000,40855419,28855419,Quarantine,Jennifer Carpenter|Steve Harris|Jay Hernandez|Johnathon Schaech|Columbus Short,John Erick Dowdle,89,Horror|Science Fiction|Thriller,2008-10-10,165,5.3,2008,12153439,41377822,29224383,5
3061,0.480116,3500000,5231128,1731128,Justice League: The New Frontier,David Boreanaz|Neil Patrick Harris|Brooke Shields|Jeremy Sisto|Kyle MacLachlan,Dave Bullock,75,Action|Adventure|Animation|Science Fiction,2008-02-26,66,6.3,2008,3544753,5298016,1753263,6
3075,0.45518,12000000,3148182,-8851818,Two Lovers,Joaquin Phoenix|Gwyneth Paltrow|Isabella Rossellini|Vinessa Shaw|Moni Moshonov,James Gray,110,Drama|Romance,2008-11-19,76,6.5,2008,12153439,3188436,-8965003,6
3076,0.453602,25000000,2000000,-23000000,Passengers,Anne Hathaway|Patrick Wilson|Andre Braugher|Dianne Wiest|David Morse,Rodrigo GarcÃ­a,93,Drama|Mystery|Thriller|Romance,2008-09-26,111,5.5,2008,25319665,2025573,-23294092,5
3077,0.451304,27000000,44352417,17352417,The Sisterhood of the Traveling Pants 2,Alexis Bledel|Amber Tamblyn|America Ferrera|Blake Lively|Rachel Nichols,Sanaa Hamri,117,Adventure|Comedy|Drama|Family,2008-08-06,127,6.0,2008,27345239,44919535,17574296,6
3078,0.450911,40000000,9793496,-30206504,The Express,Rob Brown|Dennis Quaid|Darrin Henson|Charles S. Dutton|Aunjanue Ellis,Gary Fleder,130,Drama,2008-10-10,39,7.1,2008,40511465,9918721,-30592744,7
3080,0.436441,3500000,1115493,-2384507,Surveillance,Julia Ormond|Bill Pullman|Pell James|Caroline Aaron|Hugh Dillon,Jennifer Chambers Lynch,97,Thriller,2008-02-08,35,6.0,2008,3544753,1129756,-2414997,6
3081,0.436406,16000000,50007546,34007546,The Women,Cloris Leachman|India Ennenga|Annette Bening|Eva Mendes|Debra Messing,Diane English,114,Comedy|Drama|Romance,2008-09-12,60,4.6,2008,16204586,50646974,34442388,5
3082,0.432911,10000000,22896728,12896728,Gong fu guan lan,Jay Chou|Charlene Choi|Eric Tsang|Wang Gang|Chen Bolin,Chu Yen-ping,100,Action|Adventure|Comedy,2008-02-07,32,5.1,2008,10127866,23189500,13061634,5
3085,0.427022999999999,2000000,38135878,36135878,ÐÐ´Ð¼Ð¸Ñ€Ð°Ð»ÑŠ,Konstantin Khabenskiy|Elizaveta Boyarskaya|Sergei Bezrukov|Anna Kovalchuk|Egor Beroev,Andrey Kravchuk,123,Action|Drama|History|War,2008-06-06,28,6.7,2008,2025573,38623507,36597934,7
3089,0.421518,37000000,63800345,26800345,Space Chimps,Andy Samberg|Cheryl Hines|Jeff Daniels|Stanley Tucci|Patrick Warburton,Kirk De Micco,81,Animation|Family,2008-07-17,60,5.1,2008,37473105,64616136,27143031,5
3091,0.417779,20000000,27640028,7640028,Lakeview Terrace,Samuel L. Jackson|Patrick Wilson|Kerry Washington|Ron Glass|Justin Chambers,Neil LaBute,110,Drama|Crime|Thriller,2008-09-19,147,5.8,2008,20255732,27993450,7737718,6
3110,0.389554,8376800,13000000,4623200,Jodhaa Akbar,Hrithik Roshan|Aishwarya Rai Bachchan|Sonu Sood|Kulbhushan Kharbanda|Rajesh Vivek,Ashutosh Gowariker,213,Action|Adventure|Drama|Foreign|History,2008-02-15,48,7.8,2008,8483911,13166226,4682315,8
3114,0.382852,3000000,3830137,830137,Choke,Anjelica Huston|Kelly Macdonald|Sam Rockwell|Clark Gregg|Brad William Henke,Clark Gregg,92,Comedy|Drama,2008-09-26,54,6.1,2008,3038359,3879111,840752,6
3116,0.374034,5000000,1296184,-3703816,"War, Inc.",John Cusack|Hilary Duff|Marisa Tomei|Joan Cusack|Dan Aykroyd,Joshua Seftel,106,Action|Adventure|Comedy|Thriller,2008-04-28,41,5.5,2008,5063933,1312757,-3751176,5
3117,0.371517,6000000,2899975,-3100025,The Wackness,Ben Kingsley|Famke Janssen|Josh Peck|Olivia Thirlby|Mary-Kate Olsen,Jonathan Levine,99,Drama,2008-07-03,40,6.3,2008,6076719,2937055,-3139664,6
3118,0.368391,25000000,6673422,-18326578,What Just Happened,Bruce Willis|Robert De Niro|Sean Penn|Robin Wright|Stanley Tucci,Barry Levinson,104,Comedy|Drama,2008-10-17,68,5.1,2008,25319665,6758752,-18560913,5
3133,0.345926,11500000,69564,-11430436,Assassination of a High School President,Mischa Barton|Reece Thompson|Bruce Willis|Michael Rapaport|Kathryn Morris,Brett Simon,93,Comedy|Crime|Mystery|Thriller,2008-01-17,53,6.2,2008,11647046,70453,-11576593,6
3134,0.812489,25000000,14109284,-10890716,Disaster Movie,Matt Lanter|Vanessa Lachey|Nicole Ari Parker|Crista Flanagan|Gary 'G. Thang' Johnson,Jason Friedberg|Aaron Seltzer,87,Action|Comedy,2008-08-29,130,3.3,2008,25319665,14289694,-11029971,3
3137,0.359217,45000000,9323833,-35676167,Miracle at St. Anna,Derek Luke|Michael Ealy|Laz Alonso|John Turturro|Valentina Cervi,Spike Lee,160,Thriller|Drama|Action|Crime|War,2008-09-15,51,6.3,2008,45575398,9443053,-36132345,6
3143,0.335116,20000000,36620508,16620508,My Best Friend's Girl,Dane Cook|Kate Hudson|Alec Baldwin|Jason Biggs|Diora Baird,Howard Deutch,101,Comedy,2008-09-19,127,5.3,2008,20255732,37088761,16833029,5
3144,0.333395,19000000,23550000,4550000,Paris,Juliette Binoche|Romain Duris|Fabrice Luchini|Albert Dupontel|FranÃ§ois Cluzet,CÃ©dric Klapisch,130,Drama,2008-01-19,48,6.3,2008,19242946,23851125,4608179,6
3147,0.326352,15000000,3533227,-11466773,The Midnight Meat Train,Bradley Cooper|Vinnie Jones|Brooke Shields|Leslie Bibb|Roger Bart,RyÃ»hei Kitamura,98,Mystery|Drama|Crime|Thriller|Horror,2008-08-07,130,5.7,2008,15191799,3578405,-11613394,6
3149,0.32288,8000000,2033165,-5966835,Mutant Chronicles,Ron Perlman|Thomas Jane|Devon Aoki|Sean Pertwee|Benno FÃ¼rmann,Simon Hunter,111,Action|Adventure|Horror|Science Fiction,2008-08-07,61,5.1,2008,8102293,2059162,-6043131,5
3158,0.308655,21000000,17600000,-3400000,Swing Vote,Kevin Costner|Madeline Carroll|Paula Patton|Kelsey Grammer|Dennis Hopper,Joshua Michael Stern,120,Drama|Comedy,2008-08-01,34,5.7,2008,21268519,17825044,-3443475,6
3176,0.282905,25100000,29506464,4406464,W.,Josh Brolin|Elizabeth Banks|Ellen Burstyn|Ioan Gruffudd|Thandie Newton,Oliver Stone,131,Drama|History,2008-10-17,71,5.6,2008,25420944,29883752,4462808,6
3180,0.280555,500000,33456317,32956317,Fireproof,Kirk Cameron|Erin Bethea|Ken Bevel|Stephen Dervan|Eric Young,Alex Kendrick,122,Drama,2008-09-26,54,7.5,2008,506393,33884110,33377717,7
3183,0.278543,7000000,10569964,3569964,Smart People,Dennis Quaid|Sarah Jessica Parker|Ellen Page|Thomas Haden Church|Ashton Holmes,Noam Murro,95,Comedy|Drama|Romance,2008-04-11,34,5.5,2008,7089506,10705118,3615612,5
3193,0.768409,37000000,100076342,63076342,Nim's Island,Abigail Breslin|Jodie Foster|Gerard Butler|Michael Carman|Mark Brady,Jennifer Flackett|Mark Levin,96,Adventure|Comedy|Family|Fantasy,2008-04-03,183,5.5,2008,37473105,101355981,63882876,5
3198,0.259988,25000000,30000000,5000000,Igor,John Cusack|Myleene Klass|Robin Walsh|Matt McKenna|John Cleese,Anthony Leondis,87,Animation|Comedy|Family|Fantasy,2008-09-19,89,5.4,2008,25319665,30383599,5063934,5
3206,0.659884,27000000,17286299,-9713701,How to Lose Friends & Alienate People,Kelan Pannell|Janette Scott|Simon Pegg|Megan Fox|Gillian Anderson,Robert B. Weide,110,Comedy|Romance|Drama,2008-10-02,106,6.0,2008,27345239,17507332,-9837907,6
3215,0.239048,4000000,530048,-3469952,Oorlogswinter,Martijn Lakemeier|Melody Klaver|Yorick van Wageningen|Jamie Campbell Bower|Raymond Thiry,Martin Koolhoven,103,Drama|History|War,2008-11-17,41,6.8,2008,4051146,536825,-3514321,7
3217,0.234772,6000000,391410,-5608590,While She Was Out,Kim Basinger|Lukas Haas|Craig Sheffer|Luke Gair|Leonard Wu,Susan Montford,108,Action|Adventure|Drama|Horror|Thriller,2008-10-27,18,4.7,2008,6076719,396414,-5680305,5
3225,0.224471,35000000,43650785,8650785,Welcome Home Roscoe Jenkins,Martin Lawrence|James Earl Jones|Margaret Avery|Joy Bryant|Cedric the Entertainer,Malcolm D. Lee,114,Comedy|Drama,2008-02-08,31,6.1,2008,35447532,44208931,8761399,6
3235,0.21503,9100000,76000000,66900000,Ghajini,Aamir Khan|Asin Thottumkal|Jiah Khan|Pradeep Ram Singh Rawat,A.R. Murugadoss,183,Action|Drama|Foreign|Mystery|Thriller,2008-12-25,53,6.9,2008,9216358,76971784,67755426,7
3239,0.352054,200000,3,-199997,Dr. Horrible's Sing-Along Blog,Neil Patrick Harris|Nathan Fillion|Felicia Day|Simon Helberg|Nick Towne,Joss Whedon,42,Adventure|Action|Comedy|Science Fiction|Music,2008-07-15,140,7.7,2008,202557,3,-202554,8
3243,0.193779,2300000,11100000,8800000,Jaane Tu... Ya Jaane Na,Imran Khan|Genelia D'Souza|Manjari Phadnis|Prateik Babbar|Sugandha Garg,Abbas Tyrewala,155,Drama|Comedy|Romance,2008-07-04,18,6.4,2008,2329409,11241931,8912522,6
3257,0.168979,5000000,4040588,-959412,Bottle Shock,Alan Rickman|Chris Pine|Bill Pullman|Rachael Taylor|Freddy RodrÃ­guez,Randall Miller,110,Comedy|Drama,2008-08-06,31,6.4,2008,5063933,4092253,-971680,6
3272,0.281186,6000000,1300000,-4700000,Julia,Tilda Swinton|Kate del Castillo|Aidan Gould|Bruno Bichir|Horacio Garcia Rojas,Erick Zonca,138,Drama,2008-02-09,10,7.1,2008,6076719,1316622,-4760097,7
3291,0.086287,2500000,107559,-2392441,Sleep Dealer,Leonor Varela|Jacob Vargas|Luis Fernando PeÃ±a,Alex Rivera,90,Drama|Science Fiction|Thriller,2008-12-10,18,5.8,2008,2531966,108934,-2423032,6
3296,0.127309999999999,15000000,317000,-14683000,The Yellow Handkerchief,William Hurt|Maria Bello|Kristen Stewart|Eddie Redmayne|Veronica Russell,Udayan Prasad,102,Drama|Romance,2008-12-17,30,6.6,2008,15191799,321053,-14870746,7
3311,0.101795,11000000,15500000,4500000,It's Alive,Bijou Phillips|James Murray|RaphaÃ«l Coleman|Owen Teale|Ty Glaser,Josef Rusnak,80,Horror,2008-08-15,11,4.2,2008,11140652,15698192,4557540,4
3340,0.021371,3500000,7700000,4200000,Expelled: No Intelligence Allowed,Ben Stein|Richard Dawkins|William Dembski|Paul Zachary Myers,Nathan Frankowski,90,Documentary,2008-04-18,12,4.5,2008,3544753,7798457,4253704,4
3372,7.95922799999999,140000000,370569774,230569774,Captain America: The First Avenger,Chris Evans|Hugo Weaving|Tommy Lee Jones|Hayley Atwell|Sebastian Stan,Joe Johnston,124,Action|Adventure|Science Fiction,2011-07-22,5025,6.5,2011,135715725,359229613,223513888,6
3373,5.903353,15000000,76175166,61175166,Drive,Ryan Gosling|Carey Mulligan|Christina Hendricks|Albert Brooks|Bryan Cranston,Nicolas Winding Refn,100,Drama|Action|Thriller|Crime,2011-01-10,2347,7.3,2011,14540970,73844056,59303086,7
3374,5.711315,125000000,1327817822,1202817822,Harry Potter and the Deathly Hallows: Part 2,Daniel Radcliffe|Rupert Grint|Emma Watson|Alan Rickman|Maggie Smith,David Yates,130,Adventure|Family|Fantasy,2011-07-07,3750,7.7,2011,121174755,1287183997,1166009242,8
3375,4.95513,380000000,1021683000,641683000,Pirates of the Caribbean: On Stranger Tides,Johnny Depp|PenÃ©lope Cruz|Geoffrey Rush|Ian McShane|Kevin McNally,Rob Marshall,136,Adventure|Action|Fantasy,2011-05-11,3180,6.3,2011,368371256,990417500,622046244,6
3376,4.50453,93000000,482860185,389860185,Rise of the Planet of the Apes,Andy Serkis|Karin Konoval|Freida Pinto|James Franco|John Lithgow,Rupert Wyatt,105,Thriller|Action|Drama|Science Fiction,2011-08-03,2578,6.9,2011,90154017,468083718,377929701,7
3377,4.12352,150000000,444115007,294115007,Thor,Chris Hemsworth|Natalie Portman|Tom Hiddleston|Anthony Hopkins|Stellan SkarsgÃ¥rd,Kenneth Branagh,115,Adventure|Fantasy|Action,2011-04-21,4485,6.5,2011,145409706,430524218,285114512,6
3378,3.596188,40000000,173930596,133930596,In Time,Justin Timberlake|Amanda Seyfried|Cillian Murphy|Olivia Wilde|Alex Pettyfer,Andrew Niccol,109,Action|Thriller|Science Fiction,2011-10-27,2068,6.6,2011,38775921,168607979,129832058,7
3379,3.355611,50000000,28931401,-21068599,Drive Angry,Nicolas Cage|Amber Heard|William Fichtner|Billy Burke|David Morse,Patrick Lussier,105,Fantasy|Thriller|Action|Crime,2011-02-24,378,5.3,2011,48469902,28046043,-20423859,5
3380,3.186679,40000000,51070807,11070807,The Mechanic,Jason Statham|Ben Foster|Donald Sutherland|Mini Anden|Tony Goldwyn,Simon West,93,Action|Thriller|Crime,2011-01-13,678,6.3,2011,38775921,49507940,10732019,6
3381,2.994474,32000000,147332697,115332697,Source Code,Jake Gyllenhaal|Michelle Monaghan|Vera Farmiga|Russell Peters|Michael Arden,Duncan Jones,93,Thriller|Science Fiction|Mystery,2011-03-30,1668,7.0,2011,31020737,142824028,111803291,7
3382,2.95274,145000000,694713380,549713380,Mission: Impossible - Ghost Protocol,Tom Cruise|Jeremy Renner|Simon Pegg|Paula Patton|Anil Kapoor,Brad Bird,133,Action|Thriller|Adventure,2011-12-07,3036,6.7,2011,140562716,673453790,532891074,7
3383,2.924415,50000000,142851197,92851197,"Crazy, Stupid, Love.",Steve Carell|Julianne Moore|Ryan Gosling|Emma Stone|Marisa Tomei,Glenn Ficarra|John Requa,118,Comedy|Drama|Romance,2011-07-29,1577,6.9,2011,48469902,138479670,90009768,7
3384,2.776061,90000000,232617430,142617430,The Girl with the Dragon Tattoo,Daniel Craig|Rooney Mara|Christopher Plummer|Goran Visnjic|Stellan SkarsgÃ¥rd,David Fincher,158,Thriller|Crime|Mystery|Drama,2011-12-14,1679,7.1,2011,87245823,225498881,138253058,7
3385,2.754426,27000000,161849455,134849455,Limitless,Bradley Cooper|Robert De Niro|Abbie Cornish|Andrew Howard|Anna Friel,Neil Burger,105,Thriller|Mystery|Science Fiction,2011-03-08,2445,7.0,2011,26173747,156896544,130722797,7
3386,2.726573,150000000,665692281,515692281,Kung Fu Panda 2,Jack Black|Angelina Jolie|Dustin Hoffman|Gary Oldman|Jackie Chan,Jennifer Yuh,91,Animation|Family,2011-05-25,1207,6.6,2011,145409706,645320794,499911088,7
3387,2.690458,80000000,214918407,134918407,Just Go With It,Jennifer Aniston|Adam Sandler|Nicole Kidman|Bailee Madison|Griffin Gluck,Dennis Dugan,117,Romance|Comedy,2011-02-10,1010,6.3,2011,77551843,208341483,130789640,6
3388,2.686643,35000000,117000000,82000000,Horrible Bosses,Jennifer Aniston|Jason Bateman|Charlie Day|Jason Sudeikis|Colin Farrell,Seth Gordon,98,Comedy|Crime,2011-07-08,1417,6.4,2011,33928931,113419570,79490639,6
3389,2.657014,110000000,299268508,189268508,Real Steel,Hugh Jackman|Dakota Goyo|Evangeline Lilly|Anthony Mackie|Kevin Durand,Shawn Levy,127,Action|Science Fiction|Drama,2011-09-28,1856,6.5,2011,106633784,290110305,183476521,6
3390,2.633754,35000000,150483765,115483765,Friends with Benefits,Justin Timberlake|Mila Kunis|Patricia Clarkson|Woody Harrelson|Nolan Gould,Will Gluck,109,Comedy,2011-07-21,1366,6.5,2011,33928931,145878667,111949736,6
3391,2.604249,20000000,216197492,196197492,Bad Teacher,Jason Segel|Cameron Diaz|Justin Timberlake|Lucy Punch|Phyllis Smith,Jake Kasdan,92,Comedy,2011-05-16,953,5.4,2011,19387960,209581425,190193465,5
3392,2.579776,125000000,334615000,209615000,Sherlock Holmes: A Game of Shadows,Robert Downey Jr.|Jude Law|Jared Harris|Noomi Rapace|Kelly Reilly,Guy Ritchie,129,Adventure|Action|Crime|Mystery,2011-11-22,2710,6.9,2011,121174755,324375126,203200371,7
3393,2.454226,200000000,559852396,359852396,Cars 2,Larry the Cable Guy|Owen Wilson|Michael Caine|Emily Mortimer|Eddie Izzard,John Lasseter|Brad Lewis,106,Animation|Family|Adventure|Comedy,2011-06-11,1277,5.8,2011,193879608,542719816,348840208,6
3394,2.419805,200000000,219851172,19851172,Green Lantern,Ryan Reynolds|Blake Lively|Peter Sarsgaard|Tim Robbins|Mark Strong,Martin Campbell,114,Adventure|Action|Thriller|Science Fiction,2011-06-16,1654,5.1,2011,193879608,213123295,19243687,5
3395,2.411533,80000000,254455986,174455986,The Hangover Part II,Bradley Cooper|Ed Helms|Zach Galifianakis|Justin Bartha|Ken Jeong,Todd Phillips,102,Comedy,2011-05-25,2601,6.1,2011,77551843,246669134,169117291,6
3396,2.252505,25000000,147780440,122780440,No Strings Attached,Natalie Portman|Ashton Kutcher|Greta Gerwig|Kevin Kline|Olivia Thirlby,Ivan Reitman,108,Comedy|Romance,2011-01-12,859,6.1,2011,24234951,143258069,119023118,6
3397,2.2343,130000000,371940071,241940071,The Adventures of Tintin,Jamie Bell|Andy Serkis|Daniel Craig|Nick Frost|Simon Pegg,Steven Spielberg,107,Adventure|Animation|Action|Family|Mystery,2011-10-25,1448,6.6,2011,126021745,360557976,234536231,7
3398,2.208685,32500000,288383523,255883523,Bridesmaids,Kristen Wiig|Rose Byrne|Maya Rudolph|Wendi McLendon-Covey|Ellie Kemper,Paul Feig,125,Romance|Comedy,2011-04-28,1145,6.5,2011,31505436,279558422,248052986,6
3399,2.164361,36000000,83160734,47160734,Hall Pass,Owen Wilson|Jason Sudeikis|Jenna Fischer|Christina Applegate|Nicky Whelan,Bobby Farrelly|Peter Farrelly,105,Comedy,2011-02-25,423,5.4,2011,34898329,80615852,45717523,5
3400,2.026717,50000000,260095987,210095987,Super 8,Joel Courtney|Elle Fanning|Riley Griffiths|Kyle Chandler|Ryan Lee,J.J. Abrams,112,Thriller|Science Fiction|Mystery,2011-06-08,1527,6.6,2011,48469902,252136540,203666638,7
3401,1.972826,82000000,89792502,7792502,Sucker Punch,Emily Browning|Abbie Cornish|Jena Malone|Vanessa Hudgens|Jamie Chung,Zack Snyder,110,Action|Fantasy|Thriller,2011-03-24,1007,5.9,2011,79490639,87044675,7554036,6
3402,1.934043,42000000,89162162,47162162,Red Riding Hood,Amanda Seyfried|Gary Oldman|Billy Burke|Shiloh Fernandez|Max Irons,Catherine Hardwicke,100,Thriller,2011-03-11,533,5.5,2011,40714717,86433625,45718908,5
3403,1.888096,110000000,712171856,602171856,The Twilight Saga: Breaking Dawn - Part 1,Kristen Stewart|Robert Pattinson|Taylor Lautner|Ashley Greene|Peter Facinelli,Bill Condon,117,Adventure|Fantasy|Romance,2011-03-15,1658,5.8,2011,106633784,690378003,583744219,6
3404,1.885979,6500000,17693675,11193675,Shame,Michael Fassbender|Carey Mulligan|James Badge Dale|Nicole Beharie|Alex Manette,Steve McQueen,100,Drama,2011-10-02,458,6.9,2011,6301087,17152213,10851126,7
3406,1.825552,55000000,187361754,132361754,Mr. Popper's Penguins,Jim Carrey|Carla Gugino|Madeline Carroll|Angela Lansbury|Ophelia Lovibond,Mark Waters,94,Comedy|Family,2011-06-17,465,5.7,2011,53316892,181628117,128311225,6
3407,1.821261,32000000,54674226,22674226,The Tree of Life,Brad Pitt|Sean Penn|Jessica Chastain|Hunter McCracken|Finnegan Williams,Terrence Malick,139,Drama|Fantasy,2011-05-18,582,6.5,2011,31020737,53001087,21980350,6
3408,1.794214,50000000,144492830,94492830,I Am Number Four,Alex Pettyfer|Timothy Olyphant|Teresa Palmer|Dianna Agron|Callan McAuliffe,D.J. Caruso,109,Action|Thriller|Science Fiction|Adventure,2011-02-18,1016,6.0,2011,48469902,140071066,91601164,6
3409,1.710793,90000000,484635760,394635760,Rio,Jesse Eisenberg|Anne Hathaway|Leslie Mann|Jane Lynch|Will.i.am,Carlos Saldanha,96,Animation|Adventure|Comedy|Family,2011-04-03,1530,6.5,2011,87245823,469804957,382559134,6
3410,1.644472,15000000,133432856,118432856,The Artist,Jean Dujardin|BÃ©rÃ©nice Bejo|John Goodman|James Cromwell|Penelope Ann Miller,Michel Hazanavicius,100,Drama|Comedy|Romance,2011-05-15,651,7.2,2011,14540970,129349549,114808579,7
3411,1.64314,80000000,169852759,89852759,Zookeeper,Kevin James|Rosario Dawson|Sylvester Stallone|Nick Nolte|Jon Favreau,Frank Coraci,102,Comedy|Romance|Family,2011-07-06,327,5.4,2011,77551843,164654932,87103089,5
3412,1.640256,163000000,174822325,11822325,Cowboys & Aliens,Daniel Craig|Olivia Wilde|Harrison Ford|Sam Rockwell|Walton Goggins,Jon Favreau,119,Action|Science Fiction|Thriller|Western,2011-07-29,1363,5.4,2011,158011880,169472419,11460539,5
3414,1.592819,66000000,177584879,111584879,War Horse,Tom Hiddleston|Benedict Cumberbatch|Toby Kebbell|Emily Watson|Jeremy Irvine,Steven Spielberg,146,Drama|War,2011-12-25,611,6.9,2011,63980270,172150434,108170164,7
3415,1.531633,8000000,39187783,31187783,50/50,Joseph Gordon-Levitt|Seth Rogen|Anna Kendrick|Bryce Dallas Howard|Anjelica Huston,Jonathan Levine,100,Comedy|Drama,2011-09-30,773,6.8,2011,7755184,37988560,30233376,7
3416,1.499109,135000000,245724603,110724603,Rango,Johnny Depp|Isla Fisher|Ned Beatty|Bill Nighy|Alfred Molina,Gore Verbinski,107,Animation|Comedy|Family|Western|Adventure,2011-03-02,1385,6.5,2011,130868735,238204949,107336214,6
3417,1.493933,52000000,75450437,23450437,The Change-Up,Olivia Wilde|Ryan Reynolds|Jason Bateman|Leslie Mann|Mircea Monroe,David Dobkin,112,Comedy,2011-08-05,440,5.9,2011,50408698,73141505,22732807,6
3418,1.488615,170000000,185770160,15770160,Hugo,Asa Butterfield|ChloÃ« Grace Moretz|Ben Kingsley|Sacha Baron Cohen|Jude Law,Martin Scorsese,126,Adventure|Drama|Family,2011-11-22,1257,6.8,2011,164797667,180085229,15287562,7
3419,1.482692,40000000,85412898,45412898,The Lincoln Lawyer,Matthew McConaughey|Marisa Tomei|Ryan Phillippe|William H. Macy|Josh Lucas,Brad Furman,119,Crime|Drama|Thriller,2011-03-17,582,6.9,2011,38775921,82799096,44023175,7
3420,1.481016,57000000,149217355,92217355,Ghost Rider: Spirit of Vengeance,Nicolas Cage|CiarÃ¡n Hinds|Violante Placido|Fergus Riordan|Johnny Whitworth,Mark Neveldine|Brian Taylor,95,Action|Fantasy|Thriller,2011-12-10,752,4.7,2011,55255688,144651011,89395323,5
3421,1.470363,15000000,59389433,44389433,One Day,Anne Hathaway|Jim Sturgess|Patricia Clarkson|Romola Garai|Heida Reed,Lone Scherfig,107,Drama|Romance,2011-03-02,591,6.9,2011,14540970,57572000,43031030,7
3422,1.46909,66000000,57777106,-8222894,Killer Elite,Jason Statham|Clive Owen|Robert De Niro|Dominic Purcell|Yvonne Strahovski,Gary McKendry,116,Action|Adventure|Thriller,2011-09-23,440,6.0,2011,63980270,56009013,-7971257,6
3423,1.465299,37000000,96047633,59047633,The Rite,Anthony Hopkins|Colin O'Donoghue|Alice Braga|Toby Jones|CiarÃ¡n Hinds,Mikael HÃ¥fstrÃ¶m,114,Drama|Thriller|Horror,2011-01-28,320,5.7,2011,35867727,93108387,57240660,6
3424,1.425344,30000000,14460000,-15540000,Winnie the Pooh,Jim Cummings|Travis Oates|Jim Cummings|Bud Luckey|Craig Ferguson,Stephen Anderson|Don Hall,63,Animation|Family,2011-04-13,174,6.8,2011,29081941,14017495,-15064446,7
3425,1.407986,75000000,132274484,57274484,The Three Musketeers,Milla Jovovich|Orlando Bloom|Logan Lerman|Ray Stevenson|Matthew Macfadyen,Paul W.S. Anderson,110,Adventure|Action|Thriller|Comedy,2011-08-31,589,5.5,2011,72704853,128226625,55521772,5
3427,1.388994,8000000,1749457,-6250543,Chalet Girl,Felicity Jones|Ed Westwick|Brooke Shields|Bill Nighy|Tamsin Egerton,Phil Traill,96,Comedy|Romance,2011-02-02,108,6.2,2011,7755184,1695920,-6059264,6
3429,1.367727,30000000,151119219,121119219,Midnight in Paris,Owen Wilson|Rachel McAdams|Kurt Fuller|Mimi Kennedy|Michael Sheen,Woody Allen,94,Fantasy|Comedy|Romance,2011-05-11,1117,7.2,2011,29081941,146494675,117412734,7
3430,1.344998,60000000,78309131,18309131,Priest,Paul Bettany|Cam Gigandet|Karl Urban|Lily Collins|Maggie Q,Scott Stewart,87,Action|Fantasy|Horror|Science Fiction|Thriller,2011-05-05,439,5.3,2011,58163882,75912718,17748836,5
3432,1.285106,12000000,22939027,10939027,Young Adult,Charlize Theron|Patton Oswalt|Patrick Wilson|Elizabeth Reaser|Collette Wolfe,Jason Reitman,94,Comedy|Drama|Romance,2011-12-16,219,5.2,2011,11632776,22237047,10604271,5
3433,1.246852,25000000,23057115,-1942885,Warrior,Tom Hardy|Jennifer Morrison|Nick Nolte|Joel Edgerton|Frank Grillo,Gavin O'Connor,140,Action|Drama,2011-09-09,768,7.6,2011,24234951,22351522,-1883429,8
3434,1.246595,35000000,82087155,47087155,Abduction,Taylor Lautner|Lily Collins|Alfred Molina|Jason Isaacs|Maria Bello,John Singleton,106,Thriller|Action|Mystery,2011-09-22,631,5.5,2011,33928931,79575127,45646196,5
3435,1.246283,30000000,130786397,100786397,Unknown,Liam Neeson|Diane Kruger|January Jones|Aidan Quinn|Bruno Ganz,Jaume Collet-Serra,113,Action|Mystery|Thriller,2011-02-16,779,6.4,2011,29081941,126784077,97702136,6
3436,1.241191,50200000,127869379,77669379,The Adjustment Bureau,Matt Damon|Emily Blunt|John Slattery|Anthony Mackie|Lauren Hodges,George Nolfi,106,Thriller|Romance|Fantasy,2011-03-03,1097,6.4,2011,48663781,123956325,75292544,6
3437,1.240414,75000000,226904017,151904017,Immortals,Mickey Rourke|Kellan Lutz|Isabel Lucas|Henry Cavill|Luke Evans,Tarsem Singh,110,Fantasy|Action|Drama,2011-11-10,596,5.6,2011,72704853,219960309,147255456,6
3438,1.22871,250000,3542353,3292353,Like Crazy,Anton Yelchin|Felicity Jones|Jennifer Lawrence|Charlie Bewley|Alex Kingston,Drake Doremus,90,Drama|Romance,2011-10-28,257,6.4,2011,242349,3433950,3191601,6
3439,1.21550499999999,30000000,36160375,6160375,Larry Crowne,Tom Hanks|Julia Roberts|Bryan Cranston|Cedric the Entertainer|Pam Grier,Tom Hanks,98,Comedy|Romance|Drama,2011-06-30,218,5.6,2011,29081941,35053796,5971855,6
3440,1.21340499999999,40000000,97552050,57552050,Paul,Seth Rogen|Simon Pegg|Nick Frost|Jason Bateman|Kristen Wiig,Greg Mottola,104,Adventure|Comedy|Science Fiction,2011-02-14,1143,6.4,2011,38775921,94566766,55790845,6
3443,1.205338,40000000,60965854,20965854,Colombiana,Zoe Saldana|Cliff Curtis|Callum Blue|Michael Vartan|Lennie James,Olivier Megaton,108,Action|Thriller|Crime|Drama,2011-07-27,554,6.5,2011,38775921,59100179,20324258,6
3444,1.19533,70000000,202466756,132466756,Battle: Los Angeles,Aaron Eckhart|RamÃ³n RodrÃ­guez|Will Rothhaar|Cory Hardrict|Jim Parrack,Jonathan Liebesman,116,Action|Science Fiction,2011-03-08,1041,5.5,2011,67857862,196270876,128413014,5
3445,1.176723,47000000,157887643,110887643,Final Destination 5,Emma Bell|Nicholas D'Agosto|Miles Fisher|Ellen Wroe|Jacqueline MacInnes Wood,Steven Quale,92,Horror|Mystery,2011-08-12,493,5.9,2011,45561708,153055972,107494264,6
3446,1.128994,30000000,2527904,-27472096,Machine Gun Preacher,Gerard Butler|Michelle Monaghan|Justin Michael Brandt|Richard Goteri|Peter Carey,Marc Forster,129,Action|Thriller|Crime,2011-09-23,166,6.4,2011,29081941,2450545,-26631396,6
3447,1.123666,79000000,149673788,70673788,Jack and Jill,Adam Sandler|Katie Holmes|Al Pacino|Eugenio Derbez|Tim Meadows,Dennis Dugan,91,Comedy,2011-11-11,371,4.2,2011,76582445,145093477,68511032,4
3448,1.120851,20000000,30426096,10426096,What's Your Number?,Chris Evans|Anna Faris|Martin Freeman|Chris Pratt|Ari Graynor,Mark Mylod,106,Comedy|Romance,2011-09-30,390,6.2,2011,19387960,29494997,10107037,6
3449,1.11981,40000000,88100000,48100000,Season of the Witch,Nicolas Cage|Ron Perlman|Ulrich Thomsen|Christopher Lee|Fernanda Dorogi,Dominic Sena,95,Adventure|Fantasy|Action,2011-01-07,453,5.2,2011,38775921,85403967,46628046,5
3450,1.116674,6400000,35057696,28657696,My Week with Marilyn,Michelle Williams|Eddie Redmayne|Kenneth Branagh|Julia Ormond|Judi Dench,Simon Curtis,99,Drama,2011-10-17,212,6.7,2011,6204147,33984861,27780714,7
3452,1.111078,50000000,120081841,70081841,We Bought a Zoo,Matt Damon|Scarlett Johansson|Thomas Haden Church|Colin Ford|Maggie Elizabeth Jones,Cameron Crowe,124,Drama|Comedy|Family,2011-12-22,589,6.4,2011,48469902,116407101,67937199,6
3454,1.107689,30000000,64626786,34626786,The Darkest Hour,Emile Hirsch|Rachael Taylor|Olivia Thirlby|Joel Kinnaman|Max Minghella,Chris Gorak,89,Horror|Action|Thriller|Science Fiction,2011-12-25,309,4.7,2011,29081941,62649079,33567138,5
3455,1.105855,25000000,124272124,99272124,The Help,Emma Stone|Viola Davis|Octavia Spencer|Bryce Dallas Howard|Jessica Chastain,Tate Taylor,146,Drama,2011-08-09,1056,7.6,2011,24234951,120469153,96234202,8
3456,1.102011,25000000,77278331,52278331,The Grey,Liam Neeson|Dermot Mulroney|Frank Grillo|Dallas Roberts|Joe Anderson,Joe Carnahan,117,Action|Drama|Thriller,2011-12-11,955,6.3,2011,24234951,74913462,50678511,6
3457,1.081676,50000000,110206216,60206216,Moneyball,Brad Pitt|Jonah Hill|Robin Wright|Philip Seymour Hoffman|Chris Pratt,Bennett Miller,133,Drama,2011-09-22,899,6.9,2011,48469902,106833690,58363788,7
3458,1.079441,7000000,6038942,-961058,We Need to Talk About Kevin,John C. Reilly|Tilda Swinton|Ezra Miller|Siobhan Fallon|Jasper Newell,Lynne Ramsay,112,Drama|Thriller,2011-09-28,345,7.3,2011,6785786,5854138,-931648,7
3459,1.074793,16000000,40492759,24492759,The Roommate,Minka Kelly|Leighton Meester|Cam Gigandet|Aly Michalka|Matt Lanter,Christian E. Christiansen,91,Thriller|Drama|Horror,2011-02-04,133,5.5,2011,15510368,39253601,23743233,5
3460,1.071695,130000000,554987477,424987477,Puss in Boots,Antonio Banderas|Salma Hayek|Zach Galifianakis|Billy Bob Thornton|Amy Sedaris,Chris Miller,90,Action|Adventure|Animation|Family|Fantasy,2011-10-28,48,6.9,2011,126021745,538003773,411982028,7
3462,1.058342,120000000,227817248,107817248,The Green Hornet,Seth Rogen|Jay Chou|Christoph Waltz|Cameron Diaz|Edward Furlong,Michel Gondry,119,Action|Crime|Comedy,2011-01-12,854,5.4,2011,116327765,220845594,104517829,5
3463,1.055533,35000000,59901913,24901913,Something Borrowed,Kate Hudson|Ginnifer Goodwin|John Krasinski|Colin Egglesfield|Ashley Williams,Luke Greenfield,112,Comedy|Drama|Romance,2011-05-05,180,6.0,2011,33928931,58068797,24139866,6
3464,1.054256,90000000,48795021,-41204979,Conan the Barbarian,Jason Momoa|Rose McGowan|Rachel Nichols|Ron Perlman|Stephen Lang,Marcus Nispel,113,Adventure|Fantasy|Action,2011-08-17,382,5.2,2011,87245823,47301797,-39944026,5
3466,1.048895,45000000,160078586,115078586,Johnny English Reborn,Rowan Atkinson|Dominic West|Gillian Anderson|Rosamund Pike|Roger Barclay,Oliver Parker,101,Crime|Adventure|Action|Comedy|Thriller,2011-09-15,689,6.0,2011,43622911,155179867,111556956,6
3467,1.045866,60000000,135458097,75458097,Contagion,Matt Damon|Gwyneth Paltrow|Kate Winslet|Jude Law|Marion Cotillard,Steven Soderbergh,106,Drama|Thriller|Science Fiction,2011-09-08,852,6.1,2011,58163882,131312814,73148932,6
3469,1.038162,41000000,7448385,-33551615,The Big Year,Owen Wilson|Steve Martin|Jack Black|Rashida Jones|Jim Parsons,David Frankel,100,Comedy,2011-10-14,152,5.4,2011,39745319,7220449,-32524870,5
3470,1.029084,17000000,43165571,26165571,Beastly,Alex Pettyfer|Vanessa Hudgens|Mary-Kate Olsen|Lisa Gay Hamilton|Neil Patrick Harris,Daniel Barnz,86,Drama|Fantasy|Romance,2011-01-21,507,6.0,2011,16479766,41844620,25364854,6
3471,1.024786,19000000,35387212,16387212,A Very Harold & Kumar Christmas,Neil Patrick Harris|John Cho|Elias Koteas|Danneel Ackles|Kal Penn,Todd Strauss-Schulson,108,Comedy,2011-11-04,186,6.0,2011,18418562,34304294,15885732,6
3472,1.013771,35000000,28128670,-6871330,The Thing,Mary Elizabeth Winstead|Joel Edgerton|Ulrich Thomsen|Eric Christian Olsen|Adewale Akinnuoye-Agbaje,Matthijs van Heijningen Jr.,103,Horror|Science Fiction|Mystery|Thriller,2011-10-12,479,6.0,2011,33928931,27267877,-6661054,6
3473,1.013101,75000000,152930623,77930623,Tower Heist,Ben Stiller|Eddie Murphy|Casey Affleck|Alan Alda|Matthew Broderick,Brett Ratner,104,Action|Comedy,2011-11-02,588,5.8,2011,72704853,148250646,75545793,6
3474,1.011185,56000000,142044638,86044638,New Year's Eve,Robert De Niro|Katherine Heigl|Ashton Kutcher|Carla Gugino|Lea Michele,Garry Marshall,118,Comedy|Romance,2011-12-08,479,5.6,2011,54286290,137697794,83411504,6
3475,1.004841,49900000,26121638,-23778362,Your Highness,Danny McBride|James Franco|Natalie Portman|Zooey Deschanel|Justin Theroux,David Gordon Green,102,Adventure|Fantasy|Action|Comedy,2011-04-08,289,5.1,2011,48372962,25322264,-23050698,5
3480,0.941604,5000000,25562924,20562924,Apollo 18,Ryan Robbins|Warren Christie|Lloyd Owen|Andrew Airlie|Michael Kopsa,Gonzalo LÃ³pez-Gallego,86,Horror|Thriller|Science Fiction,2011-07-20,205,4.9,2011,4846990,24780648,19933658,5
3481,0.93488,17000000,24922237,7922237,Fright Night,Anton Yelchin|Colin Farrell|Toni Collette|Christopher Mintz-Plasse|David Tennant,Craig Gillespie,106,Horror|Comedy,2011-08-18,328,6.1,2011,16479766,24159567,7679801,6
3482,0.93092,130000000,150406466,20406466,Happy Feet Two,Elijah Wood|Robin Williams|Pink|E.G. Daily|Johnny A. Sanchez,George Miller,100,Music|Family|Animation|Comedy,2011-11-17,232,5.8,2011,126021745,145803733,19781988,6
3483,0.929466,40000000,97138686,57138686,Scream 4,David Arquette|Neve Campbell|Courteney Cox|Emma Roberts|Hayden Panettiere,Wes Craven,111,Horror|Mystery,2011-04-11,499,6.0,2011,38775921,94166052,55390131,6
3484,0.921653,150000000,38992758,-111007242,Mars Needs Moms,Seth Green|Joan Cusack|Dan Fogler|Breckin Meyer|Elisabeth Harnois,Simon Wells,88,Adventure|Animation|Family,2011-03-09,129,5.5,2011,145409706,37799503,-107610203,5
3485,0.91973,14350531,3964682,-10385849,Attack the Block,Nick Frost|Jodie Whittaker|John Boyega|Luke Treadaway|Flaminia Cinque,Joe Cornish,88,Action|Comedy|Science Fiction,2011-05-12,427,6.4,2011,13911376,3843354,-10068022,6
3486,0.917718,21000000,72417394,51417394,Diary of a Wimpy Kid: Rodrick Rules,Zachary Gordon|Devon Bostick|Rachael Harris|Robert Capron|Steve Zahn,David Bowers,99,Family|Comedy,2011-03-25,127,6.4,2011,20357358,70201279,49843921,6
3488,0.907952,40000000,55247881,15247881,Extremely Loud & Incredibly Close,Thomas Horn|Tom Hanks|Sandra Bullock|Max von Sydow|John Goodman,Stephen Daldry,129,Drama,2011-12-24,463,7.0,2011,38775921,53557187,14781266,7
3490,0.904531,75000000,342695435,267695435,Alvin and the Chipmunks: Chipwrecked,Jason Lee|David Cross|Jenny Slate|Andy Buckley|Justin Long,Mike Mitchell,87,Comedy|Fantasy|Family|Music|Animation,2011-12-14,308,5.5,2011,72704853,332208283,259503430,5
3491,0.903312,21000000,970816,-20029184,The Beaver,Jodie Foster|Mel Gibson|Jennifer Lawrence|Anton Yelchin|Zachary Booth,Jodie Foster,91,Drama,2011-02-11,144,6.0,2011,20357358,941107,-19416251,6
3492,0.897265,25000000,10324441,-14675559,Straw Dogs,James Marsden|Kate Bosworth|Alexander SkarsgÃ¥rd|Laz Alonso|Dominic Purcell,Rod Lurie,110,Thriller,2011-09-16,75,5.3,2011,24234951,10008492,-14226459,5
3493,0.895829,10000000,136836156,126836156,The Best Exotic Marigold Hotel,Bill Nighy|Maggie Smith|Tom Wilkinson|Judi Dench|Dev Patel,John Madden,124,Drama|Comedy,2011-11-28,310,6.8,2011,9693980,132648701,122954721,7
3494,0.879003,110000000,563749323,453749323,The Smurfs,Neil Patrick Harris|Jayma Mays|Anton Yelchin|Hank Azaria|Alan Cumming,Raja Gosnell,103,Animation|Family|Adventure|Comedy|Fantasy,2011-07-29,797,5.5,2011,106633784,546497490,439863706,5
3496,0.863804,30000000,63782078,33782078,Hanna,Saoirse Ronan|Eric Bana|Vicky Krieps|Cate Blanchett|Tom Hollander,Joe Wright,111,Action|Thriller|Adventure,2011-04-07,804,6.5,2011,29081941,61830221,32748280,6
3499,0.852907,12468389,29007412,16539023,A Few Best Men,Rebel Wilson|Xavier Samuel|Olivia Newton-John|Kris Marshall|Kevin Bishop,Stephan Elliott,97,Comedy,2011-10-14,87,5.7,2011,12086831,28119728,16032897,6
3502,0.846187999999999,5000000,3142154,-1857846,Flypaper,Patrick Dempsey|Ashley Judd|Tim Blake Nelson|Mekhi Phifer|Matt Ryan,Rob Minkoff,87,Mystery|Comedy|Crime,2011-08-19,153,6.1,2011,4846990,3045997,-1800993,6
3503,0.846125,3500000,19504039,16004039,Margin Call,Kevin Spacey|Paul Bettany|Jeremy Irons|Zachary Quinto|Ashley Williams,J.C. Chandor,107,Thriller|Drama,2011-09-28,313,6.6,2011,3392893,18907177,15514284,7
3504,0.827785,36000000,189712432,153712432,Gnomeo & Juliet,James McAvoy|Michael Caine|Maggie Smith|Julie Walters|Patrick Stewart,Kelly Asbury,84,Animation|Family,2011-01-13,335,5.7,2011,34898329,183906860,149008531,6
3505,0.815155,15774948,741875,-15033073,Blitz,Jason Statham|Paddy Considine|Aidan Gillen|Zawe Ashton|Luke Evans,Elliott Lester,97,Crime|Action|Thriller,2011-05-20,309,6.0,2011,15292203,719172,-14573031,6
3507,0.808335999999999,20000000,177243185,157243185,The Descendants,George Clooney|Shailene Woodley|Amara Miller|Nick Krause|Robert Forster,Alexander Payne,115,Comedy|Drama,2011-09-09,590,6.6,2011,19387960,171819196,152431236,7
3508,0.806735,63000000,183953723,120953723,Hop,Russell Brand|James Marsden|Kaley Cuoco|Hank Azaria|Elizabeth Perkins,Tim Hill,95,Animation,2011-03-30,228,5.4,2011,61072076,178324379,117252303,5
3509,0.806361,45000000,24000000,-21000000,The Rum Diary,Johnny Depp|Amber Heard|Aaron Eckhart|Michael Rispoli|Giovanni Ribisi,Bruce Robinson,120,Drama|Comedy,2011-10-13,234,5.5,2011,43622911,23265553,-20357358,5
3511,0.802769,6000000,19560274,13560274,The Guard,Brendan Gleeson|Don Cheadle|Liam Cunningham|Mark Strong|Katarina Cas,John Michael McDonagh,96,Action|Comedy|Thriller|Crime,2011-07-07,194,6.6,2011,5816388,18961691,13145303,7
3513,0.80048,10000000,17273593,7273593,Our Idiot Brother,Paul Rudd|Elizabeth Banks|Zooey Deschanel|Emily Mortimer|Adam Scott,Jesse Peretz,90,Comedy|Drama,2011-08-26,199,5.7,2011,9693980,16744987,7051007,6
3514,0.786615,10000000,610986,-9389014,The Ledge,Patrick Wilson|Liv Tyler|Charlie Hunnam|Terrence Howard|Jaqueline Fleming,Matthew Chapman,101,Drama|Thriller,2011-05-06,44,5.7,2011,9693980,592288,-9101692,6
3515,0.785489,24000000,63543328,39543328,Footloose,Kenny Wormald|Julianne Hough|Dennis Quaid|Andie MacDowell|Miles Teller,Craig Brewer,113,Drama|Music|Romance,2011-10-06,266,6.5,2011,23265553,61598777,38333224,6
3517,0.780318,36000000,9612469,-26387531,Trespass,Nicolas Cage|Nicole Kidman|Liana Liberato|Cam Gigandet|Jordana Spiro,Joel Schumacher,91,Crime|Drama|Thriller,2011-10-14,179,5.3,2011,34898329,9318308,-25580021,5
3518,0.779648,25000000,27603069,2603069,Carnage,Kate Winslet|Jodie Foster|Christoph Waltz|John C. Reilly|Elvis Polanski,Roman Polanski,80,Comedy|Drama,2011-09-16,382,6.9,2011,24234951,26758361,2523410,7
3519,0.779536,100000,1776935,1676935,Another Earth,Brit Marling|William Mapother|Jordan Baker|Flint Beverage|Robin Lord Taylor,Mike Cahill,92,Drama|Science Fiction,2011-07-22,299,6.8,2011,96939,1722557,1625618,7
3520,0.771868,12500000,75993061,63493061,The Ides of March,Ryan Gosling|George Clooney|Philip Seymour Hoffman|Paul Giamatti|Marisa Tomei,George Clooney,101,Drama,2011-09-24,591,6.4,2011,12117475,73667524,61550049,6
3522,0.760502999999999,195000000,1123746996,928746996,Transformers: Dark of the Moon,Shia LaBeouf|John Malkovich|Ken Jeong|Frances McDormand|Josh Duhamel,Michael Bay,154,Action|Science Fiction|Adventure,2011-06-28,2456,6.1,2011,189032618,1089358138,900325520,6
3523,0.760193,5000000,205703818,200703818,Paranormal Activity 3,Katie Featherston|Sprague Grayden|Lauren Bittner|Christopher Nicholas Smith|Chloe Csengery,Henry Joost|Ariel Schulman,83,Horror,2011-10-19,406,6.0,2011,4846990,199408878,194561888,6
3525,0.747362,70000000,67112664,-2887336,The Dilemma,Kevin James|Vince Vaughn|Winona Ryder|Jennifer Connelly|Queen Latifah,Ron Howard,111,Comedy|Drama,2011-01-13,204,5.2,2011,67857862,65058885,-2798977,5
3526,0.734516,19000000,6928068,-12071932,Take Me Home Tonight,Topher Grace|Anna Faris|Dan Fogler|Teresa Palmer|Michelle Trachtenberg,Michael Dowse,97,Comedy|Drama|Romance,2011-03-04,120,6.3,2011,18418562,6716055,-11702507,6
3530,0.70252,4000000,25345000,21345000,A Lonely Place to Die,Melissa George|Ed Speleers|Eamonn Walker|Alec Newman|Karel Roden,Julian Gilbey,99,Adventure|Action|Thriller|Crime,2011-04-09,77,6.1,2011,3877592,24569393,20691801,6
3531,0.699052,45000000,165184237,120184237,The Muppets,Amy Adams|Jason Segel|Emily Blunt|John Krasinski|Zach Galifianakis,James Bobin,103,Comedy|Family|Music,2011-11-22,328,6.4,2011,43622911,160129276,116506365,6
3532,0.688697,27000000,85564310,58564310,Spy Kids: All the Time in the World,Jessica Alba|Mason Cook|Rowan Blanchard|Joel McHale|Jeremy Piven,Robert Rodriguez,89,Family|Comedy|Action,2011-08-18,125,4.5,2011,26173747,82945874,56772127,4
3533,0.687144,9500000,120000,-9380000,Trust,Clive Owen|Catherine Keener|Liana Liberato|Jason Clarke|Viola Davis,David Schwimmer,104,Crime|Drama|Thriller,2011-04-01,164,6.5,2011,9209281,116327,-9092954,6
3537,0.666454,17000000,12355798,-4644202,Seeking Justice,Nicolas Cage|Guy Pearce|January Jones|Jennifer Carpenter|Harold Perrineau,Roger Donaldson,105,Action|Drama|Thriller,2011-09-02,171,5.9,2011,16479766,11977686,-4502080,6
3539,0.661177999999999,40000000,45735397,5735397,Arthur,Russell Brand|Helen Mirren|Greta Gerwig|Jennifer Garner|Geraldine James,Jason Winer,110,Comedy|Romance,2011-04-08,180,5.3,2011,38775921,44335804,5559883,5
3543,0.658095,25000000,27122040,2122040,The Eagle,Channing Tatum|Mark Strong|Jamie Bell|Donald Sutherland|Denis O'Hare,Kevin Macdonald,114,Adventure|Drama,2011-02-08,252,5.9,2011,24234951,26292052,2057101,6
3544,0.656612,25000000,34942188,9942188,The Sitter,Sam Rockwell|Jonah Hill|Max Records|Ari Graynor|J.B. Smoove,David Gordon Green,81,Comedy,2011-12-09,213,5.4,2011,24234951,33872888,9637937,5
3545,0.644722999999999,2000000,42070,-1957930,Rundskop,Matthias Schoenaerts|Jeroen Perceval|Jeanne Dandoy|Barbara Sarafian|Tibo Vandenborre,MichaÃ«l R. Roskam,124,Crime|Drama,2011-02-02,56,7.5,2011,1938796,40782,-1898014,7
3547,0.626306,15000000,868439,-14131561,W.E.,Abbie Cornish|Andrea Riseborough|James D'Arcy|Richard Coyle|David Harbour,Madonna,119,Drama|Romance,2011-09-01,43,5.8,2011,14540970,841863,-13699107,6
3553,0.604152,750000,78396,-671604,The Innkeepers,Sara Paxton|Pat Healy|Kelly McGillis|George Riddle|Lena Dunham,Ti West,102,Horror|Thriller,2011-12-01,104,5.2,2011,727048,75996,-651052,5
3554,0.601594,8000000,163265,-7836735,Restless,Mia Wasikowska|Henry Hopper|Ryo Kase|Schuyler Fisk|Jane Adams,Gus Van Sant,91,Drama|Romance,2011-09-16,93,6.3,2011,7755184,158268,-7596916,6
3557,0.597001,7700000,1072602,-6627398,Coriolanus,Gerard Butler|Ralph Fiennes|Lubna Azabal|Ashraf Barhom|Jessica Chastain,Ralph Fiennes,123,Drama|Thriller,2011-02-14,76,5.7,2011,7464364,1039778,-6424586,6
3558,0.588821,35000000,84606030,49606030,J. Edgar,Leonardo DiCaprio|Armie Hammer|Naomi Watts|Judi Dench|Geoff Pierson,Clint Eastwood,137,Drama|Crime|History,2011-11-09,428,5.8,2011,33928931,82016919,48087988,6
3559,0.587044999999999,30000000,108609310,78609310,Sanctum,Ioan Gruffudd|Richard Roxburgh|Alice Parkinson|Daniel Wyllie|Allison Cratchley,Alister Grierson,108,Action|Thriller,2011-02-03,193,5.7,2011,29081941,105285652,76203711,6
3561,0.58425,24000000,30551495,6551495,I Don't Know How She Does It,Sarah Jessica Parker|Pierce Brosnan|Sarah Shahi|Busy Philipps|Olivia Munn,Douglas McGrath,89,Comedy,2011-09-16,94,5.2,2011,23265553,29616559,6351006,5
3562,0.580693999999999,15000000,27462041,12462041,A Dangerous Method,Keira Knightley|Viggo Mortensen|Michael Fassbender|Sarah Gadon|Vincent Cassel,David Cronenberg,99,Drama|Thriller,2011-09-30,308,5.9,2011,14540970,26621648,12080678,6
3563,0.578282,18000000,47088990,29088990,Soul Surfer,AnnaSophia Robb|Helen Hunt|Lorraine Nicholson|Carrie Underwood|Dennis Quaid,Sean McNamara,106,Action|Drama,2011-04-08,225,6.9,2011,17449164,45647974,28198810,7
3564,0.570978,28000000,40547440,12547440,30 Minutes or Less,Jesse Eisenberg|Danny McBride|Aziz Ansari|Bianca Kajlich|Nick Swardson,Ruben Fleischer,83,Action|Comedy|Adventure,2011-08-11,337,5.5,2011,27143145,39306608,12163463,5
3565,0.570634,4798235,209696,-4588539,The Awakening,Rebecca Hall|Dominic West|Imelda Staunton|Isaac Hempstead Wright|Lucy Cohu,Nick Murphy ,107,Drama|Horror|Thriller,2011-08-17,243,6.2,2011,4651399,203278,-4448121,6
3566,0.566856,30000000,13521829,-16478171,Hoodwinked Too! Hood VS. Evil,Hayden Panettiere|Bill Hader|Joan Cusack|Patrick Warburton|Glenn Close,Mike Disa,86,Comedy|Animation|Family,2011-04-29,86,4.9,2011,29081941,13108034,-15973907,5
3573,0.539108,20000000,17479,-19982521,5 Days of War,Rupert Friend|Val Kilmer|Andy GarcÃ­a|Dean Cain|Emmanuelle Chriqui,Renny Harlin,113,War|Drama,2011-04-14,29,5.9,2011,19387960,16944,-19371016,6
3576,0.530139,38000000,114156230,76156230,Water for Elephants,Robert Pattinson|Reese Witherspoon|Christoph Waltz|Tatum Etheridge|Hal Holbrook,Francis Lawrence,120,Drama|Romance,2011-03-15,558,6.7,2011,36837125,110662825,73825700,7
3577,0.528255,50000000,38502340,-11497660,Dream House,Daniel Craig|Naomi Watts|Rachel Weisz|Marton Csokas|Elias Koteas,Jim Sheridan,92,Drama|Thriller|Mystery,2011-09-30,235,5.9,2011,48469902,37324093,-11145809,6
3578,0.524684,10000000,1759252,-8240748,A Better Life,DemiÃ¡n Bichir|JosÃ© JuliÃ¡n|Chelsea Rendon|Dolores Heredia|JoaquÃ­n Cosio,Chris Weitz,98,Drama,2011-06-24,27,6.6,2011,9693980,1705415,-7988565,7
3581,0.52043,1,1378,1377,"Love, Wedding, Marriage",Mandy Moore|Kellan Lutz|Jessica Szohr|Autumn Federici|James Brolin,Dermot Mulroney,90,Comedy|Romance,2011-06-03,55,5.3,2011,0,1335,1335,5
3583,0.512775,12000000,972512,-11027488,Rampart,Woody Harrelson|Steve Buscemi|Ben Foster|Robin Wright|Jon Bernthal,Oren Moverman,108,Crime|Drama|Action|Thriller,2011-12-10,63,5.2,2011,11632776,942751,-10690025,5
3585,0.509532,5000000,3099314,-1900686,Take Shelter,Michael Shannon|Jessica Chastain|Katy Mixon|Shea Whigham|Ray McKinnon,Jeff Nichols,120,Thriller|Drama,2011-11-25,248,6.9,2011,4846990,3004468,-1842522,7
3586,0.506031,8000000,10130000,2130000,Prom,Aimee Teegarden|Thomas McDonell|Nicholas Braun|Faith Ford|Danielle Campbell,Joe Nussbaum,104,Comedy,2011-04-29,78,5.8,2011,7755184,9820002,2064818,6
3589,0.49518,4317946,14624826,10306880,Pina,Regina Advento|Malou Airaudo|Ruth Amarante|Pina Bausch|Jorge Puerta,Wim Wenders,106,Documentary,2011-02-24,48,7.2,2011,4185808,14177277,9991469,7
3595,0.487945,1000000,34522221,33522221,Courageous,Alex Kendrick|Ken Bevel|Ben Davies|Kevin Downes|Rusty Martin,Alex Kendrick,129,Drama,2011-09-30,51,6.7,2011,969398,33465773,32496375,7
3598,0.484734,40000000,5446000,-34554000,Black Gold,Mark Strong|Antonio Banderas|Freida Pinto|Tahar Rahim|Riz Ahmed,Jean-Jacques Annaud,130,Adventure|Drama,2011-12-21,55,5.6,2011,38775921,5279341,-33496580,6
3601,0.482368,10000000,3665069,-6334931,Killer Joe,Matthew McConaughey|Emile Hirsch|Thomas Haden Church|Gina Gershon|Juno Temple,William Friedkin,102,Drama|Thriller,2011-09-10,196,6.3,2011,9693980,3552910,-6141070,6
3604,0.475663,32000000,83615414,51615414,"Big Mommas: Like Father, Like Son",Portia Doubleday|Martin Lawrence|Brandon T. Jackson|Mari Morrow|Faizon Love,John Whitesell,107,Crime|Comedy|Action,2011-02-16,223,5.4,2011,31020737,81056618,50035881,5
3608,0.46351,93,2500000,2499907,From Prada to Nada,Camilla Belle|Alexa PenaVega|April Bowlby|Wilmer Valderrama|Nicholas D'Agosto,Angel Gracia,107,Comedy|Drama|Romance,2011-01-28,47,5.2,2011,90,2423495,2423405,5
3610,0.455555,37000000,95404397,58404397,Dolphin Tale,Morgan Freeman|Ashley Judd|Harry Connick Jr.|Nathan Gamble|Kris Kristofferson,Charles Martin Smith,113,Drama|Family,2011-09-23,103,6.6,2011,35867727,92484835,56617108,7
3615,0.44615,29000000,33662874,4662874,Xin shao lin si,Andy Lau|Nicholas Tse|Fan Bingbing|Jackie Chan|Wu Jing,Benny Chan,131,Action|Drama,2011-01-20,59,6.4,2011,28112543,32632724,4520181,6
3619,0.436803,125000000,626137675,501137675,Fast Five,Vin Diesel|Paul Walker|Dwayne Johnson|Jordana Brewster|Tyrese Gibson,Justin Lin,130,Action|Thriller|Crime,2011-04-20,1591,7.1,2011,121174755,606976636,485801881,7
3621,0.434506,2500000,3358,-2496642,Nuit Blanche,Tomer Sisley|Julien Boisselier|JoeyStarr|Serge Riaboukine|Laurent Stocker, FrÃ©dÃ©ric Jardin,98,Action|Comedy|Thriller|Romance,2011-11-14,28,5.9,2011,2423495,3255,-2420240,6
3623,0.43132,10000000,303877,-9696123,In the Land of Blood and Honey,Zana MarjanoviÄ‡|Goran KostiÄ‡|Branko ÄuriÄ‡|Dzana Pinjo|MiloÅ¡ TimotijeviÄ‡,Angelina Jolie,127,Drama|Romance|War,2011-12-23,31,6.6,2011,9693980,294577,-9399403,7
3625,0.429826,4000000,355688,-3644312,Another Happy Day,Ellen Barkin|Ezra Miller|Kate Bosworth|Demi Moore|George Kennedy,Sam Levinson,119,Comedy|Drama,2011-11-18,19,6.1,2011,3877592,344803,-3532789,6
3628,0.423412,6600000,37710610,31110610,Jumping the Broom,Paula Patton|Julie Bowen|Meagan Good|Mike Epps|Angela Bassett,Salim Akil,112,Comedy,2011-05-06,37,6.3,2011,6398027,36556591,30158564,6
3631,0.419201,2000000,13101672,11101672,Silent House,Elizabeth Olsen|Adam Trese|Eric Sheffer Stevens|Julia Taylor Ross|Adam Barnett,Chris Kentis|Laura Lau,85,Horror|Mystery,2011-01-21,63,5.2,2011,1938796,12700735,10761939,5
3636,0.414629,8000000,100915,-7899085,Wuthering Heights,Kaya Scodelario|James Northcote|Amy Wren|Nichola Burley|Steve Evets,Andrea Arnold,129,Drama|Romance,2011-09-05,36,5.6,2011,7755184,97826,-7657358,6
3639,0.524527,125000,3200000,3075000,Your Sister's Sister,Mark Duplass|Emily Blunt|Rosemarie DeWitt|Mike Birbiglia|Kate Bayley,Lynn Shelton,90,Drama|Comedy,2011-09-11,96,6.3,2011,121174,3102073,2980899,6
3642,0.410616,20000000,17425000,-2575000,Monte Carlo,Selena Gomez|Katie Cassidy|Cory Monteith|Leighton Meester|Andie MacDowell,Thomas Bezucha,109,Adventure|Comedy|Romance,2011-07-01,359,5.9,2011,19387960,16891760,-2496200,6
3643,0.410207,10831173,10654385,-176788,Win Win,Paul Giamatti|Alex Shaffer|Amy Ryan|Melanie Lynskey|Bobby Cannavale,Tom McCarthy,106,Drama|Comedy,2011-03-18,87,6.8,2011,10499717,10328339,-171378,7
3649,0.395082,14000000,46495,-13953505,Margaret,Anna Paquin|Matt Damon|Mark Ruffalo|Matthew Broderick|Jeannie Berlin,Kenneth Lonergan,149,Drama,2011-09-30,35,5.9,2011,13571572,45072,-13526500,6
3654,0.381174,17000000,3696232,-13303768,The Double,Stephen Moyer|Topher Grace|Richard Gere|Stana Katic|Martin Sheen,Michael Brandt,98,Drama|Action|Thriller|Crime|Mystery,2011-10-27,133,5.9,2011,16479766,3583120,-12896646,6
3659,0.372627,930000,30905,-899095,L!fe Happens,Krysten Ritter|Kate Bosworth|Rachel Bilson|Geoff Stults|Justin Kirk,Kat Coiro,100,Comedy,2011-06-18,47,5.2,2011,901540,29959,-871581,5
3661,0.37054,13000000,114956699,101956699,The Iron Lady,Meryl Streep|Anthony Stewart Head|Harry Lloyd|Jim Broadbent|Susan Brown,Phyllida Lloyd,105,History|Drama,2011-12-30,333,6.2,2011,12602174,111438798,98836624,6
3664,0.548602,4000000,1104682,-2895318,Red State,Michael Parks|John Goodman|Melissa Leo|Michael Angarano|Kyle Gallner,Kevin Smith,88,Horror|Action|Thriller,2011-08-19,137,5.8,2011,3877592,1070876,-2806716,6
3666,0.363036,19100000,5728213,-13371787,The Devil's Double,Dominic Cooper|Ludivine Sagnier|Raad Rawi|Mehmet Ferda|Philip Quast,Lee Tamahori,109,Drama|Action|Thriller|Crime|War,2011-02-11,126,6.3,2011,18515502,5552918,-12962584,6
3674,0.352084,4000000,253899,-3746101,The Music Never Stopped,J.K. Simmons|Lou Taylor Pucci|Julia Ormond|Cara Seymour|MÃ­a Maestro,Jim Kohlberg,105,Drama,2011-03-18,31,7.3,2011,3877592,246129,-3631463,7
3680,0.339565,28000000,10126458,-17873542,Shark Night,Sara Paxton|Chris Carmack|Joel David Moore|Chris Zylka|Dustin Milligan,David R. Ellis,91,Horror|Thriller,2011-09-02,74,5.1,2011,27143145,9816568,-17326577,5
3685,0.567753,3000000,672648,-2327352,Hobo with a Shotgun,Rutger Hauer|Gregory Smith|Robb Wells|Brian Downey|Molly Dunsworth,Jason Eisener,86,Action|Comedy|Thriller,2011-05-06,84,5.8,2011,2908194,652063,-2256131,6
3686,0.334274,25000000,53213633,28213633,Madea's Big Happy Family,Tyler Perry|Lauren London|Shannon Kane|Cassi Davis|Philip Anthony-Rodriguez,Tyler Perry,106,Comedy|Drama,2011-04-22,45,6.9,2011,24234951,51585191,27350240,7
3691,0.318142,15000000,4627375,-10372625,Atlas Shrugged Part I,Taylor Schilling|Paul Johansson|Michael O'Keefe|Grant Bowler|Edi Gathegi,Paul Johansson,97,Drama|Thriller|Science Fiction|Mystery,2011-04-14,37,4.8,2011,14540970,4485768,-10055202,5
3698,0.307661,25000000,11790979,-13209021,This Must Be the Place,Sean Penn|Frances McDormand|Judd Hirsch|Eve Hewson|Kerry Condon,Paolo Sorrentino,118,Drama,2011-10-01,127,6.3,2011,24234951,11430151,-12804800,6
3717,0.283696,8000000,5634828,-2365172,Albert Nobbs,Glenn Close|Mia Wasikowska|Aaron Taylor-Johnson|Pauline Collins|Brendan Gleeson,Rodrigo GarcÃ­a,113,Drama,2011-12-21,68,6.1,2011,7755184,5462391,-2292793,6
3733,0.263908,134005,1332231,1198226,Snow Flower and the Secret Fan,Li Bingbing|Jun Ji-hyun|Hugh Jackman|Vivian Wu|Jiang Wu,Wayne Wang,104,History|Drama,2011-07-15,12,4.4,2011,129904,1291462,1161558,4
3752,0.244803,6000000,5206,-5994794,The Good Doctor,Orlando Bloom|Riley Keough|Taraji P. Henson|Rob Morrow|Michael PeÃ±a,Lance Daly,93,Drama|Thriller,2011-01-01,28,4.8,2011,5816388,5046,-5811342,5
3755,0.243777,8000,469947,461947,Weekend,Tom Cullen|Chris New|Jonathan Race|Laura Freeman|Loreto Murray,Andrew Haigh,96,Drama|Romance,2011-09-22,96,7.4,2011,7755,455565,447810,7
3758,0.198863,500000,171760,-328240,Kill List,Neil Maskell|MyAnna Buring|Harry Simpson|Michael Smiley|Struan Rodger,Ben Wheatley,95,Horror|Thriller|Crime,2011-09-02,88,5.9,2011,484699,166503,-318196,6
3766,0.226575,13000000,98441954,85441954,Justin Bieber: Never Say Never,Justin Bieber|Miley Cyrus|Usher Raymond|Jaden Smith|Sean Kingston,Jon M. Chu,105,Documentary|Music|Family,2011-02-11,90,5.3,2011,12602174,95429437,82827263,5
3785,0.195283,17000,101236,84236,Bellflower,Evan Glodell|Jessie Wiseman|Tyler Dawson|Rebekah Brandes|Vincent Grashaw,Evan Glodell,106,Action|Drama|Romance,2011-04-16,24,6.7,2011,16479,98137,81658,7
3786,0.193681,10000000,4417580,-5582420,"Jeff, Who Lives at Home",Jason Segel|Ed Helms|Susan Sarandon|Judy Greer|Rae Dawn Chong,Mark Duplass|Jay Duplass,83,Drama|Comedy,2011-09-13,138,5.9,2011,9693980,4282393,-5411587,6
3788,0.189663,3000000,22000,-2978000,The Divide,Lauren German|Michael Biehn|Milo Ventimiglia|Courtney B. Vance|Ashton Holmes,Xavier Gens,112,Science Fiction,2011-03-13,86,5.6,2011,2908194,21326,-2886868,6
3798,0.181427,45202,225861,180659,Life in a Day,Cindy Baer|Moica|Caryn Waechter|Drake Shannon,Kevin Macdonald|Zillah Bowes,95,Documentary|Drama,2011-01-27,58,7.3,2011,43818,218949,175131,7
3801,0.164515,160000000,344420111,184420111,X-Men: First Class,James McAvoy|Michael Fassbender|Jennifer Lawrence|Kevin Bacon|Rose Byrne,Matthew Vaughn,132,Action|Science Fiction|Adventure,2011-05-24,3651,7.0,2011,155103686,333880181,178776495,7
3818,0.331313,250000,1000000,750000,Louis C.K.: Live at the Beacon Theater,Louis C.K.,Louis C.K.,62,Comedy,2011-12-10,47,7.9,2011,242349,969398,727049,8
3832,0.135239,9000000,18663238,9663238,Glee: The Concert Movie,Dianna Agron|Lea Michele|Gwyneth Paltrow|Darren Criss|Chris Colfer,Kevin Tancharoen,84,Documentary|Music|Family,2011-08-11,54,6.3,2011,8724582,18092106,9367524,6
3853,0.098896,20,15,-5,William & Kate,Camilla Luddington|Nico Evers-Swindell|Samantha Whittaker|Jonathan Patrick Moore|Richard Reid,Mark Rosman,83,Drama|Romance,2011-04-18,18,5.9,2011,19,14,-5,6
3911,8.095275,79000000,926287400,847287400,The Lord of the Rings: The Two Towers,Elijah Wood|Ian McKellen|Viggo Mortensen|Liv Tyler|Orlando Bloom,Peter Jackson,179,Adventure|Fantasy|Action,2002-12-18,5114,7.8,2002,95768650,1122902454,1027133804,8
3912,6.012584,100000000,876688482,776688482,Harry Potter and the Chamber of Secrets,Daniel Radcliffe|Rupert Grint|Emma Watson|Kenneth Branagh|Richard Harris,Chris Columbus,161,Adventure|Fantasy|Family,2002-11-13,3458,7.2,2002,121226139,1062775600,941549461,7
3913,4.46751299999999,59000000,383257136,324257136,Ice Age,Ray Romano|John Leguizamo|Denis Leary|Goran Visnjic|Jack Black,Chris Wedge|Carlos Saldanha,81,Animation|Comedy|Family|Adventure,2002-03-10,2270,6.9,2002,71523422,464607829,393084407,7
3914,3.628943,60000000,214034224,154034224,The Bourne Identity,Matt Damon|Franka Potente|Chris Cooper|Clive Owen|Brian Cox,Doug Liman,119,Action|Drama|Mystery|Thriller,2002-06-14,2601,7.1,2002,72735683,259465426,186729743,7
3915,3.326646,33000000,102441078,69441078,Resident Evil,Milla Jovovich|Michelle Rodriguez|Eric Mabius|Ryan McCluskey|Oscar Pearce,Paul W.S. Anderson,100,Horror|Action|Science Fiction,2002-03-15,1265,6.3,2002,40004625,124185363,84180738,6
3916,3.241129,139000000,821708551,682708551,Spider-Man,Tobey Maguire|Willem Dafoe|Kirsten Dunst|James Franco|Cliff Robertson,Sam Raimi,121,Fantasy|Action,2002-05-01,3170,6.6,2002,168504333,996125553,827621220,7
3917,3.128314,120000000,649398328,529398328,Star Wars: Episode II - Attack of the Clones,Ewan McGregor|Natalie Portman|Hayden Christensen|Ian McDiarmid|Samuel L. Jackson,George Lucas,142,Adventure|Action|Science Fiction,2002-05-15,2549,6.4,2002,145471367,787240522,641769155,6
3918,2.973115,52000000,352114312,300114312,Catch Me If You Can,Leonardo DiCaprio|Tom Hanks|Christopher Walken|Martin Sheen|Amy Adams,Steven Spielberg,141,Drama|Crime,2002-12-25,2277,7.6,2002,63037592,426854586,363816994,8
3919,2.388226,140000000,441818803,301818803,Men in Black II,Tommy Lee Jones|Will Smith|Rip Torn|Lara Flynn Boyle|Johnny Knoxville,Barry Sonnenfeld,88,Action|Adventure|Comedy|Science Fiction,2002-07-03,1950,5.9,2002,169716595,535599877,365883282,6
3920,2.364204,35000000,120072577,85072577,The Pianist,Adrien Brody|Thomas Kretschmann|Frank Finlay|Maureen Lipman|Emilia Fox,Roman Polanski,150,Drama|War,2002-09-24,938,7.9,2002,42429148,145559349,103130201,8
3921,2.103595,102000000,358372926,256372926,Minority Report,Tom Cruise|Colin Farrell|Samantha Morton|Max von Sydow|Lois Smith,Steven Spielberg,145,Action|Thriller|Science Fiction|Mystery,2002-06-20,1595,6.9,2002,123650662,434441662,310791000,7
3922,2.095296,80000000,145771527,65771527,Lilo & Stitch,Chris Sanders|Daveigh Chase|Tia Carrere|David Ogden Stiers|Kevin McDonald,Dean DeBlois|Chris Sanders,85,Animation,2002-06-21,681,6.9,2002,96980911,176713194,79732283,7
3923,1.955546,21000000,43928932,22928932,The Transporter,Jason Statham|Shu Qi|FranÃ§ois BerlÃ©and|Matt Schulze|Ric Young,Louis Leterrier|Corey Yuen Kwai,92,Action|Crime|Thriller,2002-10-02,1119,6.5,2002,25457489,53253348,27795859,6
3924,1.936728,70000000,277448382,207448382,xXx,Vin Diesel|Asia Argento|Marton Csokas|Samuel L. Jackson|Michael Roof,Rob Cohen,124,Action,2002-08-09,849,5.7,2002,84858297,336339962,251481665,6
3925,1.936492,140000000,109578115,-30421885,Treasure Planet,Joseph Gordon-Levitt|David Hyde Pierce|Emma Thompson|Roscoe Lee Browne|Martin Short,Ron Clements|John Musker,95,Adventure|Animation|Family|Fantasy|Science Fiction,2002-11-26,545,7.0,2002,169716595,132837318,-36879277,7
3926,1.846196,140000000,431971116,291971116,Die Another Day,Pierce Brosnan|Halle Berry|Rosamund Pike|Rick Yune|Toby Stephens,Lee Tamahori,133,Adventure|Action|Thriller,2002-11-17,692,5.8,2002,169716595,523661907,353945312,6
3927,1.839408,5000000,82719885,77719885,28 Days Later...,Cillian Murphy|Naomie Harris|Noah Huntley|Christopher Dunne|Emma Hitching,Danny Boyle,113,Horror|Thriller|Science Fiction,2002-10-31,1015,6.9,2002,6061306,100278123,94216817,7
3928,1.809883,55000000,154906693,99906693,Maid in Manhattan,Jennifer Lopez|Ralph Fiennes|Natasha Richardson|Stanley Tucci|Tyler Posey,Wayne Wang,105,Comedy|Drama|Romance,2002-12-12,281,5.7,2002,66674376,187787403,121113027,6
3929,1.778527,54000000,155010032,101010032,Blade II,Wesley Snipes|Kris Kristofferson|Ron Perlman|Leonor Varela|Norman Reedus,Guillermo del Toro,117,Science Fiction|Horror|Action|Thriller,2002-03-22,961,6.1,2002,65462115,187912677,122450562,6
3930,1.75153,100000000,193772504,93772504,Gangs of New York,Leonardo DiCaprio|Daniel Day-Lewis|Cameron Diaz|Liam Neeson|Brendan Gleeson,Martin Scorsese,167,Drama|History|Crime,2002-12-14,1068,6.9,2002,121226139,234902925,113676786,7
3931,1.694723,48000000,196397415,148397415,Panic Room,Jodie Foster|Kristen Stewart|Forest Whitaker|Dwight Yoakam|Jared Leto,David Fincher,112,Crime|Drama|Thriller,2002-03-29,670,6.4,2002,58188546,238085004,179896458,6
3932,1.594587,120000000,169956806,49956806,Stuart Little 2,Michael J. Fox|Geena Davis|Hugh Laurie|Jonathan Lipnicki|Anna Hoelck,Rob Minkoff,78,Family|Adventure|Animation|Comedy,2002-07-19,366,5.4,2002,145471367,206032074,60560707,5
3933,1.568528,5000000,38275483,33275483,National Lampoonâ€™s Van Wilder,Ryan Reynolds|Tara Reid|Tim Matheson|Kal Penn|Simon Helberg,Walt Becker,92,Comedy|Romance,2002-03-29,684,5.9,2002,6061306,46399890,40338584,6
3934,1.558805,41000000,215000000,174000000,8 Mile,Eminem|Mekhi Phifer|Brittany Murphy|Kim Basinger|Michael Shannon,Curtis Hanson,110,Drama,2002-11-08,944,6.7,2002,49702717,260636199,210933482,7
3935,1.525009,50000000,171269535,121269535,Mr. Deeds,Adam Sandler|Winona Ryder|John Turturro|Allen Covert|Peter Gallagher,Steven Brill,96,Comedy|Romance,2002-06-28,379,5.7,2002,60613069,207623445,147010376,6
3936,1.496493,3500159,76578641,73078482,Bend It Like Beckham,Parminder Nagra|Keira Knightley|Jonathan Rhys Meyers|Anupam Kher|Shaheen Khan,Gurinder Chadha,112,Comedy|Drama|Romance,2002-04-11,309,6.0,2002,4243107,92833330,88590223,6
3938,1.486895,60000000,93354918,33354918,Two Weeks Notice,Sandra Bullock|Hugh Grant|Alicia Witt|Dana Ivey|Robert Klein,Marc Lawrence,101,Romance|Comedy,2002-12-19,263,5.8,2002,72735683,113170562,40434879,6
3939,1.381699,72000000,408247917,336247917,Signs,Mel Gibson|Joaquin Phoenix|Rory Culkin|Abigail Breslin|Cherry Jones,M. Night Shyamalan,106,Drama|Thriller|Science Fiction|Mystery,2002-08-02,905,6.3,2002,87282820,494903188,407620368,6
3940,1.359987,48000000,249348933,201348933,The Ring,Naomi Watts|Martin Henderson|David Dorfman|Brian Cox|Shannon Cochran,Gore Verbinski,115,Horror|Mystery|Thriller,2002-10-18,810,6.4,2002,58188546,302276085,244087539,6
3942,1.297822,11000000,41227069,30227069,A Walk to Remember,Mandy Moore|Shane West|Peter Coyote|Daryl Hannah|Lauren German,Adam Shankman,101,Drama|Family|Romance,2002-01-25,582,7.3,2002,13334875,49977984,36643109,7
3943,1.271588,5000000,368744044,363744044,My Big Fat Greek Wedding,Nia Vardalos|John Corbett|Lainie Kazan|Michael Constantine|Andrea Martin,Joel Zwick,95,Comedy|Drama|Romance,2002-02-22,395,6.1,2002,6061306,447014168,440952862,6
3944,1.263507,27000000,129000000,102000000,About a Boy,Hugh Grant|Nicholas Hoult|Toni Collette|Rachel Weisz|Sharon Small,Chris Weitz|Paul Weitz,101,Drama|Comedy|Romance,2002-04-26,361,6.4,2002,32731057,156381719,123650662,6
3946,1.216798,85000000,78382433,-6617567,Collateral Damage,Arnold Schwarzenegger|Francesca Neri|Elias Koteas|Cliff Curtis|John Turturro,Andrew Davis,108,Action|Thriller|Drama,2002-02-06,242,5.5,2002,103042218,95019997,-8022221,5
3947,1.20464,13000000,97837138,84837138,Phone Booth,Colin Farrell|Kiefer Sutherland|Forest Whitaker|Radha Mitchell|Katie Holmes,Joel Schumacher,81,Thriller|Drama,2002-09-09,529,6.5,2002,15759398,118604185,102844787,6
3948,1.204615,60000000,67312826,7312826,Star Trek: Nemesis,Patrick Stewart|Jonathan Frakes|LeVar Burton|Brent Spiner|Gates McFadden,Stuart Baird,117,Science Fiction|Action|Adventure|Thriller,2002-12-12,291,6.1,2002,72735683,81600740,8865057,6
3949,1.191235,20000000,5359645,-14640355,Equilibrium,Christian Bale|Taye Diggs|Emily Watson|Angus Macfadyen|Sean Bean,Kurt Wimmer,107,Action|Science Fiction|Thriller,2002-12-06,927,6.9,2002,24245227,6497290,-17747937,7
3950,1.182695,8000000,16856124,8856124,The Good Girl,Jennifer Aniston|Jake Gyllenhaal|Zooey Deschanel|John C. Reilly|Deborah Rush,Miguel Arteta,93,Drama|Comedy|Romance,2002-01-12,98,5.8,2002,9698091,20434028,10735937,6
3951,1.17681,25000000,108846072,83846072,The Hours,Nicole Kidman|Julianne Moore|Meryl Streep|Stephen Dillane|Miranda Richardson,Stephen Daldry,114,Drama,2002-12-27,216,6.7,2002,30306534,131949890,101643356,7
3952,1.165599,80000000,181001478,101001478,Road to Perdition,Tom Hanks|Tyler Hoechlin|Jennifer Jason Leigh|Liam Aiken|Paul Newman,Sam Mendes,117,Thriller|Crime|Drama,2002-07-12,614,7.1,2002,96980911,219421103,122440192,7
3953,1.15929,63000000,296633907,233633907,Austin Powers in Goldmember,Mike Myers|BeyoncÃ© Knowles|Seth Green|Michael York|Mindy Sterling,Jay Roach,94,Science Fiction|Comedy|Crime|Action,2002-07-26,557,5.9,2002,76372467,359597833,283225366,6
3954,1.118663,65000000,172855065,107855065,The Santa Clause 2,Tim Allen|Elizabeth Mitchell|David Krumholtz|Eric Lloyd|Spencer Breslin,Michael Lembeck,104,Fantasy|Comedy|Family,2002-10-31,174,5.4,2002,78796990,209545521,130748531,5
3955,1.11148799999999,46000000,113714830,67714830,Insomnia,Al Pacino|Robin Williams|Maura Tierney|Hilary Swank|Martin Donovan,Christopher Nolan,118,Crime|Mystery|Thriller,2002-05-24,564,6.6,2002,55764024,137852098,82088074,7
3956,1.090465,35000000,68349884,33349884,Ghost Ship,Gabriel Byrne|Julianna Margulies|Desmond Harrington|Ron Eldard|Isaiah Washington,Steve Beck,91,Horror|Mystery|Thriller,2002-10-25,265,5.2,2002,42429148,82857925,40428777,5
3957,1.06440499999999,84000000,275650703,191650703,Scooby-Doo,Freddie Prinze Jr.|Sarah Michelle Gellar|Matthew Lillard|Linda Cardellini|Rowan Atkinson,Raja Gosnell,88,Mystery|Adventure|Comedy,2002-06-14,401,5.3,2002,101829957,334160705,232330748,5
3959,1.04058799999999,80000000,122563539,42563539,Spirit: Stallion of the Cimarron,Matt Damon|James Cromwell|Daniel Studi|Chopper Bernet|Jeff LeBeau,Kelly Asbury|Lorna Cook,83,Western|Animation|Adventure|Comedy|Family,2002-05-24,402,7.1,2002,96980911,148579046,51598135,7
3960,1.039674,55000000,6416302,-48583698,D-Tox,Sylvester Stallone|Courtney B. Vance|Tom Berenger|Charles S. Dutton|Jeffrey Wright,Jim Gillespie,96,Action|Thriller,2002-01-04,60,5.8,2002,66674376,7778235,-58896141,6
3962,1.025158,60000000,165333180,105333180,The Scorpion King,Dwayne Johnson|Kelly Hu|Michael Clarke Duncan|Steven Brand|Bernard Hill,Chuck Russell,92,Action|Fantasy|Adventure,2002-04-16,420,5.2,2002,72735683,200427031,127691348,5
3963,1.011362,70000000,33561137,-36438863,I Spy,Eddie Murphy|Owen Wilson|Famke Janssen|Keith Dallas|Malcolm McDowell,Betty Thomas,97,Action|Adventure|Comedy|Thriller,2002-10-31,133,5.2,2002,84858297,40684870,-44173427,5
3964,1.005772,4000000,35564473,31564473,Bowling for Columbine,Michael Moore|George H. W. Bush|George W. Bush|Dick Clark|Charlton Heston,Michael Moore,120,Documentary,2002-10-09,235,7.2,2002,4849045,43113437,38264392,7
3965,1.005627,15000000,13060843,-1939157,25th Hour,Edward Norton|Philip Seymour Hoffman|Barry Pepper|Rosario Dawson|Anna Paquin,Spike Lee,135,Crime|Drama,2002-12-16,309,6.9,2002,18183920,15833155,-2350765,7
3966,0.9858,1300000,447741,-852259,Ken Park,James Ransone|Tiffany Limos|Maeve Quinlan|Amanda Plummer|Wade Williams,Larry Clark|Edward Lachman,97,Drama,2002-08-31,61,5.4,2002,1575939,542779,-1033160,5
3968,0.958182,68,193,125,The Sum of All Fears,Ben Affleck|Morgan Freeman|James Cromwell|Ken Jenkins|Liev Schreiber,Phil Alden Robinson,124,Thriller|Action|Drama,2002-05-31,256,5.7,2002,82,233,151,6
3970,0.936666,75000000,114660784,39660784,We Were Soldiers,Mel Gibson|Greg Kinnear|Madeleine Stowe|Sam Elliott|Chris Klein,Randall Wallace,138,Action|History|War,2002-03-01,332,6.5,2002,90919604,138998841,48079237,6
3971,0.925495,5000000,64282312,59282312,Jackass: The Movie,Johnny Knoxville|Bam Margera|Steve-O|Chris Pontius|Dave England,Jeff Tremaine,87,Comedy,2002-10-21,197,6.2,2002,6061306,77926965,71865659,6
3973,0.91537,12000000,56298474,44298474,Frida,Salma Hayek|Alfred Molina|MÃ­a Maestro|Patricia Reyes SpÃ­ndola|Diego Luna,Julie Taymor,123,Drama|Romance,2002-08-29,201,7.3,2002,14547136,68248466,53701330,7
3974,0.90146,50000000,56714147,6714147,Murder by Numbers,Sandra Bullock|Ben Chaplin|Ryan Gosling|Michael Pitt|Agnes Bruckner,Barbet Schroeder,120,Crime|Drama|Thriller,2002-04-19,141,6.1,2002,60613069,68752370,8139301,6
3975,0.898884,19000000,32801173,13801173,Adaptation.,Nicolas Cage|Meryl Streep|Chris Cooper|Tilda Swinton|Cara Seymour,Spike Jonze,114,Comedy|Crime|Drama,2002-12-06,319,7.2,2002,23032966,39763595,16730629,7
3976,0.895022999999999,30000000,180622424,150622424,Sweet Home Alabama,Reese Witherspoon|Josh Lucas|Patrick Dempsey|Candice Bergen|Rhona Mitra,Andy Tennant,108,Comedy|Romance,2002-09-26,224,6.0,2002,36367841,218961591,182593750,6
3977,0.880807,12000000,75781642,63781642,Barbershop,Ice Cube|Anthony Anderson|Cedric the Entertainer|Sean Patrick Thomas|Eve,Tim Story,102,Comedy|Drama,2002-04-01,75,6.2,2002,14547136,91867158,77320022,6
3978,0.8757,15000000,9237470,-5762530,Dark Blue,Kurt Russell|Scott Speedman|Michael Michele|Brendan Gleeson|Ving Rhames,Ron Shelton,118,Action|Crime|Drama|Thriller,2002-12-14,33,6.7,2002,18183920,11198228,-6985692,7
3979,0.875246999999999,80000000,123729176,43729176,The Time Machine,Guy Pearce|Samantha Mumba|Phyllida Law|Laura Kirk|Mark Addy,Simon Wells,96,Science Fiction|Adventure|Action,2002-03-04,341,5.6,2002,96980911,149992103,53011192,6
3980,0.872571999999999,20000000,12398628,-7601372,Undisputed,Wesley Snipes|Ving Rhames|Peter Falk|Michael Rooker|Jon Seda,Walter Hill,96,Action|Adventure|Drama|Thriller,2002-08-23,60,6.3,2002,24245227,15030378,-9214849,6
3981,0.821206,43000000,68696770,25696770,The Sweetest Thing,Cameron Diaz|Christina Applegate|Thomas Jane|Selma Blair|Jason Bateman,Roger Kumble,84,Romance|Comedy,2002-04-12,164,5.4,2002,52127239,83278442,31151203,5
3983,0.784565,115000000,77628265,-37371735,Windtalkers,Nicolas Cage|Adam Beach|Peter Stormare|Noah Emmerich|Mark Ruffalo,John Woo,134,Drama|Action|History|War,2002-06-14,207,5.9,2002,139410060,94105748,-45304312,6
3984,0.782771,36000000,102244770,66244770,John Q,Denzel Washington|Robert Duvall|Anne Heche|Kimberly Elise|Daniel E. Smith,Nick Cassavetes,116,Drama|Thriller|Crime,2002-02-15,317,7.1,2002,43641410,123947387,80305977,7
3988,0.76758,50000000,119137784,69137784,Unfaithful,Richard Gere|Diane Lane|Olivier Martinez|Erik Per Sullivan|Zeljko Ivanek,Adrian Lyne,124,Drama,2002-05-10,138,6.4,2002,60613069,144426136,83813067,6
3989,0.742412,45000000,94935764,49935764,Changing Lanes,Ben Affleck|Samuel L. Jackson|Kim Staunton|Toni Collette|Sydney Pollack,Roger Michell,89,Action|Adventure|Crime|Thriller,2002-04-07,169,5.7,2002,54551762,115086961,60535199,6
3990,0.74198,25000000,17000000,-8000000,Punch-Drunk Love,Adam Sandler|Emily Watson|Philip Seymour Hoffman|Luis GuzmÃ¡n|Mary Lynn Rajskub,Paul Thomas Anderson,95,Comedy|Drama|Romance,2002-10-25,268,6.9,2002,30306534,20608443,-9698091,7
3991,0.72233,100000000,35168966,-64831034,K-19: The Widowmaker,Harrison Ford|Liam Neeson|Peter Sarsgaard|Joss Ackland|John Shrapnel,Kathryn Bigelow,138,Thriller|Drama|History,2002-07-19,146,6.0,2002,121226139,42633979,-78592160,6
3995,0.698611,35000000,45479110,10479110,Queen of the Damned,Stuart Townsend|Aaliyah|Marguerite Moreau|Vincent PÃ©rez|Paul McGann,Michael Rymer,101,Drama|Fantasy|Horror,2002-02-10,117,5.2,2002,42429148,55132569,12703421,5
3996,0.683151,38000000,119723358,81723358,Spy Kids 2: Island of Lost Dreams,Antonio Banderas|Carla Gugino|Alexa PenaVega|Daryl Sabara|Steve Buscemi,Robert Rodriguez,100,Action|Adventure|Comedy|Family,2002-08-07,260,5.2,2002,46065932,145136004,99070072,5
3998,0.682409,38000000,51801187,13801187,Enough,Jennifer Lopez|Billy Campbell|Tessa Allen|Juliette Lewis|Dan Futterman,Michael Apted,114,Action|Drama|Thriller,2002-05-24,153,6.3,2002,46065932,62796579,16730647,6
3999,0.68142,20000000,33526835,13526835,Friday After Next,Ice Cube|Mike Epps|John Witherspoon|Don Curry|Anna Maria Horsford,Marcus Raboy,85,Comedy|Drama,2002-11-22,51,6.5,2002,24245227,40643287,16398060,6
4000,0.678896,20000000,109862682,89862682,Return to Never Land,Harriet Owen|Blayne Weaver|Jeff Bennett|Kath Soucie|Corey Burton,Robin Budd|Donovan Cook,72,Adventure|Fantasy|Animation|Family,2002-02-14,174,6.2,2002,24245227,133182287,108937060,6
4002,0.646373,40000000,16872671,-23127329,Life or Something Like It,Angelina Jolie|Edward Burns|Tony Shalhoub|Christian Kane|Melissa Errico,Stephen Herek,103,Comedy|Drama|Romance,2002-04-26,57,5.6,2002,48490455,20454087,-28036368,6
4003,0.645437,14000000,6413915,-7586085,Slackers,Jason Segel|Devon Sawa|Jason Schwartzman|Jaime King|Laura Prepon,Dewey Nicks,86,Comedy|Romance,2002-02-01,29,5.7,2002,16971659,7775341,-9196318,6
4006,0.608347,45000000,306776732,261776732,Chicago,Catherine Zeta-Jones|RenÃ©e Zellweger|Queen Latifah|Richard Gere|Christine Baranski,Rob Marshall,113,Action|Comedy|Crime|Drama|Music,2002-12-26,361,6.5,2002,54551762,371893588,317341826,6
4007,0.600563,12000000,52223306,40223306,One Hour Photo,Robin Williams|Connie Nielsen|Michael Vartan|Erin Daniels|Eriq La Salle,Mark Romanek,96,Horror|Thriller,2002-08-21,195,6.4,2002,14547136,63308297,48761161,6
4008,0.600189,35000000,16838910,-18161090,Femme Fatale,Rebecca Romijn|Antonio Banderas|Peter Coyote|Rie Rasmussen|Gregg Henry,Brian De Palma,114,Thriller|Crime|Romance,2002-11-06,63,6.1,2002,42429148,20413160,-22015988,6
4010,0.581487,40000000,22433915,-17566085,City By The Sea,Robert De Niro|James Franco|Frances McDormand|Eliza Dushku|George Dzundza,Michael Caton-Jones,108,Drama|Thriller|Mystery,2002-09-06,44,5.7,2002,48490455,27195769,-21294686,6
4013,0.573735999999999,60000000,43061982,-16938018,Reign of Fire,Christian Bale|Matthew McConaughey|Izabella Scorupco|Gerard Butler|Alexander Siddig,Rob Bowman,101,Action|Fantasy|Science Fiction|Thriller,2002-07-12,352,5.9,2002,72735683,52202378,-20533305,6
4014,0.570851,85000000,77741732,-7258268,Showtime,Robert De Niro|Rachael Harris|Eddie Murphy|Zaid Farid|William Shatner,Tom Dey,95,Action|Comedy,2002-03-14,148,5.2,2002,103042218,94243300,-8798918,5
4016,0.569956999999999,42000000,63781810,21781810,High Crimes,Ashley Judd|Morgan Freeman|Jim Caviezel|Amanda Peet|Adam Scott,Carl Franklin,115,Drama|Mystery|Thriller|Crime,2002-04-03,91,6.0,2002,50914978,77320225,26405247,6
4017,0.560535999999999,21000000,10011050,-10988950,Moonlight Mile,Jake Gyllenhaal|Dustin Hoffman|Susan Sarandon|Aleksia Landeau|Ellen Pompeo,Brad Silberling,117,Romance|Drama,2002-09-09,23,6.6,2002,25457489,12136009,-13321480,7
4018,0.558747,70000000,32287044,-37712956,Hart's War,Bruce Willis|Colin Farrell|Terrence Howard|Marcel IureÈ™|Cole Hauser,Gregory Hoblit,125,Drama|War,2002-02-15,138,5.7,2002,84858297,39140336,-45717961,6
4019,0.557277,30000000,105834556,75834556,About Schmidt,Jack Nicholson|Kathy Bates|Hope Davis|Dermot Mulroney|June Squibb,Alexander Payne,125,Drama|Comedy,2002-12-13,167,6.7,2002,36367841,128299146,91931305,7
4020,0.548844,25000000,51842679,26842679,Blue Crush,Kate Bosworth|Matthew Davis|Michelle Rodriguez|Sanoe Lake|Mika Boorem,John Stockwell,104,Adventure,2002-08-08,96,5.6,2002,30306534,62846878,32540344,6
4021,0.545906999999999,50000000,26199517,-23800483,Blood Work,Clint Eastwood|Jeff Daniels|Anjelica Huston|Wanda De Jesus|Tina Lifford,Clint Eastwood,110,Crime|Drama|Mystery|Thriller,2002-08-04,89,5.7,2002,60613069,31760662,-28852407,6
4022,0.54375,47000000,30002758,-16997242,Solaris,George Clooney|Natascha McElhone|Viola Davis|Jeremy Davies|Ulrich Tukur,Steven Soderbergh,99,Drama|Science Fiction|Mystery|Romance,2002-11-27,196,5.8,2002,56976285,36371185,-20605100,6
4024,0.534397,35000000,29882645,-5117355,The Four Feathers,Heath Ledger|Wes Bentley|Kate Hudson|Djimon Hounsou|Michael Sheen,Shekhar Kapur,132,War|Adventure|Drama|Romance,2002-09-08,81,6.4,2002,42429148,36225576,-6203572,6
4025,0.53098,30000000,27674124,-2325876,The Quiet American,Michael Caine|Brendan Fraser|Äá»— Thá»‹ Háº£i Yáº¿n|Tzi Ma|Rade Serbedzija,Phillip Noyce,101,Drama|Action|Thriller|Romance,2002-11-22,34,5.6,2002,36367841,33548272,-2819569,6
4029,0.5076,32000000,55157539,23157539,The Mothman Prophecies,Richard Gere|Laura Linney|Will Patton|Bob Tracey|Debra Messing,Mark Pellington,119,Drama|Mystery|Thriller|Horror,2002-01-25,135,5.9,2002,38792364,66865355,28072991,6
4032,0.49789,13500000,29027914,15527914,Far from Heaven,Julianne Moore|Dennis Quaid|Dennis Haysbert|Patricia Clarkson|Viola Davis,Todd Haynes,107,Drama|Romance,2002-09-01,57,6.4,2002,16365528,35189419,18823891,6
4033,0.494021,20000000,75597042,55597042,The Rookie,Dennis Quaid|Rachel Griffiths|Beth Grant|Angus T. Jones|Brian Cox,John Lee Hancock,127,Drama|Family,2002-03-25,42,6.0,2002,24245227,91643375,67398148,6
4034,0.485311,70000000,65977295,-4022705,Bad Company,Anthony Hopkins|Chris Rock|Peter Stormare|Gabriel Macht|Kerry Washington,Joel Schumacher,116,Action|Adventure|Comedy|Thriller,2002-06-07,121,5.5,2002,84858297,79981727,-4876570,5
4036,0.482312,30000000,33013805,3013805,Confessions of a Dangerous Mind,Sam Rockwell|Drew Barrymore|Julia Roberts|Rutger Hauer|Brad Pitt,George Clooney,113,Comedy|Crime|Drama|Romance|Thriller,2002-12-30,137,6.4,2002,36367841,40021361,3653520,6
4042,0.455247,70000000,19924033,-50075967,Ballistic: Ecks vs. Sever,Antonio Banderas|Lucy Liu|Gregg Henry|Ray Park|Talisa Soto,Wych Kaosayananda,91,Action|Adventure|Thriller,2002-09-20,35,4.8,2002,84858297,24153136,-60705161,5
4044,0.445162,30000000,6916869,-23083131,Trapped,Charlize Theron|Kevin Bacon|Courtney Love|Stuart Townsend|Dakota Fanning,Luis Mandoki,106,Action|Crime|Drama|Thriller,2002-09-20,72,5.8,2002,36367841,8385053,-27982788,6
4048,0.440499,26000000,38793283,12793283,Clockstoppers,Jesse Bradford|Paula GarcÃ©s|Robin Thomas|French Stewart|Michael Biehn,Jonathan Frakes,94,Adventure|Family|Science Fiction|Thriller,2002-03-17,47,4.5,2002,31518796,47027599,15508803,4
4049,0.431515,13000000,37664855,24664855,Halloween: Resurrection,Jamie Lee Curtis|Brad Loree|Busta Rhymes|Bianca Kajlich|Katee Sackhoff,Rick Rosenthal,94,Horror|Thriller,2002-07-01,106,4.6,2002,15759398,45659649,29900251,5
4050,0.427389,18000000,676698,-17323302,Salton Sea,Val Kilmer|Vincent D'Onofrio|Adam Goldberg|Luis GuzmÃ¡n|Doug Hutchison,D.J. Caruso,103,Drama|Mystery|Thriller,2002-01-01,35,6.8,2002,21820705,820334,-21000371,7
4053,0.416292,15000000,52970014,37970014,Big Fat Liar,Frankie Muniz|Paul Giamatti|Amanda Bynes|Amanda Detmer|Donald Faison,Shawn Levy,88,Comedy|Family,2002-02-08,95,5.7,2002,18183920,64213502,46029582,6
4055,0.400097,6500000,12633747,6133747,Narc,Jason Patric|Ray Liotta|Chi McBride|Busta Rhymes|Lloyd Adams,Joe Carnahan,105,Action|Crime|Drama|Thriller,2002-01-14,61,6.2,2002,7879699,15315403,7435704,6
4062,0.373221,8000000,27362712,19362712,Brown Sugar,Sanaa Lathan|Taye Diggs|Mos Def|Queen Latifah|Nicole Ari Parker,Rick Famuyiwa,109,Comedy|Romance,2002-10-05,23,7.2,2002,9698091,33170759,23472668,7
4065,0.364807,12500000,23367586,10867586,Antwone Fisher,Derek Luke|Malcolm David Kelley|Cory Hodges|Denzel Washington|Joy Bryant,Denzel Washington,120,Drama|Romance,2002-12-19,76,6.6,2002,15153267,28327622,13174355,7
4070,0.357389,9000000,4777465,-4222535,Igby Goes Down,Kieran Culkin|Claire Danes|Jeff Goldblum|Jared Harris|Amanda Peet,Burr Steers,97,Comedy|Drama,2002-09-13,40,6.5,2002,10910352,5791536,-5118816,6
4072,0.346921999999999,10000000,598645,-9401355,Swept Away,Madonna|Adriano Giannini|Bruce Greenwood|Elizabeth Banks|Michael Beattie,Guy Ritchie,89,Comedy|Romance,2002-10-11,26,4.7,2002,12122613,725714,-11396899,5
4074,0.346465,20000000,8586376,-11413624,Boat Trip,Cuba Gooding Jr.|Horatio Sanz|Roselyn SÃ¡nchez|Vivica A. Fox|Maurice Godin,Mort Nathan,94,Comedy,2002-10-01,64,4.5,2002,24245227,10408932,-13836295,4
4076,0.342912,500000,150277,-349723,May,Angela Bettis|Jeremy Sisto|Anna Faris|James Duval|Nichole Hiltz,Lucky McKee,93,Drama|Horror|Thriller|Romance,2002-01-13,52,5.9,2002,606130,182175,-423955,6
4077,0.462287,12000000,61141030,49141030,Crossroads,Britney Spears|Zoe Saldana|Taryn Manning|Anson Mount|Dan Aykroyd,Tamra Davis,93,Action|Adventure|Comedy|Drama|Family,2002-02-15,99,5.1,2002,14547136,74118910,59571774,5
4078,0.912373,100000000,7103973,-92896027,The Adventures of Pluto Nash,Eddie Murphy|Randy Quaid|Rosario Dawson|Joe Pantoliano|Jay Mohr,Ron Underwood,95,Action|Comedy|Science Fiction,2002-08-15,75,4.6,2002,121226139,8611872,-112614267,5
4080,0.246694,25000000,10719357,-14280643,Abandon,Katie Holmes|Benjamin Bratt|Charlie Hunnam|Zooey Deschanel|Fred Ward,Stephen Gaghan,99,Drama|Mystery|Thriller,2002-10-14,20,4.9,2002,30306534,12994662,-17311872,5
4087,0.299006,78000000,209196298,131196298,Red Dragon,Anthony Hopkins|Edward Norton|Ralph Fiennes|Harvey Keitel|Emily Watson,Brett Ratner,124,Crime|Thriller|Horror,2002-09-29,642,6.5,2002,94556388,253600595,159044207,6
4089,0.294923,29000000,16930185,-12069815,Serving Sara,Matthew Perry|Elizabeth Hurley|Vincent Pastore|Bruce Campbell|Cedric the Entertainer,Reginald Hudlin,100,Comedy|Romance,2002-08-20,44,5.1,2002,35155580,20523809,-14631771,5
4092,0.281325,60000000,52322400,-7677600,Dragonfly,Kevin Costner|Joe Morton|Ron Rifkin|Susanna Thompson|Kathy Bates,Tom Shadyac,104,Drama,2002-02-22,101,6.2,2002,72735683,63428425,-9307258,6
4094,0.278771,20000000,57588485,37588485,Drumline,Nick Cannon|Zoe Saldana|Orlando Jones|Leonard Roberts|GQ,Charles Stone III,118,Drama|Romance|Comedy|Music,2002-12-13,61,6.3,2002,24245227,69812297,45567070,6
4113,0.23421,14000000,25482931,11482931,All About the Benjamins,Ice Cube|Mike Epps|Tommy Flanagan|Carmen Chaplin|Eva Mendes,Kevin Bray,95,Action|Adventure|Comedy,2002-03-08,22,6.4,2002,16971659,30891973,13920314,6
4115,0.231392,40000000,18902015,-21097985,FearDotCom,Stephen Dorff|Natascha McElhone|Stephen Rea|Udo Kier|Amelia Curtis,William Malone,101,Horror|Thriller,2002-08-09,46,3.3,2002,48490455,22914183,-25576272,3
4119,0.22758,7000000,2062066,-4937934,Auto Focus,Greg Kinnear|Willem Dafoe|Rita Wilson|Maria Bello|Ron Leibman,Paul Schrader,104,Drama|Crime,2002-10-18,18,5.9,2002,8485829,2499763,-5986066,6
4120,0.225324,10000000,11411644,1411644,The Powerpuff Girls,Catherine Cavadini|Tara Strong|E.G. Daily|Tom Kane|Tom Kenny,Craig McCracken,73,Action|Family,2002-07-03,17,5.6,2002,12122613,13833895,1711282,6
4123,0.214587,25000000,10113733,-14886267,Possession,Gwyneth Paltrow|Aaron Eckhart|Jeremy Northam|Jennifer Ehle|Lena Headey,Neil LaBute,102,Drama|Mystery,2002-10-02,23,6.6,2002,30306534,12260488,-18046046,7
4128,0.192065,2000000,2506446,506446,Full Frontal,David Duchovny|Nicky Katt|Catherine Keener|Mary McCormack|David Hyde Pierce,Steven Soderbergh,96,Comedy|Drama|Romance,2002-08-02,12,4.7,2002,2424522,3038467,613945,5
4132,0.185041,40000000,8493890,-31506110,Big Trouble,Tim Allen|Rene Russo|Patrick Warburton|Ben Foster|Zooey Deschanel,Barry Sonnenfeld,85,Action|Comedy|Thriller,2002-04-05,35,6.2,2002,48490455,10296814,-38193641,6
4141,0.132296,25000000,41604473,16604473,Undercover Brother,Eddie Griffin|Chris Kattan|Denise Richards|Aunjanue Ellis|Chi McBride,Malcolm D. Lee,86,Action|Comedy,2002-05-31,46,5.4,2002,30306534,50435496,20128962,5
4157,0.111966,4000000,146402,-3853598,Los lunes al sol,Javier Bardem|Luis Tosar|Nieve de Medina|Enrique VillÃ©n|Celso Bugallo,Fernando LeÃ³n de Aranoa,113,Drama|Foreign,2002-09-27,16,6.5,2002,4849045,177477,-4671568,6
4176,0.017708,40000,1434436,1394436,The Kid Stays in the Picture,Robert Evans|Eddie Albert|Francis Ford Coppola|Catherine Deneuve,Nanette Burstein|Brett Morgen,93,Documentary,2002-01-18,10,7.4,2002,48490,1738911,1690421,7
4177,8.09375399999999,8000000,213928762,205928762,Pulp Fiction,John Travolta|Samuel L. Jackson|Uma Thurman|Bruce Willis|Ving Rhames,Quentin Tarantino,154,Thriller|Crime,1994-10-14,5343,8.1,1994,11768892,314713075,302944183,8
4178,7.192039,25000000,28341469,3341469,The Shawshank Redemption,Tim Robbins|Morgan Freeman|Bob Gunton|William Sadler|Clancy Brown,Frank Darabont,142,Drama|Crime,1994-09-10,5754,8.4,1994,36777789,41693462,4915673,8
4179,6.715966,55000000,677945399,622945399,Forrest Gump,Tom Hanks|Robin Wright|Gary Sinise|Mykelti Williamson|Sally Field,Robert Zemeckis,142,Comedy|Drama|Romance,1994-07-06,4856,8.1,1994,80911135,997333314,916422179,8
4180,4.78268799999999,45000000,788241776,743241776,The Lion King,Jonathan Taylor Thomas|Matthew Broderick|James Earl Jones|Jeremy Irons|Moira Kelly,Roger Allers|Rob Minkoff,89,Family|Animation|Drama,1994-06-23,3489,7.7,1994,66200020,1159591590,1093391570,8
4181,2.536898,30000000,350448145,320448145,Speed,Keanu Reeves|Sandra Bullock|Dennis Hopper|Jeff Daniels|Joe Morton,Jan de Bont,116,Action|Adventure|Crime|Thriller,1994-06-09,1012,6.6,1994,44133346,515548317,471414971,7
4182,2.360701,17000000,247275374,230275374,Dumb and Dumber,Jim Carrey|Jeff Daniels|Lauren Holly|Mike Starr|Karen Duffy,Peter Farrelly,107,Comedy,1994-12-16,1060,6.5,1994,25008896,363769661,338760765,6
4183,2.126863,30000000,51132598,21132598,The Naked Gun 33â…“: The Final Insult,Leslie Nielsen|Priscilla Presley|George Kennedy|O.J. Simpson|Fred Ward,Peter Segal,83,Comedy|Action|Crime,1994-03-18,228,6.1,1994,44133346,75221756,31088410,6
4184,2.06444,60000000,223664608,163664608,Interview with the Vampire,Brad Pitt|Tom Cruise|Kirsten Dunst|Antonio Banderas|Christian Slater,Neil Jordan,123,Horror|Romance,1994-11-11,829,7.0,1994,88266693,329035590,240768897,7
4186,1.843243,115000000,378882411,263882411,True Lies,Arnold Schwarzenegger|Jamie Lee Curtis|Tom Arnold|Bill Paxton|Tia Carrere,James Cameron,141,Action|Thriller,1994-07-14,620,6.6,1994,169177829,557378295,388200466,7
4187,1.627278,23000000,351583407,328583407,The Mask,Jim Carrey|Cameron Diaz|Nancy Fish|Tim Bagley|Johnny Williams,Chuck Russell,101,Romance|Comedy|Crime|Fantasy,1994-07-29,1307,6.5,1994,33835565,517218414,483382849,6
4189,1.364852,55000000,196567262,141567262,Stargate,Kurt Russell|James Spader|Jaye Davidson|Viveca Lindfors|Alexis Cruz,Roland Emmerich,121,Action|Adventure|Science Fiction,1994-10-28,648,6.7,1994,80911135,289172371,208261236,7
4190,1.353693,62000000,215887717,153887717,Clear and Present Danger,Harrison Ford|Willem Dafoe|Anne Archer|Joaquim de Almeida|Henry Czerny,Phillip Noyce,141,Action|Drama|Thriller,1994-08-03,204,6.1,1994,91208916,317594916,226386000,6
4191,1.309466,34000000,50282766,16282766,Natural Born Killers,Woody Harrelson|Juliette Lewis|Robert Downey Jr.|Tommy Lee Jones|Tom Sizemore,Oliver Stone,119,Crime|Thriller|Drama,1994-08-25,484,6.8,1994,50017793,73971558,23953765,7
4192,1.297355,27000,3151130,3124130,Clerks,Brian O'Halloran|Jeff Anderson|Jason Mewes|Kevin Smith|Lisa Spoonhauer,Kevin Smith,92,Comedy,1994-09-13,383,7.2,1994,39720,4635663,4595943,7
4193,1.267344,50000000,119208989,69208989,Beverly Hills Cop III,Eddie Murphy|Judge Reinhold|HÃ©ctor Elizondo|Gilbert R. Hill|Timothy Carhart,John Landis,104,Action|Comedy|Crime,1994-05-24,246,5.6,1994,73555578,175369721,101814143,6
4194,1.259399,22000000,189833357,167833357,The Santa Clause,Tim Allen|Judge Reinhold|Wendy Crewson|David Krumholtz|Peter Boyle,John Pasquin,97,Fantasy|Drama|Comedy|Family,1994-11-10,274,6.3,1994,32364454,279266046,246901592,6
4195,1.253496,30000000,160638883,130638883,Legends of the Fall,Brad Pitt|Anthony Hopkins|Aidan Quinn|Julia Ormond|Henry Thomas,Edward Zwick,133,Drama|Western|War|Romance,1994-12-16,380,7.1,1994,44133346,236317718,192184372,7
4197,1.23287099999999,6000000,254700832,248700832,Four Weddings and a Funeral,Hugh Grant|Andie MacDowell|James Fleet|Simon Callow|John Hannah,Mike Newell,117,Comedy|Drama|Romance,1994-03-09,319,6.5,1994,8826669,374693338,365866669,6
4200,1.022699,45000000,117615211,72615211,The Client,Susan Sarandon|Tommy Lee Jones|Mary-Louise Parker|Anthony LaPaglia|Bradley Whitford,Joel Schumacher,119,Drama|Thriller|Crime|Mystery,1994-07-20,130,6.2,1994,66200020,173025096,106825076,6
4201,0.983841,15000000,94000000,79000000,The Crow,Brandon Lee|Rochelle Davis|Ernie Hudson|Michael Wincott|Bai Ling,Alex Proyas,102,Fantasy|Action|Thriller,1994-05-11,505,7.2,1994,22066673,138284486,116217813,7
4203,0.954392,46000000,341631208,295631208,The Flintstones,John Goodman|Elizabeth Perkins|Rick Moranis|Rosie O'Donnell|Kyle MacLachlan,Brian Levant,91,Fantasy|Comedy|Family,1994-05-26,264,5.0,1994,67671131,502577619,434906488,5
4205,0.948788,38000000,120000000,82000000,Star Trek: Generations,Patrick Stewart|Jonathan Frakes|Brent Spiner|LeVar Burton|Michael Dorn,David Carson,118,Science Fiction|Action|Adventure|Thriller,1994-11-17,265,6.3,1994,55902239,176533387,120631148,6
4206,0.943815,15000000,107217396,92217396,Ace Ventura: Pet Detective,Jim Carrey|Sean Young|Courteney Cox|Tone Loc|Dan Marino,Tom Shadyac,86,Comedy|Mystery,1994-02-04,988,6.3,1994,22066673,157728750,135662077,6
4209,0.86712,55000000,214015089,159015089,Disclosure,Michael Douglas|Demi Moore|Donald Sutherland|Dylan Baker|Jacqueline Kim,Barry Levinson,123,Drama|Thriller|Crime|Mystery|Romance,1994-12-09,107,5.8,1994,80911135,314840071,233928936,6
4210,0.848554,60000000,37000000,-23000000,Junior,Arnold Schwarzenegger|Danny DeVito|Emma Thompson|Frank Langella|Pamela Reed,Ivan Reitman,109,Comedy|Romance|Science Fiction,1994-11-22,207,4.7,1994,88266693,54431127,-33835566,5
4211,0.848472999999999,14000000,18090181,4090181,New Nightmare,Heather Langenkamp|Robert Englund|Miko Hughes|Wes Craven|David Newsom,Wes Craven,112,Horror|Thriller|Mystery|Fantasy,1994-10-14,159,6.4,1994,20595561,26612674,6017113,6
4212,0.84317,25000000,48063435,23063435,The Shadow,Alec Baldwin|John Lone|Penelope Ann Miller|Peter Boyle|Ian McKellen,Russell Mulcahy,108,Adventure|Fantasy|Action|Thriller|Science Fiction,1994-07-01,81,5.3,1994,36777789,70706674,33928885,5
4213,0.834029,5000000,3049135,-1950865,Heavenly Creatures,Melanie Lynskey|Kate Winslet|Sarah Peirse|Simon O'Connor|Diana Kent,Peter Jackson,99,Drama|Fantasy,1994-09-02,149,6.6,1994,7355557,4485617,-2869940,7
4214,0.787327,35000000,9771658,-25228342,The Swan Princess,Michelle Nicastro|Howard McGillin|Jack Palance|John Cleese|Steven Wright,Richard Rich,90,Fantasy|Animation|Comedy|Family,1994-11-18,134,6.6,1994,51488904,14375199,-37113705,7
4215,0.77638,27000000,13670688,-13329312,The Pagemaster,Macaulay Culkin|Christopher Lloyd|Patrick Stewart|Whoopi Goldberg|Canan J. Howell,Pixote Hunt|Joe Johnston|Maurice Hunt,80,Fantasy|Science Fiction|Family|Animation,1994-11-23,91,6.5,1994,39720012,20111107,-19608905,6
4216,0.767191,12000000,15826984,3826984,The Next Karate Kid,Pat Morita|Hilary Swank|Michael Ironside|Constance Towers|Chris Conrad,Christopher Cain,107,Adventure,1994-07-18,90,4.8,1994,17653338,23283259,5629921,5
4219,0.736742,40000000,19726050,-20273950,Color of Night,Bruce Willis|Jane March|RubÃ©n Blades|Lesley Ann Warren|Scott Bakula,Richard Rush,121,Thriller|Drama|Romance|Mystery,1994-08-19,63,5.6,1994,58844462,29019220,-29825242,6
4220,0.729837,18000000,5887457,-12112543,Ed Wood,Johnny Depp|Martin Landau|Sarah Jessica Parker|Patricia Arquette|Jeffrey Jones,Tim Burton,127,Comedy|Drama|History,1994-09-27,326,7.1,1994,26480008,8661106,-17818902,7
4221,0.710052,27000000,101646581,74646581,Timecop,Jean-Claude Van Damme|Mia Sara|Ron Silver|Bruce McGill|Gloria Reuben,Peter Hyams,99,Thriller|Science Fiction|Action|Crime,1994-09-15,157,5.3,1994,39720012,149533460,109813448,5
4222,0.684636,63000000,25052000,-37948000,Wyatt Earp,Kevin Costner|Dennis Quaid|Gene Hackman|David Andrews|Linden Ashby,Lawrence Kasdan,191,Drama|Action|Western,1994-06-24,108,6.3,1994,92680028,36854286,-55825742,6
4227,0.629985,50000000,16478900,-33521100,Terminal Velocity,Charlie Sheen|Nastassja Kinski|James Gandolfini|Christopher McDonald|Brooke Langton,Deran Sarafian,102,Action|Thriller,1994-09-23,40,4.8,1994,73555578,24242300,-49313278,5
4229,0.614943999999999,3000000,15119639,12119639,Muriel's Wedding,Toni Collette|Bill Hunter|Rachel Griffiths|Sophie Lee|Roz Hammond,P.J. Hogan,106,Drama|Comedy|Romance,1994-09-29,47,6.5,1994,4413334,22242675,17829341,6
4230,0.607281,35000000,99423521,64423521,Street Fighter,Jean-Claude Van Damme|RaÃºl JuliÃ¡|Ming-Na Wen|Damian Chapa|Kylie Minogue,Steven E. de Souza,102,Action|Adventure|Thriller,1994-12-22,177,4.1,1994,51488904,146263091,94774187,4
4231,0.605753,45000000,170362582,125362582,The Specialist,Sylvester Stallone|Sharon Stone|James Woods|Rod Steiger|Eric Roberts,Luis Llosa,110,Action|Thriller,1994-10-07,162,5.5,1994,66200020,250622364,184422344,5
4233,0.590765,28000000,11373501,-16626499,Thumbelina,Jodi Benson|Gino Conforti|Barbara Cook|Gary Imhoff|Charo,Don Bluth|Gary Goldman,87,Animation|Drama|Family|Fantasy,1994-03-30,59,6.3,1994,41191123,16731688,-24459435,6
4234,0.590148999999999,26000000,36800000,10800000,Highlander III: The Sorcerer,Christopher Lambert|Mario Van Peebles|Deborah Kara Unger|Mako|Martin Neufeld,Andrew Morahan,99,Action|Fantasy|Science Fiction,1994-11-29,46,4.3,1994,38248900,54136905,15888005,4
4235,0.586306,50000000,49000000,-1000000,On Deadly Ground,Steven Seagal|Michael Caine|Joan Chen|John C. McGinley|R. Lee Ermey,Steven Seagal,102,Action|Thriller,1994-02-18,48,4.6,1994,73555578,72084466,-1471112,5
4240,0.564501,45000000,112006296,67006296,Frankenstein,Robert De Niro|Kenneth Branagh|Tom Hulce|Helena Bonham Carter|Aidan Quinn,Kenneth Branagh,123,Drama|Horror|Science Fiction|Romance,1994-11-04,120,5.8,1994,66200020,164773757,98573737,6
4241,0.563685,40000000,24332324,-15667676,Renaissance Man,Danny DeVito|Mark Wahlberg|Gregory Hines|James Remar|Ed Begley Jr.,Penny Marshall,128,Comedy|War,1994-06-03,43,5.7,1994,58844462,35795563,-23048899,6
4242,0.544269,10000000,29392418,19392418,A Low Down Dirty Shame,Keenen Ivory Wayans|Charles S. Dutton|Jada Pinkett Smith|Salli Richardson-Whitfield|Andrew Divoff,Keenen Ivory Wayans,100,Action|Comedy|Crime,1994-11-23,15,7.3,1994,14711115,43239525,28528410,7
4244,0.536193,15000000,11300653,-3699347,PrÃªt-Ã -Porter,Marcello Mastroianni|Sophia Loren|Jean-Pierre Cassel|Chiara Mastroianni|Kim Basinger,Robert Altman,133,Drama|Comedy,1994-12-23,16,6.0,1994,22066673,16624521,-5442152,6
4245,0.528782,26000000,8009329,-17990671,The Chase,Charlie Sheen|Kristy Swanson|Henry Rollins|Rocky Carroll|Ray Wise,Adam Rifkin,89,Comedy|Thriller|Action|Crime,1994-03-04,38,5.8,1994,38248900,11782616,-26466284,6
4247,0.509774,11500000,20079850,8579850,Reality Bites,Winona Ryder|Ethan Hawke|Ben Stiller|Janeane Garofalo|Steve Zahn,Ben Stiller,99,Drama,1994-02-18,90,6.5,1994,16917782,29539699,12621917,6
4251,0.48427,23000000,71368,-22928632,A Troll in Central Park,Dom DeLuise|Phillip Glasser|Tawny Sunshine Glover|Cloris Leachman|Hayley Mills,Don Bluth|Gary Goldman,76,Fantasy|Animation|Science Fiction|Family,1994-10-07,17,4.2,1994,33835565,104990,-33730575,4
4274,0.394187,700000,7830611,7130611,Hoop Dreams,William Gates|Arthur Agee|Steve James,Steve James,171,Documentary,1994-09-12,48,7.3,1994,1029778,11519702,10489924,7
4277,0.387981,3500000,2341309,-1158691,Double Dragon,Robert Patrick|Mark Dacascos|Scott Wolf|Kristina Wagner|Julia Nickson,James Yukich,89,Action|Adventure|Comedy|Science Fiction,1994-11-04,33,4.2,1994,5148890,3444326,-1704564,4
4285,0.255858,11000000,11439193,439193,The Ref,Denis Leary|Judy Davis|Kevin Spacey|Glynis Johns|Robert J. Steinmiller Jr.,Ted Demme,97,Comedy,1994-03-09,43,6.8,1994,16182227,16828329,646102,7
4291,0.331455,17080000,21011500,3931500,The Air Up There,Kevin Bacon|Charles Gitonga Maina|Yolanda Vazquez|Mabutho 'Kid' Sithole|Sean McCann,Paul Michael Glaser,107,Comedy|Family,1994-01-07,19,4.6,1994,25126585,30910260,5783675,5
4303,0.282609,25000000,22200000,-2800000,Don Juan DeMarco,Johnny Depp|Marlon Brando|Faye Dunaway|GÃ©raldine Pailhas|Bob Dishy,Jeremy Leven,97,Romance|Drama|Comedy,1994-10-01,88,6.2,1994,36777789,32658676,-4119113,6
4309,0.270267,2000000,2260622,260622,Leprechaun 2,Warwick Davis|Charlie Heath|Shevonne Durkin|Sandy Baron|Clint Howard,Rodman Flender,85,Comedy|Horror,1994-04-07,17,5.5,1994,2942223,3325627,383404,5
4312,0.251549,50000000,16671505,-33328495,Baby's Day Out,Joe Mantegna|Lara Flynn Boyle|Joe Pantoliano|Brian Haley|Cynthia Nixon,Patrick Read Johnson,99,Action|Adventure|Comedy|Family,1994-07-01,143,5.9,1994,73555578,24525643,-49029935,6
4313,0.246647,600000,185898,-414102,Texas Chainsaw Massacre: The Next Generation,RenÃ©e Zellweger|Matthew McConaughey|Robert Jacks|Tonie Perensky|Joe Stevens,Kim Henkel,95,Comedy|Horror|Thriller,1994-01-01,36,3.9,1994,882666,273476,-609190,4
4315,0.243921,7400000,7690013,290013,Surviving the Game,Ice-T|Rutger Hauer|Charles S. Dutton|Gary Busey|John C. McGinley,Ernest R. Dickerson,96,Action|Adventure|Thriller|Crime,1994-04-15,23,6.3,1994,10886225,11312867,426642,6
4318,0.416428,45000000,21355893,-23644107,Intersection,Richard Gere|Sharon Stone|Lolita Davidovich|Martin Landau|Jennifer Morrison,Mark Rydell,98,Drama|Romance,1994-01-21,24,4.6,1994,66200020,31416901,-34783119,5
4322,0.170254,13000000,7820688,-5179312,Serial Mom,Kathleen Turner|Sam Waterston|Ricki Lake|Matthew Lillard|Mink Stole,John Waters,95,Crime|Comedy|Thriller,1994-04-13,53,5.8,1994,19124450,11505104,-7619346,6
4341,0.129344,20000000,305070,-19694930,Rapa Nui,Jason Scott Lee|Esai Morales|Sandrine Holt|Eru Potaka-Dewes|Emilio Tuki Hito,Kevin Reynolds,107,Adventure,1994-09-09,16,6.2,1994,29422231,448792,-28973439,6
4352,0.094568,9000000,4350774,-4649226,PCU,Jeremy Piven|Chris Young|Megan Ward|Jon Favreau|David Spade,Hart Bochner,79,Comedy,1994-04-29,21,6.7,1994,13240004,6400473,-6839531,7
4361,7.637767,220000000,1519557910,1299557910,The Avengers,Robert Downey Jr.|Chris Evans|Mark Ruffalo|Chris Hemsworth|Scarlett Johansson,Joss Whedon,143,Science Fiction|Action|Adventure,2012-04-25,8903,7.3,2012,208943741,1443191435,1234247694,7
4362,7.031452,70000000,132400000,62400000,Underworld: Awakening,Kate Beckinsale|Stephen Rea|Michael Ealy|Theo James|India Eisley,MÃ¥ns MÃ¥rlind|BjÃ¶rn Stein,88,Fantasy|Action|Horror,2012-01-19,1426,6.0,2012,66482099,125746142,59264043,6
4363,6.591277,250000000,1081041287,831041287,The Dark Knight Rises,Christian Bale|Michael Caine|Gary Oldman|Anne Hathaway|Tom Hardy,Christopher Nolan,165,Action|Crime|Drama|Thriller,2012-07-16,6723,7.5,2012,237436070,1026712780,789276710,7
4364,5.944518,100000000,425368238,325368238,Django Unchained,Jamie Foxx|Christoph Waltz|Leonardo DiCaprio|Kerry Washington|Samuel L. Jackson,Quentin Tarantino,165,Drama|Western,2012-12-25,7375,7.7,2012,94974428,403991051,309016623,8
4365,5.603587,200000000,1108561013,908561013,Skyfall,Daniel Craig|Judi Dench|Javier Bardem|Ralph Fiennes|Naomie Harris,Sam Mendes,143,Action|Adventure|Thriller,2012-10-25,6137,6.8,2012,189948856,1052849482,862900626,7
4366,4.611854,130000000,276572938,146572938,The Bourne Legacy,Jeremy Renner|Rachel Weisz|Edward Norton|Scott Glenn|Stacy Keach,Tony Gilroy,120,Action|Thriller,2012-08-08,2086,5.9,2012,123466756,262673566,139206810,6
4367,4.218933,250000000,1017003568,767003568,The Hobbit: An Unexpected Journey,Ian McKellen|Martin Freeman|Richard Armitage|Andy Serkis|Cate Blanchett,Peter Jackson,169,Adventure|Fantasy|Action,2012-11-26,6417,6.9,2012,237436070,965893322,728457252,7
4368,4.008188,130000000,403170142,273170142,Prometheus,Noomi Rapace|Michael Fassbender|Charlize Theron|Idris Elba|Guy Pearce,Ridley Scott,124,Science Fiction|Adventure|Mystery,2012-05-30,3559,6.2,2012,123466756,382908536,259441780,6
4369,3.931139,21000000,205738714,184738714,Silver Linings Playbook,Bradley Cooper|Jennifer Lawrence|Robert De Niro|Jacki Weaver|Chris Tucker,David O. Russell,122,Drama|Comedy|Romance,2012-09-08,3317,6.9,2012,19944629,195399167,175454538,7
4370,3.702647,215000000,752215857,537215857,The Amazing Spider-Man,Andrew Garfield|Emma Stone|Rhys Ifans|Denis Leary|Martin Sheen,Marc Webb,136,Action|Adventure|Fantasy,2012-06-27,4837,6.4,2012,204195020,714412708,510217688,6
4371,3.626741,185000000,538983207,353983207,Brave,Kelly Macdonald|Julie Walters|Billy Connolly|Emma Thompson|Kevin McKidd,Mark Andrews|Steve Purcell|Brenda Chapman,93,Animation|Adventure|Comedy|Family|Action,2012-06-21,3206,6.6,2012,175702692,511896218,336193526,7
4372,3.335603,170000000,396600000,226600000,Snow White and the Huntsman,Kristen Stewart|Charlize Theron|Chris Hemsworth|Sam Claflin|Ian McShane,Rupert Sanders,127,Adventure|Fantasy|Drama,2012-05-30,2152,5.7,2012,161456527,376668581,215212054,6
4373,3.151021,42000000,201585328,159585328,21 Jump Street,Channing Tatum|Jonah Hill|Brie Larson|Dave Franco|Ellie Kemper,Phil Lord|Christopher Miller,109,Action|Comedy|Crime,2012-03-12,3015,6.7,2012,39889259,191454512,151565253,7
4374,3.14008,120000000,609016565,489016565,Life of Pi,Suraj Sharma|Irrfan Khan|Ayush Tandon|Gautam Belur|Adil Hussain,Ang Lee,127,Adventure|Drama|Action,2012-11-20,4338,7.1,2012,113969313,578409999,464440686,7
4375,3.135776,95000000,877244782,782244782,Ice Age: Continental Drift,John Leguizamo|Ray Romano|Chris Wedge|Denis Leary|Seann William Scott,Steve Martino|Mike Thurmeier,88,Animation|Comedy|Adventure|Family,2012-06-26,1920,6.2,2012,90225706,833158215,742932509,6
4376,2.990114,50000000,549368315,499368315,Ted,Mark Wahlberg|Mila Kunis|Seth MacFarlane|Joel McHale|Giovanni Ribisi,Seth MacFarlane,106,Comedy|Fantasy,2012-06-29,3199,6.4,2012,47487214,521759415,474272201,6
4377,2.944554,60000000,218340595,158340595,Jack Reacher,Tom Cruise|Rosamund Pike|Richard Jenkins|David Oyelowo|Werner Herzog,Christopher McQuarrie,130,Crime|Drama|Thriller,2012-12-20,2281,6.2,2012,56984656,207367731,150383075,6
4378,2.892625,42000000,180274123,138274123,Lo imposible,Naomi Watts|Ewan McGregor|Tom Holland|Samuel Joslin|Oaklee Pendergast,Juan Antonio Bayona,113,Drama,2012-09-09,1310,6.8,2012,39889259,171214317,131325058,7
4379,2.858742,165000000,471222889,306222889,Wreck-It Ralph,John C. Reilly|Sarah Silverman|Jane Lynch|Jack McBrayer|Jamie Elman,Rich Moore,108,Family|Animation|Comedy|Adventure,2012-11-01,3492,7.0,2012,156707806,447541244,290833438,7
4380,2.623143,17000000,115350426,98350426,Pitch Perfect,Anna Kendrick|Skylar Astin|Brittany Snow|Anna Camp|Rebel Wilson,Jason Moore,112,Comedy|Music|Romance,2012-09-28,1540,7.2,2012,16145652,109553407,93407755,7
4381,2.592896,225000000,624026776,399026776,Men in Black 3,Will Smith|Tommy Lee Jones|Josh Brolin|Michael Stuhlbarg|Emma Thompson,Barry Sonnenfeld,106,Action|Comedy|Science Fiction,2012-05-23,3142,6.1,2012,213692463,592665861,378973398,6
4382,2.571099,75000000,691210692,616210692,The Hunger Games,Jennifer Lawrence|Josh Hutcherson|Liam Hemsworth|Woody Harrelson|Elizabeth Banks,Gary Ross,142,Science Fiction|Adventure|Fantasy,2012-03-12,7080,6.7,2012,71230821,656473401,585242580,7
4383,2.570101,125000000,198802074,73802074,Total Recall,Colin Farrell|Kate Beckinsale|Jessica Biel|Bryan Cranston|Bill Nighy,Len Wiseman,121,Action|Science Fiction|Adventure|Thriller,2012-08-02,1872,5.8,2012,118718035,188811132,70093097,6
4384,2.478372,102000000,130482868,28482868,Cloud Atlas,Tom Hanks|Halle Berry|Jim Broadbent|Hugo Weaving|Jim Sturgess,Lilly Wachowski|Lana Wachowski|Tom Tykwer,172,Drama|Science Fiction,2012-10-26,2162,6.5,2012,96873916,123925357,27051441,6
4385,2.415046,100000000,312573423,212573423,The Expendables 2,Sylvester Stallone|Jason Statham|Dolph Lundgren|Bruce Willis|Arnold Schwarzenegger,Simon West,103,Action|Adventure|Thriller,2012-08-08,2218,6.0,2012,94974428,296864820,201890392,6
4386,2.406976,45000000,376141306,331141306,Taken 2,Liam Neeson|Maggie Grace|Famke Janssen|Rade Serbedzija|Luke Grimes,Olivier Megaton,91,Action|Thriller|Crime|Drama,2012-09-27,2051,6.0,2012,42738492,357238054,314499562,6
4387,2.092701,150000000,245527149,95527149,Dark Shadows,Johnny Depp|Michelle Pfeiffer|Helena Bonham Carter|Jackie Earle Haley|Jonny Lee Miller,Tim Burton,113,Comedy|Fantasy,2012-05-08,1434,5.6,2012,142461642,233188005,90726363,6
4388,2.046884,13000000,33400000,20400000,The Perks of Being a Wallflower,Logan Lerman|Emma Watson|Ezra Miller|Paul Rudd|Nina Dobrev,Stephen Chbosky,102,Drama|Romance,2012-09-20,1727,7.6,2012,12346675,31721458,19374783,8
4389,2.003232,44500000,232324128,187824128,Argo,Ben Affleck|Bryan Cranston|Alan Arkin|John Goodman|Victor Garber,Ben Affleck,120,Drama|Thriller,2012-10-11,2485,7.0,2012,42263620,220648511,178384891,7
4390,1.979531,50000000,234989584,184989584,American Reunion,Jason Biggs|Alyson Hannigan|Seann William Scott|Chris Klein|Thomas Ian Nicholas,Jon Hurwitz|Hayden Schlossberg,113,Comedy,2012-04-04,1180,6.0,2012,47487214,223180013,175692799,6
4391,1.974672,7000000,167221571,160221571,Magic Mike,Channing Tatum|Matthew McConaughey|Olivia Munn|Cody Horn|Alex Pettyfer,Steven Soderbergh,110,Drama|Comedy,2012-06-28,664,6.1,2012,6648209,158817730,152169521,6
4392,1.832955,30000000,66486080,36486080,The Cabin in the Woods,Kristen Connolly|Chris Hemsworth|Anna Hutchison|Fran Kranz|Jesse Williams,Drew Goddard,95,Horror|Thriller,2012-04-12,1403,6.5,2012,28492328,63144774,34652446,6
4393,1.832434,145000000,306941670,161941670,Rise of the Guardians,Chris Pine|Alec Baldwin|Jude Law|Isla Fisher|Hugh Jackman,Peter Ramsey,97,Fantasy|Animation|Family,2012-11-21,1272,6.9,2012,137712920,291516095,153803175,7
4394,1.821562,30000000,196114570,166114570,The Vow,Rachel McAdams|Channing Tatum|Sam Neill|Scott Speedman|Jessica Lange,Michael Sucsy,104,Drama|Romance,2012-02-05,861,6.9,2012,28492328,186258691,157766363,7
4395,1.814197,79000000,355692760,276692760,Journey 2: The Mysterious Island,Dwayne Johnson|Josh Hutcherson|Kristin Davis|Vanessa Hudgens|Luis GuzmÃ¡n,Brad Peyton,94,Adventure|Action|Science Fiction,2012-01-19,601,5.8,2012,75029798,337817164,262787366,6
4396,1.774202,12500000,1353868,-11146132,The Paperboy,Zac Efron|Matthew McConaughey|Nicole Kidman|John Cusack|David Oyelowo,Lee Daniels,107,Thriller,2012-09-14,150,5.4,2012,11871803,1285828,-10585975,5
4397,1.76105,30000000,40346186,10346186,Safe,Jason Statham|Chris Sarandon|James Hong|Catherine Chan|Robert John Burke,Boaz Yakin,94,Action|Crime|Thriller,2012-04-16,556,6.2,2012,28492328,38318559,9826231,6
4398,1.73616,69000000,112265139,43265139,Abraham Lincoln: Vampire Hunter,Benjamin Walker|Dominic Cooper|Anthony Mackie|Mary Elizabeth Winstead|Rufus Sewell,Timur Bekmambetov,94,Action|Horror|Fantasy,2012-06-20,872,5.5,2012,65532355,106623173,41090818,5
4399,1.690572,60000000,8106475,-51893525,Upside Down,Kirsten Dunst|Jim Sturgess|Timothy Spall|James Kidnie|Heidi Hawkins,Juan Diego Solanas,104,Romance|Science Fiction|Drama|Fantasy,2012-09-27,695,6.1,2012,56984656,7699078,-49285578,6
4401,1.682769,70000000,348840316,278840316,The Lorax,Zac Efron|Danny DeVito|Taylor Swift|Ed Helms|Rob Riggle,Chris Renaud|Kyle Balda,86,Animation|Family,2012-03-01,744,6.3,2012,66482099,331309095,264826996,6
4402,1.661091,16000000,68263166,52263166,Moonrise Kingdom,Bruce Willis|Edward Norton|Jared Gilman|Kara Hayward|Bill Murray,Wes Anderson,94,Comedy|Drama|Romance,2012-05-16,976,7.6,2012,15195908,64832551,49636643,8
4404,1.653924,50000000,41037742,-8962258,Dredd,Karl Urban|Olivia Thirlby|Lena Headey|Wood Harris|Jason Cope,Pete Travis,95,Action|Science Fiction,2012-09-07,1350,6.5,2012,47487214,38975360,-8511854,6
4405,1.630455,209000000,303025485,94025485,Battleship,Taylor Kitsch|Alexander SkarsgÃ¥rd|Rihanna|Brooklyn Decker|Tadanobu Asano,Peter Berg,131,Thriller|Action|Adventure|Science Fiction,2012-04-11,1523,5.5,2012,198496554,287796721,89300167,5
4409,1.608797,61000000,441809770,380809770,Les MisÃ©rables,Hugh Jackman|Russell Crowe|Anne Hathaway|Amanda Seyfried|Sacha Baron Cohen,Tom Hooper,157,Drama|Music|Romance,2012-12-18,1278,7.0,2012,57934401,419606302,361671901,7
4410,1.606999,85000000,183018522,98018522,Mirror Mirror,Julia Roberts|Lily Collins|Armie Hammer|Nathan Lane|Martin Klebba,Tarsem Singh,106,Adventure|Fantasy|Drama|Comedy|Science Fiction,2012-03-15,718,5.4,2012,80728263,173820794,93092531,5
4411,1.588457,260000000,284139100,24139100,John Carter,Taylor Kitsch|Lynn Collins|Mark Strong|Willem Dafoe|CiarÃ¡n Hinds,Andrew Stanton,132,Action|Adventure|Fantasy|Science Fiction,2012-03-07,1479,6.0,2012,246933513,269859485,22925972,6
4412,1.58709,30000000,47042000,17042000,Looper,Joseph Gordon-Levitt|Bruce Willis|Emily Blunt|Paul Dano|Noah Segan,Rian Johnson,118,Action|Thriller|Science Fiction,2012-09-26,3542,6.5,2012,28492328,44677870,16185542,6
4413,1.586368,120000000,829000000,709000000,The Twilight Saga: Breaking Dawn - Part 2,Kristen Stewart|Robert Pattinson|Taylor Lautner|Peter Facinelli|Elizabeth Reaser,Bill Condon,115,Adventure|Fantasy|Drama|Romance,2012-11-13,1668,6.1,2012,113969313,787338009,673368696,6
4414,1.554441,40000000,132820716,92820716,Zero Dark Thirty,Jessica Chastain|Jason Clarke|Mark Strong|Joel Edgerton|Chris Pratt,Kathryn Bigelow,157,Thriller|Drama|History,2012-12-19,1240,6.5,2012,37989771,126145715,88155944,6
4415,1.517201,23000000,33372606,10372606,Haywire,Gina Carano|Ewan McGregor|Michael Fassbender|Bill Paxton|Channing Tatum,Steven Soderbergh,93,Thriller,2012-01-18,339,5.5,2012,21844118,31695441,9851323,5
4416,1.507337,150000000,301000000,151000000,Wrath of the Titans,Sam Worthington|Liam Neeson|Ralph Fiennes|Rosamund Pike|Edgar RamÃ­rez,Jonathan Liebesman,99,Adventure,2012-03-27,1011,5.5,2012,142461642,285873028,143411386,5
4417,1.496861,33000000,140470746,107470746,Step Up Revolution,Kathryn McCormick|Ryan Guzman|Stephen Boss|Megan Boone|Jessica Guadix,Scott Speer,99,Music|Drama|Romance,2012-07-26,445,6.6,2012,31341561,133411287,102069726,7
4418,1.459325,15000000,145000000,130000000,Chronicle,Dane DeHaan|Alex Russell|Michael B. Jordan|Michael Kelly|Anna Wood,Josh Trank,84,Science Fiction|Drama|Thriller,2012-02-01,1165,6.5,2012,14246164,137712920,123466756,6
4419,1.436895,12000000,81272766,69272766,Act of Valor,Roselyn SÃ¡nchez|Emilio Rivera|Nestor Serrano|Gonzalo Menendez|Alexander Asefa,Mike McCoy|Scott Waugh,110,Action|Thriller|War,2012-02-24,328,6.3,2012,11396931,77188344,65791413,6
4420,1.418764,85000000,358375603,273375603,Hotel Transylvania,Adam Sandler|Steve Buscemi|David Spade|Kevin James|Selena Gomez,Genndy Tartakovsky,91,Animation|Comedy|Family|Fantasy,2012-09-20,1706,6.7,2012,80728263,340365179,259636916,7
4421,1.3743,3000000,77712439,74712439,Sinister,Ethan Hawke|Vincent D'Onofrio|James Ransone|Fred Dalton Thompson|Clare Foley,Scott Derrickson,110,Horror|Thriller|Mystery,2012-03-29,914,6.7,2012,2849232,73806944,70957712,7
4423,1.345091,7000000,48126384,41126384,End of Watch,Jake Gyllenhaal|Michael PeÃ±a|Natalie Martinez|Anna Kendrick|David Harbour,David Ayer,109,Crime|Drama|Thriller,2012-09-20,784,7.1,2012,6648209,45707757,39059548,7
4425,1.312488,65000000,275293450,210293450,Lincoln,Daniel Day-Lewis|Sally Field|David Strathairn|Joseph Gordon-Levitt|James Spader,Steven Spielberg,149,Drama|War,2012-11-09,993,6.6,2012,61733378,261458379,199725001,7
4426,1.306241,40000000,79700000,39700000,What to Expect When You're Expecting,Cameron Diaz|Jennifer Lopez|Elizabeth Banks|Anna Kendrick|Brooklyn Decker,Kirk Jones,110,Romance|Comedy|Drama,2012-05-17,389,5.7,2012,37989771,75694619,37704848,6
4427,1.291798,65000000,179379533,114379533,The Dictator,Sacha Baron Cohen|Sayed Badreya|Aasif Mandvi|Megan Fox|Anna Faris,Larry Charles,83,Comedy,2012-05-15,1159,5.9,2012,61733378,170364685,108631307,6
4428,1.272901,7500000,8135031,635031,Iron Sky,Julia Dietze|Christopher Kirby|GÃ¶tz Otto|Udo Kier|Stephanie Paul,Timo Vuorensola,93,Action|Comedy|Science Fiction,2012-03-10,343,5.5,2012,7123082,7726199,603117,5
4429,1.272721,25000000,99357138,74357138,The Lucky One,Zac Efron|Blythe Danner|Taylor Schilling|Jay R. Ferguson|Riley Thomas Stewart,Scott Hicks,101,Drama|Romance,2012-04-19,569,6.8,2012,23743607,94363873,70620266,7
4430,1.270174,12000000,100000000,88000000,Project X,Oliver Cooper|Jonathan Daniel Brown|Thomas Mann|Dax Flame|Kirby Bliss Blanton,Nima Nourizadeh,88,Comedy|Crime,2012-03-01,960,6.5,2012,11396931,94974428,83577497,6
4431,1.252392,25000000,63100000,38100000,Contraband,Mark Wahlberg|Kate Beckinsale|Ben Foster|Giovanni Ribisi|J.K. Simmons,Baltasar KormÃ¡kur,109,Thriller|Action|Drama|Crime,2012-01-12,549,6.1,2012,23743607,59928864,36185257,6
4433,1.204406,145000000,746921274,601921274,Madagascar 3: Europe's Most Wanted,Ben Stiller|Sacha Baron Cohen|David Schwimmer|Frances McDormand|Chris Rock,Eric Darnell|Tom McGrath|Conrad Vernon,93,Animation|Family,2012-06-06,1290,6.4,2012,137712920,709384208,571671288,6
4435,1.178045,26000000,53676580,27676580,Lawless,Shia LaBeouf|Tom Hardy|Guy Pearce|Jessica Chastain|Mia Wasikowska,John Hillcoat,115,Crime|Drama,2012-08-29,656,6.7,2012,24693351,50979024,26285673,7
4437,1.169815,26000000,29657751,3657751,The Raven,John Cusack|Luke Evans|Alice Eve|Brendan Gleeson|Kevin McNally,James McTeigue,111,Thriller,2012-03-09,224,6.0,2012,24693351,28167279,3473928,6
4438,1.161624,75000000,59418613,-15581387,Rock of Ages,Tom Cruise|Alec Baldwin|Diego Boneta|Julianne Hough|Bryan Cranston,Adam Shankman,123,Comedy|Drama|Music|Romance,2012-06-13,240,5.9,2012,71230821,56432487,-14798334,6
4439,1.157127,35000000,2106557,-32893443,Stolen,Nicolas Cage|Malin Ã…kerman|Josh Lucas|Sami Gayle|Danny Huston,Simon West,96,Action|Crime|Drama|Thriller,2012-05-17,233,5.1,2012,33241049,2000690,-31240359,5
4442,1.116305,68000000,68267862,267862,The Watch,Ben Stiller|Vince Vaughn|Jonah Hill|Richard Ayoade|Rosemarie DeWitt,Akiva Schaffer,98,Comedy,2012-07-26,584,5.3,2012,64582611,64837011,254400,5
4443,1.113113,60000000,118338361,58338361,The Pirates! In an Adventure with Scientists!,Hugh Grant|Brendan Gleeson|Jeremy Piven|Brian Blessed|Salma Hayek,Peter Lord|Jeff Newitt,88,Animation|Adventure|Family|Comedy,2012-03-12,262,6.4,2012,56984656,112391181,55406525,6
4444,1.106899,32000000,28258060,-3741940,The Master,Joaquin Phoenix|Philip Seymour Hoffman|Amy Adams|Laura Dern|Jesse Plemons,Paul Thomas Anderson,137,Drama,2012-09-07,387,6.8,2012,30391817,26837930,-3553887,7
4446,1.095479,30000000,53909751,23909751,The Five-Year Engagement,Emily Blunt|Alison Brie|Jason Segel|Rhys Ifans|Chris Pratt,Nicholas Stoller,124,Comedy,2012-04-27,319,5.6,2012,28492328,51200477,22708149,6
4447,1.09533899999999,35000000,88058786,53058786,This Is 40,Paul Rudd|Leslie Mann|Jason Segel|Maude Apatow|Megan Fox,Judd Apatow,134,Comedy,2012-12-20,693,5.5,2012,33241049,83633328,50392279,5
4448,1.068764,20000000,32204030,12204030,Lockout,Guy Pearce|Maggie Grace|Joseph Gilgun|Lennie James|Peter Stormare,Stephen St. Leger|James Mather,95,Action|Thriller|Science Fiction,2012-04-12,488,5.8,2012,18994885,30585593,11590708,6
4449,1.055188,35000000,24159934,-10840066,Wanderlust,Paul Rudd|Jennifer Aniston|Justin Theroux|Malin Ã…kerman|Lauren Ambrose,David Wain,98,Comedy,2012-02-24,250,5.2,2012,33241049,22945759,-10295290,5
4450,1.049943,17000000,127730736,110730736,The Woman in Black,Daniel Radcliffe|CiarÃ¡n Hinds|Sidney Johnston|Alisa Khazanova|Mary Stockley,James Watkins,95,Drama|Horror|Thriller,2012-02-01,695,6.1,2012,16145652,121311536,105165884,6
4451,1.046157,39000000,81491068,42491068,Frankenweenie,Charlie Tahan|Winona Ryder|Catherine O'Hara|Martin Short|Martin Landau,Tim Burton,87,Animation|Comedy|Family,2012-10-04,589,6.5,2012,37040026,77395675,40355649,6
4452,1.020104,70000000,58058367,-11941633,That's My Boy,Adam Sandler|Susan Sarandon|Eva Amurri Martino|Leighton Meester|Andy Samberg,Sean Anders,116,Comedy,2012-06-14,297,5.6,2012,66482099,55140602,-11341497,6
4453,1.01404,85000000,208076205,123076205,Safe House,Denzel Washington|Ryan Reynolds|Vera Farmiga|Joel Kinnaman|Brendan Gleeson,Daniel Espinosa,115,Action|Thriller|Crime|Mystery,2012-02-09,992,6.2,2012,80728263,197619185,116890922,6
4454,0.998625,45000000,47000000,2000000,Savages,Blake Lively|Taylor Kitsch|Aaron Taylor-Johnson|Benicio del Toro|Salma Hayek,Oliver Stone,131,Crime|Drama|Thriller,2012-07-06,516,6.2,2012,42738492,44637981,1899489,6
4456,0.988109,3730500,6294161,2563661,The Sweeney,Ray Winstone|Ben Drew|Hayley Atwell|Damian Lewis|Alan Ford,Nick Love,112,Action|Drama|Crime,2012-09-11,64,5.7,2012,3543021,5977843,2434822,6
4458,0.974459,31000000,161772375,130772375,Flight,Denzel Washington|Don Cheadle|Bruce Greenwood|Kelly Reilly|John Goodman,Robert Zemeckis,138,Drama,2012-11-02,1824,6.4,2012,29442072,153642388,124200316,6
4459,0.95865,42000000,46221189,4221189,Man on a Ledge,Sam Worthington|Elizabeth Banks|Jamie Bell|Ed Harris|Edward Burns,Asger Leth,102,Action|Thriller|Crime,2012-01-13,590,6.2,2012,39889259,43898309,4009050,6
4460,0.958518,15000000,19422261,4422261,Seven Psychopaths,Colin Farrell|Sam Rockwell|Christopher Walken|Woody Harrelson|Abbie Cornish,Martin McDonagh,110,Comedy|Crime|Thriller,2012-09-07,773,6.6,2012,14246164,18446181,4200017,7
4461,0.953111,40000000,24719215,-15280785,Big Miracle,Drew Barrymore|John Krasinski|Kristen Bell|Vinessa Shaw|Dermot Mulroney,Ken Kwapis,107,Adventure|Drama|Romance,2012-02-02,109,6.5,2012,37989771,23476933,-14512838,6
4462,0.948869,9000000,8303261,-696739,Bel Ami,Robert Pattinson|Christina Ricci|Uma Thurman|Kristin Scott Thomas|Natalia Tena,Nick Ormerod|Declan Donnellan,102,Drama,2012-03-09,93,5.1,2012,8547698,7885974,-661724,5
4464,0.913638,6000000,31081,-5968919,Maniac,Elijah Wood|America Olivo|Nora Arnezeder|Zoe Aggeliki|Jan Broberg,Franck Khalfoun,89,Horror|Crime|Mystery|Thriller,2012-12-26,189,5.8,2012,5698465,29519,-5668946,6
4465,0.903283,10000000,3428048,-6571952,Disconnect,Jason Bateman|Hope Davis|Frank Grillo|Paula Patton|Michael Nyqvist,Henry Alex Rubin,115,Drama|Thriller,2012-09-11,302,6.7,2012,9497442,3255768,-6241674,7
4466,0.901943,16000000,12434778,-3565222,People Like Us,Chris Pine|Elizabeth Banks|Olivia Wilde|Michelle Pfeiffer|Mark Duplass,Alex Kurtzman,114,Drama,2012-06-29,124,6.6,2012,15195908,11809859,-3386049,7
4467,0.892471999999999,5000000,8493728,3493728,Piranha 3DD,Danielle Panabaker|Matt Bush|Katrina Bowden|Jean-Luc Bilodeau|David Koechner,John Gulager,83,Horror|Thriller|Comedy,2012-05-11,176,4.2,2012,4748721,8066869,3318148,4
4469,0.862841,14000000,85446075,71446075,The Possession,Jeffrey Dean Morgan|Natasha Calis|Madison Davenport|Kyra Sedgwick|Rob LaBelle,Ole Bornedal,92,Horror|Thriller,2012-08-30,283,5.8,2012,13296419,81151921,67855502,6
4470,0.843148999999999,20000000,52302796,32302796,Silent Hill: Revelation 3D,Adelaide Clemens|Kit Harington|Sean Bean|Carrie-Anne Moss|Radha Mitchell,Michael J. Bassett,94,Thriller|Horror|Mystery,2012-10-10,262,5.1,2012,18994885,49674281,30679396,5
4471,0.836457,15000000,37930465,22930465,Killing Them Softly,Brad Pitt|Scoot McNairy|Ben Mendelsohn|James Gandolfini|Ray Liotta,Andrew Dominik,97,Crime|Thriller,2012-09-20,480,5.7,2012,14246164,36024242,21778078,6
4472,0.828573,20000000,16863583,-3136417,The Cold Light of Day,Henry Cavill|VerÃ³nica Echegui|Sigourney Weaver|Bruce Willis|Caroline Goodall,Mabrouk El Mechri,93,Action|Thriller,2012-04-04,193,4.8,2012,18994885,16016091,-2978794,5
4474,0.821987999999999,12000000,35485056,23485056,Arbitrage,Richard Gere|Susan Sarandon|Tim Roth|Brit Marling|Monica Raymund,Nicholas Jarecki,100,Drama|Thriller,2012-09-14,184,5.9,2012,11396931,33701729,22304798,6
4475,0.819110999999999,20000000,1969193,-18030807,The Iceman,Michael Shannon|Winona Ryder|Ray Liotta|Chris Evans|David Schwimmer,Ariel Vromen,105,Thriller|Crime|Drama,2012-09-01,218,6.4,2012,18994885,1870229,-17124656,6
4478,0.799589999999999,65000000,44806783,-20193217,Red Dawn,Chris Hemsworth|Josh Hutcherson|Isabel Lucas|Adrianne Palicki|Jeffrey Dean Morgan,Dan Bradley,93,War|Action|Thriller|Science Fiction,2012-11-21,404,5.3,2012,61733378,42554985,-19178393,5
4479,0.79128,14000000,13551174,-448826,Red Lights,Sigourney Weaver|Robert De Niro|Cillian Murphy|Elizabeth Olsen|Toby Jones,Rodrigo CortÃ©s,119,Thriller,2012-03-02,206,6.1,2012,13296419,12870150,-426269,6
4480,0.784114,30000000,54819301,24819301,The Three Stooges,Sean Hayes|Will Sasso|Chris Diamantopoulos|SofÃ­a Vergara|Jane Lynch,Bobby Farrelly|Peter Farrelly,92,Comedy,2012-04-13,82,4.9,2012,28492328,52064317,23571989,5
4481,0.777868999999999,30000000,114281051,84281051,Hope Springs,Meryl Streep|Steve Carell|Tommy Lee Jones|Jean Smart|Marin Ireland,David Frankel,100,Drama|Comedy|Romance,2012-08-07,192,5.6,2012,28492328,108537774,80045446,6
4484,0.767413,15000000,15608545,608545,The Man with the Iron Fists,Russell Crowe|Lucy Liu|Jamie Chung|RZA|Zhu Zhu,RZA,96,Action,2012-11-02,244,5.1,2012,14246164,14824126,577962,5
4488,0.736973,40000000,22044277,-17955723,A Thousand Words,Eddie Murphy|Allison Janney|Cliff Curtis|Clark Duke|Kerry Washington,Brian Robbins,91,Drama|Comedy,2012-03-07,230,5.8,2012,37989771,20936426,-17053345,6
4493,0.714232,17000000,73244881,56244881,To Rome with Love,Ellen Page|Woody Allen|Jesse Eisenberg|PenÃ©lope Cruz|Alec Baldwin,Woody Allen,111,Romance|Comedy,2012-04-20,298,5.5,2012,16145652,69563906,53418254,5
4495,0.704291,2500000,3003,-2496997,About Cherry,Ashley Hinshaw|James Franco|Heather Graham|Dev Patel|Lili Taylor,Stephen Elliott,102,Drama,2012-02-14,58,4.4,2012,2374360,2852,-2371508,4
4498,0.686877,45000000,30353232,-14646768,Alex Cross,Tyler Perry|Rachel Nichols|Jean Reno|Matthew Fox|Giancarlo Esposito,Rob Cohen,101,Action|Thriller|Crime|Mystery,2012-10-18,230,5.2,2012,42738492,28827808,-13910684,5
4499,0.672243,40000000,36893721,-3106279,One for the Money,Katherine Heigl|John Leguizamo|Debbie Reynolds|Sherri Shepherd|Patrick Fischler,Julie Anne Robinson,91,Action|Comedy|Thriller|Crime|Romance,2012-01-26,271,5.2,2012,37989771,35039600,-2950171,5
4500,0.668285,11000000,59520298,48520298,Quartet,Maggie Smith|Tom Courtenay|Billy Connolly|Pauline Collins|Michael Gambon,Dustin Hoffman,98,Drama|Comedy|Romance,2012-09-08,97,6.2,2012,10447187,56529062,46081875,6
4501,0.665792,26350000,1576687,-24773313,Lay the Favorite,Rebecca Hall|Bruce Willis|Catherine Zeta-Jones|Joshua Jackson|Vince Vaughn,Stephen Frears,94,Drama|Comedy,2012-06-22,46,4.9,2012,25025761,1497449,-23528312,5
4505,0.646413,60000000,107139399,47139399,ParaNorman,Kodi Smit-McPhee|Tucker Albrizzi|Jodelle Ferland|Anna Kendrick|Casey Affleck,Sam Fell|Chris Butler,90,Family|Animation|Adventure|Comedy,2012-08-03,549,6.6,2012,56984656,101755031,44770375,7
4506,0.644806,15000000,8138788,-6861212,Promised Land,Matt Damon|John Krasinski|Frances McDormand|Rosemarie DeWitt|Lucas Black,Gus Van Sant,106,Drama,2012-09-23,160,5.7,2012,14246164,7729767,-6516397,6
4507,0.63948,22000000,77112176,55112176,Diary of a Wimpy Kid: Dog Days,Devon Bostick|Steve Zahn|Peyton List|Rachael Harris|Zachary Gordon,David Bowers,94,Comedy|Family,2012-08-02,134,5.9,2012,20894374,73236848,52342474,6
4511,0.628612,12000000,9622846,-2377154,For Greater Glory - The True Story of Cristiada,Eva Longoria|Andy GarcÃ­a|Oscar Isaac|Peter O'Toole|RubÃ©n Blades,Dean Wright,145,Drama,2012-06-01,20,6.8,2012,11396931,9139242,-2257689,7
4512,0.627024,58000000,50365377,-7634623,Red Tails,Bryan Cranston|David Oyelowo|Cuba Gooding Jr.|Daniela Ruah|Terrence Howard,Anthony Hemingway,125,Drama|Action|Adventure|History|War,2012-01-19,125,6.1,2012,55085168,47834228,-7250940,6
4515,0.615971,14000000,11417362,-2582638,Fun Size,Victoria Justice|Jackson Nicoll|Chelsea Handler|Josh Pence|Jane Levy,Josh Schwartz,87,Comedy,2012-10-25,83,5.4,2012,13296419,10843574,-2452845,5
4517,0.612153,1500000,1165882,-334118,The Lords of Salem,Sheri Moon Zombie|Bruce Davison|Jeff Daniel Phillips|Judy Geeson|Meg Foster,Rob Zombie,101,Horror|Thriller,2012-09-10,120,4.7,2012,1424616,1107289,-317327,5
4519,0.607856,35000000,31083599,-3916401,Premium Rush,Joseph Gordon-Levitt|Michael Shannon|Dania Ramirez|Jamie Chung|WolÃ© Parks,David Koepp,91,Crime|Action|Thriller,2012-08-24,592,6.1,2012,33241049,29521470,-3719579,6
4520,0.604625,3000000,11947954,8947954,Bachelorette,Kirsten Dunst|Isla Fisher|Lizzy Caplan|James Marsden|Kyle Bornheimer,Leslye Headland,87,Comedy|Romance,2012-08-06,288,5.3,2012,2849232,11347500,8498268,5
4522,0.595210999999999,40000000,41863726,1863726,The Guilt Trip,Seth Rogen|Barbra Streisand|Yvonne Strahovski|Colin Hanks|Adam Scott,Anne Fletcher,95,Comedy,2012-12-19,210,5.3,2012,37989771,39759834,1770063,5
4524,0.591005,1000000,9138338,8138338,The Sessions,John Hawkes|Helen Hunt|William H. Macy|Moon Bloodgood|Annika Marks,Ben Lewin,98,Drama|Romance|Comedy,2012-05-02,102,6.3,2012,949744,8679084,7729340,6
4526,0.58808,10000000,9636289,-363711,Seeking a Friend for the End of the World,Steve Carell|Keira Knightley|Connie Britton|Adam Brody|Rob Corddry,Lorene Scafaria,101,Drama|Comedy|Romance|Science Fiction,2012-06-22,425,6.2,2012,9497442,9152010,-345432,6
4530,0.580776,6000000,13231461,7231461,The Words,Bradley Cooper|Zoe Saldana|Jeremy Irons|Dennis Quaid|Olivia Wilde,Brian Klugman|Lee Sternthal,96,Drama|Thriller,2012-09-07,234,6.3,2012,5698465,12566504,6868039,6
4534,0.557661,5000000,142817992,137817992,Paranormal Activity 4,Katie Featherston|Kathryn Newton|Matt Shively|Brady Allen|Sprague Grayden,Henry Joost|Ariel Schulman,95,Horror,2012-10-17,352,5.3,2012,4748721,135640571,130891850,5
4535,0.557044,13000000,18295,-12981705,Venuto al mondo,PenÃ©lope Cruz|Emile Hirsch|Adnan Haskovic|Pietro Castellitto|Saadet Isil Aksoy,Sergio Castellitto,127,Drama|Romance|War,2012-09-13,80,6.8,2012,12346675,17375,-12329300,7
4536,0.552288,25000000,8784318,-16215682,On the Road,Kristen Stewart|Garrett Hedlund|Sam Riley|Kirsten Dunst|Tom Sturridge,Walter Salles,137,Adventure|Drama,2012-05-22,205,5.6,2012,23743607,8342855,-15400752,6
4538,0.546482999999999,11500000,1402307,-10097693,Universal Soldier: Day of Reckoning,Jean-Claude Van Damme|Scott Adkins|Dolph Lundgren|Andrei Arlovski|Mariah Bonner,John Hyams,114,Thriller|Action|Science Fiction|Horror|Mystery,2012-10-04,79,5.1,2012,10922059,1331833,-9590226,5
4540,0.543868999999999,5600000,8139,-5591861,Dracula 3D,Thomas Kretschmann|Asia Argento|Rutger Hauer|Marta Gastini|Unax Ugalde,Dario Argento,109,Horror|Romance|Thriller,2012-01-29,22,3.3,2012,5318567,7729,-5310838,3
4550,0.518403,850000,1243961,393961,"For a Good Time, Call...",Ari Graynor|Lauren Miller|Mark Webber|Justin Long|Mimi Rogers,Jamie Travis,85,Comedy,2012-08-31,69,5.8,2012,807282,1181444,374162,6
4556,0.494391,25000000,119772232,94772232,Parental Guidance,Billy Crystal|Bette Midler|Marisa Tomei|Tom Everett Scott|Bailee Madison,Andy Fickman,104,Comedy,2012-12-25,154,5.9,2012,23743607,113752992,90009385,6
4560,0.491648,1000000,101758490,100758490,The Devil Inside,Fernanda Andrade|Simon Quarterman|Evan Helmuth|Ionut Grama|Suzan Crowley,William Brent Bell,83,Thriller|Horror,2012-01-06,162,4.5,2012,949744,96644543,95694799,4
4564,0.48576,25000000,432274,-24567726,Dark Tide,Halle Berry|Olivier Martinez|Ralph Brown|Mark Elderkin|Luke Tyler,John Stockwell,113,Thriller|Adventure|Drama,2012-03-28,37,4.9,2012,23743607,410549,-23333058,5
4571,0.473381,12000000,96070507,84070507,Think Like a Man,Michael Ealy|Jerry Ferrara|Meagan Good|Regina Hall|Kevin Hart,Tim Story,123,Comedy|Romance,2012-04-16,201,6.6,2012,11396931,91242414,79845483,7
4573,0.468552,2000000,14400000,12400000,Hit & Run,Kristen Bell|Dax Shepard|Tom Arnold|Kristin Chenoweth|Michael Rosenbaum,David Palmer|Dax Shepard,100,Action|Comedy|Romance,2012-08-22,175,5.4,2012,1899488,13676317,11776829,5
4581,0.452064,12000000,66351,-11933649,Deadfall,Eric Bana|Olivia Wilde|Charlie Hunnam|Patrick Kerton|Kris Kristofferson,Stefan Ruzowitzky,95,Crime|Drama|Thriller,2012-11-08,138,5.5,2012,11396931,63016,-11333915,5
4591,0.436617,3000000,3010,-2996990,ATM,Alice Eve|Josh Peck|Brian Geraghty|Aaron Hughes|Will Woytowich,David Brooks,90,Horror|Thriller,2012-02-17,105,5.5,2012,2849232,2858,-2846374,5
4594,0.430256,1800000,21107746,19307746,Beasts of the Southern Wild,QuvenzhanÃ© Wallis|Dwight Henry|Levy Easterly|Gina Montana|Lowell Landes,Benh Zeitlin,93,Drama|Fantasy,2012-06-29,262,6.6,2012,1709539,20046961,18337422,7
4603,0.409718,20000000,4636169,-15363831,Fire with Fire,Bruce Willis|Josh Duhamel|Rosario Dawson|Vincent D'Onofrio|50 Cent,David Barrett,97,Action|Crime|Drama|Thriller,2012-08-31,144,5.7,2012,18994885,4403174,-14591711,6
4604,0.40801,750000,4007792,3257792,Safety Not Guaranteed,Aubrey Plaza|Mark Duplass|Jake Johnson|Karan Soni|Jenica Bergere,Colin Trevorrow,85,Comedy|Romance|Science Fiction|Drama,2012-06-08,341,6.7,2012,712308,3806377,3094069,7
4611,0.402086,12000000,2521,-11997479,The Samaritan,Samuel L. Jackson|Luke Kirby|Ruth Negga|Tom Wilkinson|Alan C. Peterson,David Weaver,90,Thriller,2012-03-02,27,4.7,2012,11396931,2394,-11394537,5
4614,0.398497,17000000,9627492,-7372508,The Apparition,Ashley Greene|Sebastian Stan|Tom Felton|Julianna Guill|Luke Pasqualino,Todd Lincoln ,82,Horror|Thriller,2012-08-23,76,4.4,2012,16145652,9143655,-7001997,4
4624,0.383998,8000000,1653792,-6346208,2 Days in New York,Julie Delpy|Dylan Baker|Chris Rock|Albert Delpy|Vincent Gallo,Julie Delpy,91,Comedy,2012-03-28,60,5.3,2012,7597954,1570679,-6027275,5
4628,0.380291,2500000,3325038,825038,Robot & Frank,Frank Langella|Liv Tyler|James Marsden|Susan Sarandon|Peter Sarsgaard,Jake Schreier,85,Science Fiction|Comedy|Drama|Crime,2012-08-16,307,6.7,2012,2374360,3157935,783575,7
4635,0.359578,20500000,6063556,-14436444,Cosmopolis,Robert Pattinson|Sarah Gadon|Juliette Binoche|Paul Giamatti|Samantha Morton,David Cronenberg,109,Drama,2012-05-25,191,4.8,2012,19469757,5758827,-13710930,5
4668,0.321712,1500000,1938,-1498062,Best Man Down,Justin Long|Jess Weixler|Tyler Labine|Addison Timlin|Shelley Long,Ted Koland,90,Comedy|Drama,2012-10-20,39,5.9,2012,1424616,1840,-1422776,6
4675,0.316117,25,30,5,Joyful Noise,Queen Latifah|Dolly Parton|Keke Palmer|Kris Kristofferson|Courtney B. Vance,Todd Graff,117,Comedy|Music,2012-01-13,25,6.7,2012,23,28,5,7
4680,0.360699,6300000,419953,-5880047,Shadow Dancer,Andrea Riseborough|Clive Owen|Gillian Anderson|Aidan Gillen|Domhnall Gleeson,James Marsh,101,Thriller,2012-02-12,55,5.6,2012,5983388,398847,-5584541,6
4707,0.266025,500000,376597,-123403,Smashed,Mary Elizabeth Winstead|Aaron Paul|Octavia Spencer|Nick Offerman|Megan Mullally,James Ponsoldt,85,Drama,2012-09-12,52,6.1,2012,474872,357670,-117202,6
4715,0.260624,65000000,240159255,175159255,Resident Evil: Retribution,Milla Jovovich|Sienna Guillory|Michelle Rodriguez|Aryana Engineer|Li Bingbing,Paul W.S. Anderson,95,Action|Horror|Science Fiction,2012-09-12,1152,5.6,2012,61733378,228089879,166356501,6
4725,0.218221,300000,2750275,2450275,Oh Boy,Tom Schilling|Marc Hosemann|Friederike Kempter|Justus von DohnÃ¡nyi|Katharina SchÃ¼ttler,Jan Ole Gerster,88,Comedy|Drama,2012-07-03,73,7.1,2012,284923,2612057,2327134,7
4737,0.167892,5990000,19450000,13460000,Eega,Sudeep|Nani|Samantha Ruth Prabhu|Devadarshini|Thagubothu Ramesh,S.S. Rajamouli,145,Science Fiction|Romance,2012-06-06,19,6.6,2012,5688968,18472526,12783558,7
4776,0.308684,14000000,24637469,10637469,Sparkle,Whitney Houston|Cee Lo Green|Derek Luke|Mike Epps|Carmen Ejogo,Salim Akil,116,Drama|Music,2012-08-17,21,5.9,2012,13296419,23399295,10102876,6
4790,0.070285,2840000,11620000,8780000,English Vinglish,Sridevi Kapoor|Priya Anand|Mehdi Nebbou|Adil Hussain|Ajith Kumar,Gauri Shinde,133,Drama,2012-09-14,42,7.1,2012,2697273,11036028,8338755,7
4810,0.158309999999999,20000000,610792,-19389208,Not Fade Away,Bella Heathcote|Jack Huston|Dominique McElligott|Brad Garrett|Christopher McDonald,David Chase,112,Drama,2012-12-21,14,5.4,2012,18994885,580096,-18414789,5
4831,0.139047,500000,1000000,500000,Redd Inc.,Nicholas Hope|Kelly Paterniti|Sam Reid,Daniel Krige,93,Thriller|Horror|Comedy,2012-11-03,10,5.3,2012,474872,949744,474872,5
4842,0.128685,100000,95000,-5000,Stitches,Ross Noble|Tommy Knight|Gemma-Leah Devereux|John McDonnell,Conor McMahon,86,Horror,2012-05-19,45,5.2,2012,94974,90225,-4749,5
4859,0.111351,65000000,73706,-64926294,Foodfight!,Charlie Sheen|Wayne Brady|Hilary Duff|Eva Longoria|Christopher Lloyd,Lawrence Kasanoff,87,Animation|Action|Comedy|Family,2012-06-15,12,2.2,2012,61733378,70001,-61663377,2
4903,0.050524,12000000,32726956,20726956,Katy Perry: Part of Me,Katy Perry|Russell Brand|Shannon Woodward|Rachael Markarian|Mia Moretti,Dan Cutforth|Jane Lipsitz,93,Documentary|Music,2012-06-28,63,6.5,2012,11396931,31082239,19685308,6
4949,7.122455,94000000,1118888979,1024888979,The Lord of the Rings: The Return of the King,Elijah Wood|Ian McKellen|Viggo Mortensen|Liv Tyler|Orlando Bloom,Peter Jackson,201,Adventure|Fantasy|Action,2003-12-01,5636,7.9,2003,111423148,1326278010,1214854862,8
4950,6.887883,22000000,95708457,73708457,Underworld,Kate Beckinsale|Scott Speedman|Michael Sheen|Shane Brolly|Bill Nighy,Len Wiseman,121,Fantasy|Action|Thriller,2003-09-19,1708,6.5,2003,26077758,113448272,87370514,6
4951,6.864067,140000000,655011224,515011224,Pirates of the Caribbean: The Curse of the Black Pearl,Johnny Depp|Geoffrey Rush|Orlando Bloom|Keira Knightley|Jack Davenport,Gore Verbinski,143,Adventure|Fantasy|Action,2003-07-09,4223,7.3,2003,165949370,776419286,610469916,7
4952,6.174132,30000000,180949000,150949000,Kill Bill: Vol. 1,Uma Thurman|Lucy Liu|Vivica A. Fox|Daryl Hannah|David Carradine,Quentin Tarantino,111,Action|Crime,2003-10-10,2932,7.6,2003,35560579,214488375,178927796,8
4953,4.21265,150000000,424988211,274988211,The Matrix Revolutions,Keanu Reeves|Laurence Fishburne|Carrie-Anne Moss|Hugo Weaving|Mary Alice,Lilly Wachowski|Lana Wachowski,129,Adventure|Action|Thriller|Science Fiction,2003-11-05,2138,6.4,2003,177802896,503760899,325958003,6
4954,4.02924,150000000,738599701,588599701,The Matrix Reloaded,Keanu Reeves|Carrie-Anne Moss|Laurence Fishburne|Hugo Weaving|Helmut Bakaitis,Lilly Wachowski|Lana Wachowski,138,Adventure|Action|Thriller|Science Fiction,2003-05-15,2376,6.6,2003,177802896,875501109,697698213,7
4955,3.440519,94000000,864625978,770625978,Finding Nemo,Albert Brooks|Ellen DeGeneres|Alexander Gould|Willem Dafoe|Brad Garrett,Andrew Stanton|Lee Unkrich,100,Animation|Family,2003-05-30,3692,7.4,2003,111423148,1024886689,913463541,7
4956,2.899533,80000000,484572835,404572835,Bruce Almighty,Jim Carrey|Jennifer Aniston|Philip Baker Hall|Catherine Bell|Lisa Ann Walter,Tom Shadyac,101,Fantasy|Comedy,2003-05-23,1706,6.3,2003,94828211,574389691,479561480,6
4957,2.793616,40000000,244931766,204931766,Love Actually,Bill Nighy|Gregor Fisher|Colin Firth|Sienna Guillory|Liam Neeson,Richard Curtis,135,Comedy|Romance|Drama,2003-09-07,1251,6.9,2003,47414105,290330516,242916411,7
4958,2.710192,32000000,173398518,141398518,Elf,Will Ferrell|James Caan|Zooey Deschanel|Mary Steenburgen|Daniel Tay,Jon Favreau,97,Romance|Comedy|Family|Fantasy,2003-10-09,606,6.5,2003,37931284,205538391,167607107,6
4959,2.686888,200000000,435000000,235000000,Terminator 3: Rise of the Machines,Arnold Schwarzenegger|Nick Stahl|Claire Danes|Kristanna Loken|David Andrews,Jonathan Mostow,109,Action|Thriller|Science Fiction,2003-07-02,1314,5.8,2003,237070528,515628400,278557872,6
4960,2.643906,15000000,15121165,121165,The Dreamers,Michael Pitt|Eva Green|Louis Garrel|Anna Chancellor|Robin Renucci,Bernardo Bertolucci,115,Drama|Romance,2003-09-01,312,7.1,2003,17780289,17923912,143623,7
4961,2.491591,70000000,122919055,52919055,Big Fish,Ewan McGregor|Albert Finney|Billy Crudup|Jessica Lange|Helena Bonham Carter,Tim Burton,125,Adventure|Fantasy|Drama,2003-12-25,1091,7.4,2003,82974685,145702426,62727741,7
4962,2.394195,78000000,179179718,101179718,Daredevil,Ben Affleck|Jennifer Garner|Colin Farrell|Michael Clarke Duncan|Jon Favreau,Mark Steven Johnson,103,Fantasy|Action|Crime|Science Fiction|Thriller,2003-02-14,881,4.9,2003,92457506,212391152,119933646,5
4963,2.182292,55000000,231449203,176449203,American Wedding,Jason Biggs|Alyson Hannigan|Seann William Scott|Eddie Kaye Thomas|Thomas Ian Nicholas,Jesse Dylan,103,Comedy|Romance,2003-08-01,662,6.0,2003,65194395,274348924,209154529,6
4964,1.830211,78000000,179265204,101265204,The League of Extraordinary Gentlemen,Sean Connery|Peta Wilson|Shane West|Stuart Townsend|Jason Flemyng,Stephen Norrington,110,Fantasy|Action|Thriller|Science Fiction,2003-07-11,672,5.6,2003,92457506,212492483,120034977,6
4965,1.798132,60000000,176070171,116070171,The Italian Job,Mark Wahlberg|Charlize Theron|Jason Statham|Edward Norton|Fausto Callegarini,F. Gary Gray,111,Thriller|Action|Crime,2003-05-30,1295,6.6,2003,71121158,208705242,137584084,7
4966,1.781615,20000000,135680000,115680000,The Jungle Book 2,John Goodman|Haley Joel Osment|Mae Whitman|Phil Collins|Connor Funk,Steve Trenbirth,72,Family|Animation|Adventure,2003-02-07,156,5.6,2003,23707052,160828646,137121594,6
4967,1.765322,4000000,119723856,115723856,Lost in Translation,Bill Murray|Scarlett Johansson|Anna Faris|Giovanni Ribisi|Akiko Takeshita,Sofia Coppola,102,Drama,2003-08-31,1135,7.3,2003,4741410,141914989,137173579,7
4968,1.70302999999999,23000000,76488889,53488889,Bad Santa,Billy Bob Thornton|Tony Cox|Brett Kelly|Lauren Graham|Bernie Mac,Terry Zwigoff,91,Drama|Comedy|Crime,2003-11-25,353,6.2,2003,27263110,90666306,63403196,6
4969,1.661911,40000000,160583018,120583018,Johnny English,Rowan Atkinson|John Malkovich|Natalie Imbruglia|Tasha de Vasconcelos|Ben Miller,Peter Howitt,88,Adventure|Action|Comedy,2003-04-06,514,6.0,2003,47414105,190347505,142933400,6
4970,1.653031,100000000,250,-99999750,Brother Bear,Joaquin Phoenix|Jeremy Suarez|Rick Moranis|Joan Copeland|Michael Clarke Duncan,Aaron Blaise|Robert Walker,85,Animation|Adventure|Family|Fantasy,2003-10-20,753,6.8,2003,118535264,296,-118534968,7
4971,1.650018,100000000,121975011,21975011,Peter Pan,Jeremy Sumpter|Jason Isaacs|Rachel Hurd-Wood|Richard Briers|Olivia Williams,P.J. Hogan,113,Adventure|Fantasy|Family,2003-12-25,391,6.7,2003,118535264,144583401,26048137,7
4972,1.64806899999999,48000000,220673217,172673217,Scary Movie 3,Pamela Anderson|Jenny McCarthy|Marny Eng|Charlie Sheen|Simon Rex,David Zucker,84,Comedy,2003-10-24,466,5.6,2003,56896926,261575581,204678655,6
4973,1.635524,18000000,62646763,44646763,Honey,Jessica Alba|Mekhi Phifer|Joy Bryant|Romeo Miller|David Moscow,Bille Woodruff,94,Music,2003-11-24,156,6.0,2003,21336347,74258506,52922159,6
4974,1.626534,36000000,44350926,8350926,A Man Apart,Vin Diesel|Larenz Tate|Timothy Olyphant|Geno Silva|Jacqueline Obradors,F. Gary Gray,109,Action|Drama,2003-04-04,152,5.7,2003,42672695,52571487,9898792,6
4975,1.622704,35000000,131282949,96282949,The School of Rock,Jack Black|Joan Cusack|Mike White|Sarah Silverman|Adam Pascal,Richard Linklater,108,Comedy|Music,2003-10-03,767,6.6,2003,41487342,155616590,114129248,7
4976,1.622536,140000000,456758981,316758981,The Last Samurai,Tom Cruise|Ken Watanabe|William Atherton|Chad Lindberg|Billy Connolly,Edward Zwick,154,Drama|Action|War|History,2003-12-05,1093,7.1,2003,165949370,541420466,375471096,7
4977,1.615231,130000000,273339556,143339556,Bad Boys II,Martin Lawrence|Will Smith|Jordi MollÃ |Gabrielle Union|Peter Stormare,Michael Bay,147,Adventure|Action|Comedy|Thriller|Crime,2003-07-18,1041,6.3,2003,154095843,324003765,169907922,6
4978,1.569435,95000000,156505388,61505388,Lara Croft Tomb Raider: The Cradle of Life,Angelina Jolie|Gerard Butler|Noah Taylor|Djimon Hounsou|Til Schweiger,Jan de Bont,117,Action|Adventure|Fantasy|Thriller,2003-07-21,994,5.5,2003,112608501,185514075,72905574,5
4979,1.565393,12600000,28650575,16050575,Wrong Turn,Desmond Harrington|Eliza Dushku|Emmanuelle Chriqui|Jeremy Sisto|Kevin Zegers,Rob Schmidt,84,Horror|Thriller,2003-05-30,347,5.9,2003,14935443,33961034,19025591,6
4980,1.518131,30000000,90259536,60259536,Identity,John Cusack|Ray Liotta|Amanda Peet|John Hawkes|Alfred Molina,James Mangold,90,Mystery|Thriller,2003-04-25,549,7.0,2003,35560579,106989379,71428800,7
4981,1.491266,150000000,212011111,62011111,Master and Commander: The Far Side of the World,Russell Crowe|Paul Bettany|James D'Arcy|Billy Boyd|Joseph Morgan,Peter Weir,138,Adventure,2003-11-14,434,6.6,2003,177802896,251307931,73505035,7
4983,1.428302,25000000,156822020,131822020,Mystic River,Sean Penn|Tim Robbins|Kevin Bacon|Marcia Gay Harden|Kevin Chapman,Clint Eastwood,138,Thriller|Crime|Drama|Mystery,2003-10-07,743,7.4,2003,29633816,185889396,156255580,7
4985,1.412354,75000000,195745823,120745823,Anger Management,Adam Sandler|Jack Nicholson|Luis GuzmÃ¡n|Marisa Tomei|January Jones,Peter Segal,106,Comedy,2003-04-11,498,5.9,2003,88901448,232027828,143126380,6
4986,1.412067,60000000,74208267,14208267,The Core,Aaron Eckhart|Hilary Swank|Delroy Lindo|Stanley Tucci|TchÃ©ky Karyo,Jon Amiel,136,Action|Thriller|Adventure|Science Fiction,2003-03-28,278,5.3,2003,71121158,87962965,16841807,5
4987,1.387163,137000000,245360480,108360480,Hulk,Eric Bana|Jennifer Connelly|Sam Elliott|Josh Lucas|Nick Nolte,Ang Lee,138,Action|Science Fiction,2003-06-19,850,5.2,2003,162393312,290838693,128445381,5
4988,1.318505,29000000,98185582,69185582,Once Upon a Time in Mexico,Antonio Banderas|Salma Hayek|Johnny Depp|Eva Mendes|Mickey Rourke,Robert Rodriguez,102,Action,2003-09-11,320,6.1,2003,34375226,116384539,82009313,6
4990,1.280654,24000000,87055349,63055349,Old School,Luke Wilson|Will Ferrell|Vince Vaughn|Ellen Pompeo|Leah Remini,Todd Phillips,91,Comedy,2003-02-21,267,6.6,2003,28448463,103191288,74742825,7
4991,1.209598,50000000,177371441,127371441,How to Lose a Guy in 10 Days,Kate Hudson|Matthew McConaughey|Kathryn Hahn|Annie Parisse|Adam Goldberg,Donald Petrie,116,Comedy|Romance,2003-02-07,499,6.2,2003,59267632,210247706,150980074,6
4992,1.204207,50000000,88323487,38323487,Shanghai Knights,Jackie Chan|Owen Wilson|Fann Wong|Aaron Taylor-Johnson|Aidan Gillen,David Dobkin,115,Action|Adventure|Comedy|Western,2003-02-06,393,5.9,2003,59267632,104694478,45426846,6
4993,1.158663,80000000,116643346,36643346,S.W.A.T.,Samuel L. Jackson|Colin Farrell|Michelle Rodriguez|LL Cool J|Josh Charles,Clark Johnson,117,Action|Thriller|Crime,2003-08-08,499,5.8,2003,94828211,138263498,43435287,6
4994,1.125044,70000000,85632458,15632458,Tears of the Sun,Bruce Willis|Monica Bellucci|Cole Hauser|Eamonn Walker|Johnny Messner,Antoine Fuqua,121,Action|Drama|War,2003-03-07,349,6.4,2003,82974685,101504660,18529975,6
4995,1.118671,45000000,124914842,79914842,"Legally Blonde 2: Red, White & Blonde",Reese Witherspoon|Sally Field|Regina King|Jennifer Coolidge|James Newman,Charles Herman-Wurmfeld,95,Comedy,2003-07-02,235,5.2,2003,53340869,148068138,94727269,5
4998,1.096211,26000000,110230332,84230332,Freaky Friday,Jamie Lee Curtis|Lindsay Lohan|Mark Harmon|Harold Gould|Haley Hudson,Mark Waters,97,Comedy|Family|Fantasy,2003-08-03,473,6.0,2003,30819168,130661815,99842647,6
4999,1.072356,60000000,26288320,-33711680,Sinbad: Legend of the Seven Seas,Brad Pitt|Catherine Zeta-Jones|Michelle Pfeiffer|Joseph Fiennes|Dennis Haysbert,Tim Johnson|Patrick Gilmore,86,Family|Animation|Adventure,2003-07-02,196,6.3,2003,71121158,31160929,-39960229,6
5000,1.047214,80000000,19480739,-60519261,Timeline,Paul Walker|Frances O'Connor|Gerard Butler|Billy Connolly|David Thewlis,Richard Donner,116,Action|Adventure|Science Fiction,2003-11-26,176,5.1,2003,94828211,23091545,-71736666,5
5001,1.024891,60000000,96269812,36269812,Paycheck,Ben Affleck|Aaron Eckhart|Uma Thurman|Paul Giamatti|Colm Feore,John Woo,119,Action|Adventure|Mystery|Science Fiction|Thriller,2003-12-25,343,5.7,2003,71121158,114113676,42992518,6
5002,1.01154599999999,120000000,259175788,139175788,Charlie's Angels: Full Throttle,Cameron Diaz|Drew Barrymore|Lucy Liu|Bernie Mac|Robert Patrick,McG,106,Action|Adventure|Comedy|Crime,2003-06-27,592,5.3,2003,142242317,307214705,164972388,5
5003,1.005582,80000000,266728738,186728738,Something's Gotta Give,Jack Nicholson|Diane Keaton|Keanu Reeves|Frances McDormand|Amanda Peet,Nancy Meyers,128,Drama|Comedy|Romance,2003-12-12,236,6.2,2003,94828211,316167615,221339404,6
5004,1.004692,90000000,182290266,92290266,The Haunted Mansion,Eddie Murphy|Terence Stamp|Nathaniel Parker|Marsha Thomason|Jennifer Tilly,Rob Minkoff,99,Thriller|Fantasy|Comedy|Family|Mystery,2003-11-25,270,5.1,2003,106681738,216078248,109396510,5
5005,1.000194,40000000,19322135,-20677865,Duplex,Ben Stiller|Drew Barrymore|Eileen Essell|Amber Valletta|Justin Theroux,Danny DeVito,89,Action|Comedy|Thriller,2003-09-26,262,5.8,2003,47414105,22903543,-24510562,6
5006,0.997525,40000000,141591324,101591324,Gothika,Halle Berry|Robert Downey Jr.|Charles S. Dutton|PenÃ©lope Cruz|John Carroll Lynch,Mathieu Kassovitz,98,Horror|Thriller,2003-11-21,339,5.8,2003,47414105,167835650,120421545,6
5007,0.995361,20000000,60427839,40427839,21 Grams,Sean Penn|Naomi Watts|Benicio del Toro|Danny Huston|Carly Nahon,Alejandro GonzÃ¡lez IÃ±Ã¡rritu,124,Drama|Crime|Thriller,2003-09-06,520,7.0,2003,23707052,71628298,47921246,7
5008,0.981031,26000000,90426405,64426405,Final Destination 2,Ali Larter|A.J. Cook|Michael Landes|Tony Todd|Keegan Connor Tracy,David R. Ellis,90,Horror|Mystery,2003-01-31,519,5.9,2003,30819168,107187178,76368010,6
5010,0.920571,9500000,107071655,97571655,The Texas Chainsaw Massacre,Jessica Biel|Jonathan Tucker|Erica Leerhsen|Mike Vogel|Eric Balfour,Marcus Nispel,98,Horror,2003-10-17,333,6.0,2003,11260850,126917669,115656819,6
5012,0.876158,40000000,190212113,150212113,Cheaper by the Dozen,Steve Martin|Bonnie Hunt|Piper Perabo|Tom Welling|Hilary Duff,Shawn Levy,98,Comedy|Drama|Family,2003-12-24,357,5.8,2003,47414105,225468431,178054326,6
5013,0.875247999999999,79000000,173013509,94013509,Cold Mountain,Jude Law|Nicole Kidman|RenÃ©e Zellweger|Eileen Atkins|Brendan Gleeson,Anthony Minghella,154,Drama,2003-12-24,299,6.5,2003,93642858,205082020,111439162,6
5017,0.841686,2000000,4601043,2601043,Thirteen,Evan Rachel Wood|Nikki Reed|Vanessa Hudgens|Holly Hunter|Brady Corbet,Catherine Hardwicke,100,Drama,2003-08-20,153,6.6,2003,2370705,5453858,3083153,7
5018,0.820611,30000000,114908830,84908830,Freddy vs. Jason,Robert Englund|Ken Kirzinger|Jason Ritter|Monica Keena|Lochlyn Munro,Ronny Yu,97,Horror,2003-08-15,315,5.7,2003,35560579,136207485,100646906,6
5019,0.796421,25000000,56489558,31489558,Cradle 2 the Grave,Jet Li|DMX|Kelly Hu|Anthony Anderson|Tom Arnold,Andrzej Bartkowiak,101,Action|Crime|Drama,2003-02-28,133,5.9,2003,29633816,66960046,37326230,6
5021,0.783216,80000000,68514844,-11485156,Looney Tunes: Back in Action,Brendan Fraser|Jenna Elfman|Steve Martin|Timothy Dalton|Heather Locklear,Joe Dante,90,Animation|Comedy|Family,2003-11-14,144,5.5,2003,94828211,81214251,-13613960,5
5022,0.760656999999999,50000000,42792561,-7207439,Basic,John Travolta|Connie Nielsen|Samuel L. Jackson|Giovanni Ribisi|Tim Daly,John McTiernan,98,Action|Drama|Mystery|Thriller|Crime,2003-04-18,153,6.0,2003,59267632,50724275,-8543357,6
5023,0.754774,85000000,80916492,-4083508,The Rundown,"Dwayne Johnson|Seann William Scott|Rosario Dawson|Christopher Walken|Ernie Reyes, Jr.",Peter Berg,104,Adventure|Action|Comedy|Thriller,2003-09-26,298,6.3,2003,100754974,95914577,-4840397,6
5025,0.723225,76000000,236350661,160350661,2 Fast 2 Furious,Paul Walker|Tyrese Gibson|Eva Mendes|Cole Hauser|Ludacris,John Singleton,107,Action|Crime|Thriller,2003-06-05,1275,6.1,2003,90086801,280158881,190072080,6
5031,0.680802999999999,22000000,68296293,46296293,Open Range,Kevin Costner|Robert Duvall|Michael Gambon|Michael Jeter|Diego Luna,Kevin Costner,139,Western,2003-08-29,125,6.8,2003,26077758,80955191,54877433,7
5032,0.648946,18000000,101564935,83564935,Just Married,Ashton Kutcher|Brittany Murphy|Christian Kane|David Moscow|Alex Thomas,Shawn Levy,95,Comedy,2003-01-09,242,5.3,2003,21336347,120390264,99053917,5
5035,0.630566,60000000,164433867,104433867,Daddy Day Care,Eddie Murphy|Jeff Garlin|Steve Zahn|Regina King|Kevin Nealon,Steve Carr,92,Comedy|Family,2003-05-03,257,5.7,2003,71121158,194912119,123790961,6
5037,0.62007,87000000,148336445,61336445,Seabiscuit,Jeff Bridges|David McCullough|Chris Cooper|Tobey Maguire|Elizabeth Banks,Gary Ross,141,Drama|History,2003-07-22,109,6.4,2003,103125680,175830997,72705317,6
5038,0.6015,50000000,55495563,5495563,Out of Time,Denzel Washington|Eva Mendes|Sanaa Lathan|John Billingsley|Dean Cain,Carl Franklin,105,Thriller|Crime|Drama,2003-10-03,151,6.0,2003,59267632,65781812,6514180,6
5039,0.598372999999999,17000000,63102666,46102666,Jeepers Creepers 2,Ray Wise|Jonathan Breck|Garikayi Mutambirwa|Eric Nenninger|Josh Hammond,Victor Salva,104,Horror|Thriller,2003-08-08,123,5.4,2003,20150994,74798912,54647918,5
5040,0.595052,17000000,55534455,38534455,The Lizzie McGuire Movie,Hilary Duff|Adam Lamberg|Hallie Todd|Robert Carradine|Jake Thomas,Jim Fall,94,Comedy|Adventure|Family,2003-04-25,158,5.8,2003,20150994,65827913,45676919,6
5041,0.580909,68000000,75715436,7715436,Dreamcatcher,Morgan Freeman|Thomas Jane|Jason Lee|Damian Lewis|Timothy Olyphant,Lawrence Kasdan,136,Drama|Horror|Science Fiction|Thriller,2003-03-21,330,5.1,2003,80603979,89749492,9145513,5
5045,0.571314,38000000,197011982,159011982,Spy Kids 3-D: Game Over,Antonio Banderas|Carla Gugino|Alexa PenaVega|Daryl Sabara|Sylvester Stallone,Robert Rodriguez,84,Action|Adventure|Comedy|Family|Science Fiction,2003-07-25,281,4.8,2003,45043400,233528673,188485273,5
5046,0.563401,35000000,20298207,-14701793,Down with Love,RenÃ©e Zellweger|Ewan McGregor|Sarah Paulson|David Hyde Pierce|Rachel Dratch,Peyton Reed,101,Action|Comedy|Romance|Thriller,2003-05-08,107,6.0,2003,41487342,24060533,-17426809,6
5047,0.556095,35000000,11560806,-23439194,The Order,Heath Ledger|Shannyn Sossamon|Benno FÃ¼rmann|Mark Addy|Peter Weller,Brian Helgeland,102,Drama|Fantasy|Horror|Mystery|Romance,2003-09-05,42,4.8,2003,41487342,13703631,-27783711,5
5048,0.548852999999999,60000000,119940815,59940815,Intolerable Cruelty,George Clooney|Catherine Zeta-Jones|Edward Herrmann|Geoffrey Rush|Richard Jenkins,Joel Coen,100,Crime|Comedy|Romance,2003-09-02,201,5.7,2003,71121158,142172162,71051004,6
5049,0.543482999999999,55000000,34234008,-20765992,The Hunted,Tommy Lee Jones|Benicio del Toro|Connie Nielsen|Leslie Stefanson|John Finn,William Friedkin,94,Drama|Action|Thriller|Crime,2003-03-11,90,5.8,2003,65194395,40579371,-24615024,6
5050,0.537976,16500000,16942795,442795,House of Sand and Fog,Jennifer Connelly|Ben Kingsley|Ron Eldard|Frances Fisher|Kim Dickens,Vadim Perelman,126,Drama,2003-12-19,76,6.5,2003,19558318,20083186,524868,6
5054,0.505814,1500000,30553394,29053394,Cabin Fever,Rider Strong|Jordan Ladd|James DeBello|Cerina Vincent|Joey Kern,Eli Roth,93,Horror,2003-08-15,142,5.3,2003,1778028,36216546,34438518,5
5055,0.500124,60000000,80154140,20154140,Runaway Jury,John Cusack|Gene Hackman|Dustin Hoffman|Rachel Weisz|Bruce McGill,Gary Fleder,127,Drama|Thriller,2003-10-09,180,6.8,2003,71121158,95010921,23889763,7
5059,0.490565,8000000,60378584,52378584,Monster,Charlize Theron|Christina Ricci|Bruce Dern|Lee Tergesen|Annie Corley,Patty Jenkins,110,Crime|Drama,2003-11-16,216,6.8,2003,9482821,71569914,62087093,7
5060,0.481708,12000000,23,-11999977,In the Cut,Meg Ryan|Mark Ruffalo|Jennifer Jason Leigh|Nick Damici|Heather Litteer,Jane Campion,119,Thriller|Mystery,2003-09-09,36,4.7,2003,14224231,27,-14224204,5
5062,0.476487,20000000,132675402,112675402,Bringing Down The House,Steve Martin|Queen Latifah|Eugene Levy|Joan Plowright|Jean Smart,Adam Shankman,105,Comedy,2003-03-07,85,5.3,2003,23707052,157267138,133560086,5
5064,0.470814,54000000,7266209,-46733791,Gigli,Ben Affleck|Jennifer Lopez|Justin Bartha|Lainie Kazan|Lenny Venito,Martin Brest,121,Drama,2003-08-01,48,3.8,2003,64009042,8613020,-55396022,4
5065,0.469518,56000000,12923936,-43076064,Gods and Generals,Stephen Lang|Jeff Daniels|Robert Duvall|Kevin Conway|C. Thomas Howell,Ronald F. Maxwell,214,Drama|History|War,2003-02-21,23,5.8,2003,66379748,15319421,-51060327,6
5067,0.462609,6000000,2,-5999998,Shattered Glass,Hayden Christensen|Peter Sarsgaard|ChloÃ« Sevigny|Rosario Dawson|Melanie Lynskey,Billy Ray,94,Drama|History,2003-11-14,46,6.4,2003,7112115,2,-7112113,6
5068,0.460673,19000000,39267515,20267515,Dumb and Dumberer: When Harry Met Lloyd,Mimi Rogers|Eric Christian Olsen|Luis GuzmÃ¡n|Rachel Nichols|Eugene Levy,Troy Miller,85,Comedy,2003-06-13,110,4.2,2003,22521700,46545852,24024152,4
5075,0.439958,20000000,37095657,17095657,Uptown Girls,Brittany Murphy|Dakota Fanning|Marley Shelton|Donald Faison|Jesse Spencer,Boaz Yakin,92,Comedy,2003-08-15,108,6.2,2003,23707052,43971435,20264383,6
5076,0.438475,5000000,742898,-4257102,Party Monster,Seth Green|Macaulay Culkin|ChloÃ« Sevigny|Diana Scarwid|Marilyn Manson,Fenton Bailey|Randy Barbato,98,Comedy|Drama|Crime,2003-09-05,25,5.6,2003,5926763,880596,-5046167,6
5078,0.431188,50000000,38955598,-11044402,The Life of David Gale,Kevin Spacey|Kate Winslet|Laura Linney|Gabriel Mann|Rhona Mitra,Alan Parker,130,Drama|Thriller|Crime,2003-02-21,246,7.2,2003,59267632,46176121,-13091511,7
5080,0.426977,3000000,10012022,7012022,Elephant,Alex Frost|Eric Deulen|John Robinson|Elias McConnell|Jordan Taylor,Gus Van Sant,81,Drama|Crime,2003-05-18,186,7.1,2003,3556057,11867776,8311719,7
5082,0.422393,7000000,13818181,6818181,House of the Dead,Jonathan Cherry|Tyron Leitso|Clint Howard|Ona Grauer|Michael Eklund,Uwe Boll,90,Horror|Action|Thriller,2003-04-11,35,3.4,2003,8297468,16379417,8081949,3
5083,0.421807,8000000,41400000,33400000,Whale Rider,Keisha Castle-Hughes|Rawiri Paratene|Vicky Haughton|Cliff Curtis|Grant Roa,Niki Caro,101,Drama|Family,2003-01-30,46,6.7,2003,9482821,49073599,39590778,7
5087,0.407552,7000000,16829545,9829545,House of 1000 Corpses,Sid Haig|Bill Moseley|Sheri Moon Zombie|Karen Black|Erin Daniels,Rob Zombie,89,Horror,2003-04-11,140,5.8,2003,8297468,19948945,11651477,6
5088,0.403468,20000000,17432163,-2567837,A Guy Thing,Jason Lee|Julia Stiles|Selma Blair|James Brolin|Shawn Hatosy,Chris Koch,101,Comedy|Romance,2003-01-17,46,5.3,2003,23707052,20663260,-3043792,5
5090,0.388875,32000000,52277485,20277485,Radio,Cuba Gooding Jr.|Ed Harris|Alfre Woodard|S. Epatha Merkerson|Debra Winger,Mike Tollin,109,Drama,2003-10-24,75,7.1,2003,37931284,61967255,24035971,7
5091,0.383686,6400000,2500000,-3900000,Young Adam,Ewan McGregor|Tilda Swinton|Peter Mullan|Emily Mortimer|Jack McElhone,David Mackenzie,93,Drama|Thriller|Crime|Romance,2003-09-26,16,5.9,2003,7586256,2963381,-4622875,6
5097,0.36744,75000000,51142659,-23857341,Hollywood Homicide,Harrison Ford|Josh Hartnett|Lena Olin|Bruce Greenwood|Isaiah Washington,Ron Shelton,116,Action|Adventure|Comedy|Thriller,2003-06-09,76,4.8,2003,88901448,60622086,-28279362,5
5098,0.366218,7800000,22441323,14641323,Swimming Pool,Charlotte Rampling|Ludivine Sagnier|Charles Dance|Jean-Marie Lamour|Marc Fayolle,FranÃ§ois Ozon,102,Thriller|Crime,2003-05-18,68,6.2,2003,9245750,26600881,17355131,6
5101,0.360105,6000000,18750246,12750246,A Mighty Wind,Bob Balaban|Christopher Guest|John Michael Higgins|Eugene Levy|Jane Lynch,Christopher Guest,91,Comedy|Music,2003-04-16,33,6.5,2003,7112115,22225653,15113538,6
5106,0.351678,850000,819939,-30061,Latter Days,Steve Sandvoss|Wes Ramsey|Jacqueline Bisset|Joseph Gordon-Levitt|Rebekah Johnson,C. Jay Cox,107,Drama|Comedy|Romance,2003-07-10,26,6.4,2003,1007549,971916,-35633,6
5107,0.350293,500000,8679814,8179814,The Station Agent,Peter Dinklage|Patricia Clarkson|Bobby Cannavale|Michelle Williams|Raven Goodwin,Tom McCarthy,88,Drama|Comedy,2003-01-26,107,7.4,2003,592676,10288640,9695964,7
5109,0.346215,15000000,30238577,15238577,The Fighting Temptations,BeyoncÃ© Knowles|Cuba Gooding Jr.|Wendell Pierce|LaTanya Richardson|Faith Evans,Jonathan Lynn,122,Comedy|Music|Romance,2003-09-17,22,5.3,2003,17780289,35843377,18063088,5
5111,0.339709,5000000,4856298,-143702,Intermission,Colin Farrell|Colm Meaney|Kelly Macdonald|Cillian Murphy|BrÃ­an F. O'Byrne,John Crowley,105,Romance|Action|Comedy|Crime|Mystery,2003-08-29,21,5.5,2003,5926763,5756425,-170338,5
5128,0.289415,10000000,96542059,86542059,Calendar Girls,Helen Mirren|Julie Walters|John Alderton|Linda Bassett|Annette Crosbie,Nigel Cole,108,Comedy,2003-09-02,46,6.5,2003,11853526,114436384,102582858,6
5130,0.284861,8256269,460978,-7795291,Foolproof,Ryan Reynolds|Kristin Booth|Joris Jarsky|David Suchet|Sean Sullivan,William Phillips,97,Action,2003-10-03,18,6.4,2003,9786590,546421,-9240169,6
5133,0.276911,4361898,3031801,-1330097,Mambo Italiano,Luke Kirby|Ginette Reno|Paul Sorvino|Mary Walsh|Peter Miller,Ã‰mile Gaudreault,92,Comedy|Romance,2003-06-06,13,5.2,2003,5170387,3593753,-1576634,5
5135,0.275184,28000000,58795814,30795814,Agent Cody Banks,Frankie Muniz|Hilary Duff|Angie Harmon|Keith David|Cynthia Stevenson,Harald Zwart,102,Action,2003-03-12,161,4.9,2003,33189874,69693773,36503899,5
5138,0.264295,24000000,23510601,-489399,Biker Boyz,Laurence Fishburne|Derek Luke|Orlando Jones|Djimon Hounsou|Lisa Bonet,Reggie Rock Bythewood,110,Action|Drama,2003-01-31,30,5.8,2003,28448463,27868353,-580110,6
5142,0.253381,13000000,17040871,4040871,Ghosts of the Abyss,Bill Paxton|John Broadwater|James Cameron|Mike Cameron|Ken Marschall,James Cameron,92,Family|Documentary,2003-04-10,23,6.7,2003,15409584,20199441,4789857,7
5148,0.349751,55000000,33828318,-21171682,Stuck on You,Matt Damon|Greg Kinnear|Eva Mendes|Wen Yann Shih|Seymour Cassel,Bobby Farrelly|Peter Farrelly,118,Comedy,2003-12-10,104,4.8,2003,65194395,40098486,-25095909,5
5162,0.208637,10,5,-5,Kid's Story,Clayton Watson|Keanu Reeves|Carrie-Anne Moss|Kevin Michael Richardson|John Demita,Shinichiro Watanabe,15,Science Fiction|Animation,2003-06-02,16,6.8,2003,11,5,-6,7
5164,0.371487,15000000,2281585,-12718415,The Company,Neve Campbell|Malcolm McDowell|James Franco|Barbara E. Robertson|William Dick,Robert Altman,112,Drama|Thriller,2003-09-10,12,4.9,2003,17780289,2704482,-15075807,5
5176,0.193661,17000000,1569918,-15430082,Veronica Guerin,Cate Blanchett|Gerard McSorley|CiarÃ¡n Hinds|Brenda Fricker|Don Wycherley,Joel Schumacher,98,Drama|Crime|Thriller,2003-07-11,26,6.7,2003,20150994,1860906,-18290088,7
5184,0.175002,110000000,214948780,104948780,X2,Patrick Stewart|Hugh Jackman|Ian McKellen|Halle Berry|Famke Janssen,Bryan Singer,133,Adventure|Action|Science Fiction|Thriller,2003-04-24,2222,6.7,2003,130388790,254790104,124401314,7
5186,0.161748,5000000,2466444,-2533556,Wonderland,Val Kilmer|Dylan McDermott|Kate Bosworth|Josh Lucas|Lisa Kudrow,James Cox,104,Crime|Drama|Mystery|Thriller,2003-10-23,23,6.4,2003,5926763,2923605,-3003158,6
5195,0.143004,30000000,15368897,-14631103,Alex & Emma,Luke Wilson|Kate Hudson|Sophie Marceau|David Paymer|Paul Wilson,Rob Reiner,96,Comedy|Romance,2003-06-16,43,5.0,2003,35560579,18217562,-17343017,5
5196,0.135161999999999,12000000,4922166,-7077834,From Justin to Kelly,Kelly Clarkson|Justin Guarini |Brandon Henschel|Greg Siff|Brian Dietzen,Robert Iscove,90,Comedy|Romance,2003-06-20,12,3.5,2003,14224231,5834502,-8389729,3
5198,0.126182,569217,569217,0,Les Clefs de bagnole,Laurent Baffie|Daniel Russo|Pascal Sellem|GÃ©rard Depardieu|Guillaume Canet,Laurent Baffie,90,Comedy,2003-12-10,12,4.8,2003,674722,674722,0,5
5207,0.098984,7000000,10000000,3000000,Sylvia,Gwyneth Paltrow|Daniel Craig|Jared Harris|Michael Gambon|Blythe Danner,Christine Jeffs,109,Drama|Romance,2003-10-17,17,5.6,2003,8297468,11853526,3556058,6
5231,4.355219,200000000,1845034188,1645034188,Titanic,Kate Winslet|Leonardo DiCaprio|Frances Fisher|Billy Zane|Kathy Bates,James Cameron,194,Drama|Romance|Thriller,1997-11-18,4654,7.3,1997,271692064,2506405735,2234713671,7
5232,3.48891,85000000,252712101,167712101,Hercules,Tate Donovan|Josh Keaton|Roger Bart|Danny DeVito|James Woods,John Musker|Ron Clements,93,Animation|Family|Fantasy|Adventure|Comedy,1997-06-26,909,7.0,1997,115469127,343299361,227830234,7
5233,3.153414,90000000,589390539,499390539,Men in Black,Tommy Lee Jones|Will Smith|Linda Fiorentino|Vincent D'Onofrio|Rip Torn,Barry Sonnenfeld,98,Action|Adventure|Comedy|Science Fiction,1997-07-01,2864,6.7,1997,122261428,800663660,678402232,7
5234,3.077454,36000000,12532777,-23467223,Gattaca,Ethan Hawke|Jude Law|Gore Vidal|Uma Thurman|Alan Arkin,Andrew Niccol,106,Thriller|Science Fiction|Mystery|Romance,1997-09-07,1117,7.3,1997,48904571,17025280,-31879291,7
5235,2.972972,90000000,263920180,173920180,The Fifth Element,Bruce Willis|Gary Oldman|Ian Holm|Milla Jovovich|Chris Tucker,Luc Besson,126,Adventure|Fantasy|Action|Thriller|Science Fiction,1997-05-07,2649,7.1,1997,122261428,358525092,236263664,7
5236,2.604799,125000000,238207122,113207122,Batman & Robin,Arnold Schwarzenegger|George Clooney|Chris O'Donnell|Uma Thurman|Alicia Silverstone,Joel Schumacher,125,Action|Crime|Fantasy|Science Fiction,1997-06-20,828,4.4,1997,169807540,323594923,153787383,4
5238,2.391809,110000000,333011068,223011068,Tomorrow Never Dies,Pierce Brosnan|Jonathan Pryce|Michelle Yeoh|Teri Hatcher|Ricky Jay,Roger Spottiswoode,119,Adventure|Action|Thriller,1997-12-11,565,5.9,1997,149430635,452382322,302951687,6
5239,2.202087,10000000,225933435,215933435,Good Will Hunting,Robin Williams|Matt Damon|Ben Affleck|Stellan SkarsgÃ¥rd|Minnie Driver,Gus Van Sant,126,Drama,1997-12-05,1592,7.7,1997,13584603,306921606,293337003,8
5240,2.113737,12000000,39673162,27673162,Jackie Brown,Pam Grier|Samuel L. Jackson|Robert Forster|Bridget Fonda|Michael Keaton,Quentin Tarantino,154,Action|Crime|Drama|Thriller,1997-12-24,763,7.1,1997,16301523,53894416,37592893,7
5241,2.064658,70000000,162000000,92000000,Alien: Resurrection,Sigourney Weaver|Winona Ryder|Dominique Pinon|Ron Perlman|Michael Wincott,Jean-Pierre Jeunet,109,Science Fiction|Horror|Action,1997-11-12,712,5.9,1997,95092222,220070572,124978350,6
5242,2.01227,50000000,109423648,59423648,The Game,Michael Douglas|Sean Penn|Deborah Kara Unger|James Rebhorn|Peter Donat,David Fincher,129,Drama|Thriller|Mystery,1997-09-12,851,7.3,1997,67923016,148647683,80724667,7
5243,1.949225,60000000,26673242,-33326758,Event Horizon,Laurence Fishburne|Sam Neill|Kathleen Quinlan|Joely Richardson|Richard T. Jones,Paul W.S. Anderson,96,Horror|Science Fiction|Mystery,1997-08-15,358,6.2,1997,81507619,36234540,-45273079,6
5244,1.929641,53000000,139804348,86804348,Anastasia,Meg Ryan|John Cusack|Christopher Lloyd|Angela Lansbury|Hank Azaria,Don Bluth|Gary Goldman,94,Animation|Family,1997-11-20,806,7.2,1997,71998397,189918659,117920262,7
5245,1.623577,32000000,79082515,47082515,Home Alone 3,Alex D. Linz|Olek Krupa|Rya Kihlstedt|Lenny Von Dohlen|Scarlett Johansson,Raja Gosnell,102,Comedy|Family,1997-12-12,331,5.2,1997,43470730,107430458,63959728,5
5246,1.616191,16500000,67683989,51183989,Austin Powers: International Man of Mystery,Mike Myers|Elizabeth Hurley|Michael York|Mimi Rogers|Seth Green,Jay Roach,94,Science Fiction|Comedy|Crime,1997-05-02,581,6.3,1997,22414595,91946013,69531418,6
5247,1.55286,105000000,121214377,16214377,Starship Troopers,Casper Van Dien|Dina Meyer|Denise Richards|Jake Busey|Neil Patrick Harris,Paul Verhoeven,129,Adventure|Action|Thriller|Science Fiction,1997-11-06,929,6.5,1997,142638333,164664921,22026588,6
5248,1.412516,3500000,257850122,254350122,The Full Monty,Robert Carlyle|Mark Addy|William Snape|Steve Huison|Tom Wilkinson,Peter Cattaneo,91,Comedy,1997-08-13,163,6.4,1997,4754611,350279159,345524548,6
5249,1.368403,75000000,224012234,149012234,Con Air,Nicolas Cage|John Cusack|John Malkovich|Ving Rhames|Nick Chinlund,Simon West,115,Action|Thriller|Crime,1997-06-01,728,6.5,1997,101884524,304311731,202427207,6
5250,1.330225,80000000,245676146,165676146,Face/Off,John Travolta|Nicolas Cage|Joan Allen|Alessandro Nivola|Gina Gershon,John Woo,138,Action|Crime|Science Fiction|Thriller,1997-06-27,955,6.7,1997,108676825,333741296,225064471,7
5251,1.308461,35000000,41954997,6954997,Donnie Brasco,Johnny Depp|Al Pacino|Michael Madsen|Bruno Kirby|James Russo,Mike Newell,127,Crime|Drama|Thriller,1997-02-27,615,7.2,1997,47546111,56994198,9448087,7
5252,1.307058,17000000,125586134,108586134,I Know What You Did Last Summer,Jennifer Love Hewitt|Sarah Michelle Gellar|Ryan Phillippe|Freddie Prinze Jr.|Bridgette Wilson,Jim Gillespie,100,Horror|Thriller|Mystery,1997-10-17,348,5.5,1997,23093825,170603779,147509954,5
5253,1.272247,57000000,152944660,95944660,The Devil's Advocate,Keanu Reeves|Al Pacino|Charlize Theron|Jeffrey Jones|Judith Ivey,Taylor Hackford,144,Drama|Horror|Mystery|Thriller,1997-10-17,717,6.9,1997,77432238,207769251,130337013,7
5254,1.231579,45000000,136885767,91885767,Anaconda,Jennifer Lopez|Ice Cube|Jon Voight|Eric Stoltz|Owen Wilson,Luis Llosa,89,Adventure|Horror|Thriller,1997-04-11,331,4.7,1997,61130714,185953882,124823168,5
5255,1.212565,250000,12021272,11771272,Chasing Amy,Ben Affleck|Joey Lauren Adams|Jason Lee|Dwight Ewell|Kevin Smith,Kevin Smith,113,Comedy|Drama|Romance,1997-04-04,227,6.7,1997,339615,16330421,15990806,7
5256,1.176223,116000000,178127760,62127760,Dante's Peak,Pierce Brosnan|Linda Hamilton|Jamie RenÃ©e Smith|Jeremy Foley|Elizabeth Hoffman,Roger Donaldson,108,Action|Adventure|Thriller,1997-02-07,216,5.5,1997,157581397,241979494,84398097,5
5257,1.172353,160000000,164508066,4508066,Speed 2: Cruise Control,Sandra Bullock|Jason Patric|Willem Dafoe|Temuera Morrison|Mike Hagerty,Jan de Bont,121,Action|Adventure|Thriller,1997-06-12,233,4.4,1997,217353651,223477680,6124029,4
5258,1.123404,35000000,126216940,91216940,L.A. Confidential,Kevin Spacey|Guy Pearce|Danny DeVito|James Cromwell|Kim Basinger,Curtis Hanson,138,Crime|Drama|Mystery|Thriller,1997-09-19,728,7.5,1997,47546111,171460704,123914593,7
5259,1.109101,24000000,172363301,148363301,Scream 2,David Arquette|Neve Campbell|Courteney Cox|Sarah Michelle Gellar|Jamie Kennedy,Wes Craven,120,Horror|Mystery,1997-12-09,442,6.0,1997,32603047,234148705,201545658,6
5260,1.087383,45000000,181000000,136000000,Liar Liar,Jim Carrey|Maura Tierney|Justin Cooper|Cary Elwes|Anne Haney,Tom Shadyac,86,Comedy,1997-03-21,774,6.2,1997,61130714,245881318,184750604,6
5262,1.037438,90000000,171120329,81120329,Contact,Jodie Foster|Matthew McConaughey|James Woods|John Hurt|Tom Skerritt,Robert Zemeckis,150,Drama|Science Fiction|Mystery,1997-07-11,745,6.9,1997,122261428,232460177,110198749,7
5263,1.031334,62000000,1060056,-60939944,Lolita,Jeremy Irons|Dominique Swain|Melanie Griffith|Frank Langella|Suzanne Shepherd,Adrian Lyne,137,Drama|Romance,1997-09-27,120,6.9,1997,84224539,1440044,-82784495,7
5264,1.008461,40000000,45916769,5916769,The Rainmaker,Matt Damon|Danny DeVito|Jon Voight|Claire Danes|Mary Kay Place,Francis Ford Coppola,135,Drama|Crime|Thriller,1997-11-18,113,6.5,1997,54338412,62376108,8037696,6
5266,0.981422,60000000,159330280,99330280,The Jackal,Bruce Willis|Richard Gere|Sidney Poitier|Diane Venora|J.K. Simmons,Michael Caton-Jones,124,Action|Thriller|Adventure|Crime,1997-11-13,295,6.0,1997,81507619,216443863,134936244,6
5269,0.96047,80000000,177977226,97977226,Flubber,Robin Williams|Marcia Gay Harden|Christopher McDonald|Raymond J. Barry|Clancy Brown,Les Mayfield,93,Comedy|Family|Science Fiction,1997-11-26,385,5.1,1997,108676825,241774999,133098174,5
5270,0.938611,68000000,118063304,50063304,The Saint,Val Kilmer|Elisabeth Shue|Rade Serbedzija|Henry Goodman|Alun Armstrong,Phillip Noyce,116,Thriller|Action|Romance|Science Fiction|Adventure,1997-04-03,161,6.0,1997,92375301,160384313,68009012,6
5271,0.936736,75000000,136982834,61982834,Conspiracy Theory,Mel Gibson|Julia Roberts|Patrick Stewart|Cylk Cozart|Steve Kahan,Richard Donner,135,Action|Drama|Mystery|Thriller,1997-08-07,243,6.4,1997,101884524,186085744,84201220,6
5272,0.933349,85000000,315156409,230156409,Air Force One,Harrison Ford|Gary Oldman|Glenn Close|Wendy Crewson|William H. Macy,Wolfgang Petersen,124,Action|Thriller,1997-07-23,474,6.1,1997,115469127,428127476,312658349,6
5274,0.855982,15000000,64256513,49256513,Wag the Dog,Dustin Hoffman|Robert De Niro|Anne Heche|Denis Leary|Willie Nelson,Barry Levinson,97,Comedy|Drama,1997-12-25,120,6.6,1997,20376904,87289923,66913019,7
5275,0.855087,50000000,314178011,264178011,As Good as It Gets,Jack Nicholson|Helen Hunt|Greg Kinnear|Cuba Gooding Jr.|Skeet Ulrich,James L. Brooks,139,Comedy|Romance,1997-12-19,480,7.0,1997,67923016,426798361,358875345,7
5276,0.835336,36000000,50159144,14159144,Breakdown,Kurt Russell|J. T. Walsh|Kathleen Quinlan|M.C. Gainey|Jack Noseworthy,Jonathan Mostow,95,Drama|Action|Thriller,1997-05-02,84,6.5,1997,48904571,68139206,19234635,6
5277,0.824965,70000000,131457682,61457682,Seven Years in Tibet,Brad Pitt|Jamyang Jamtsho Wangchuk|David Thewlis|BD Wong|Mako,Jean-Jacques Annaud,136,History|Drama|Adventure|War,1997-09-12,342,6.9,1997,95092222,178580044,83487822,7
5278,0.797298,38000000,299288605,261288605,My Best Friend's Wedding,Julia Roberts|Dermot Mulroney|Cameron Diaz|Rupert Everett|Philip Bosco,P.J. Hogan,105,Comedy|Romance,1997-06-19,336,6.3,1997,51621492,406571694,354950202,6
5279,0.778274,15000000,43101594,28101594,Boogie Nights,Mark Wahlberg|Burt Reynolds|John C. Reilly|Julianne Moore|Thomas Jane,Paul Thomas Anderson,155,Drama,1997-09-11,438,7.3,1997,20376904,58551805,38174901,7
5280,0.776305,15000000,3675201,-11324799,Lost Highway,Bill Pullman|Patricia Arquette|John Roselius|Louis Eppolito|Robert Blake,David Lynch,134,Drama|Thriller|Mystery,1997-01-15,263,7.3,1997,20376904,4992614,-15384290,7
5281,0.761869999999999,50000000,10541523,-39458477,Mad City,John Travolta|Dustin Hoffman|Mia Kirshner|Alan Alda|Robert Prosky,Costa-Gavras,114,Action|Drama|Thriller,1997-11-07,36,5.3,1997,67923016,14320240,-53602776,5
5285,0.742726,18000000,251212670,233212670,Bean,Rowan Atkinson|Peter MacNicol|John Mills|Pamela Reed|Harris Yulin,Mel Smith,85,Comedy,1997-07-29,297,6.3,1997,24452285,341262444,316810159,6
5286,0.737243,90000000,140807547,50807547,The Devil's Own,Harrison Ford|Brad Pitt|Margaret Colin|RubÃ©n Blades|Treat Williams,Alan J. Pakula,107,Crime|Thriller|Drama,1997-03-12,147,5.8,1997,122261428,191281465,69020037,6
5290,0.712173,27000000,60527873,33527873,Kiss the Girls,Morgan Freeman|Ashley Judd|Cary Elwes|Alex McArthur|Tony Goldwyn,Gary Fleder,115,Drama|Mystery|Thriller|Crime,1997-10-03,170,6.1,1997,36678428,82224713,45546285,6
5291,0.708978,50000000,50068310,68310,Absolute Power,Clint Eastwood|Gene Hackman|Ed Harris|Scott Glenn|Laura Linney,Clint Eastwood,121,Crime|Drama|Thriller,1997-02-14,91,6.2,1997,67923016,68015812,92796,6
5292,0.706535999999999,25000000,36400360,11400360,Vegas Vacation,Chevy Chase|Beverly D'Angelo|Randy Quaid|Ethan Embry|Marisol Nichols,Stephen Kessler,93,Comedy,1997-02-13,69,6.1,1997,33961508,49448444,15486936,6
5293,0.706041,19000000,6682098,-12317902,U Turn,Sean Penn|Nick Nolte|Jennifer Lopez|Joaquin Phoenix|Claire Danes,Oliver Stone,125,Thriller,1997-10-03,76,6.6,1997,25810746,9077364,-16733382,7
5295,0.685381999999999,30000000,25480490,-4519510,Mimic,Mira Sorvino|Jeremy Northam|Giancarlo Giannini|Josh Brolin|Alexander Goodwin,Guillermo del Toro,105,Fantasy|Horror|Thriller,1997-08-22,99,5.3,1997,40753809,34614234,-6139575,5
5296,0.683051,20000000,5716080,-14283920,One Eight Seven,"Samuel L. Jackson|John Heard|Kelly Rowan|Clifton Collins, Jr.|Tony Plana",Kevin Reynolds,119,Drama|Thriller,1997-07-29,67,6.4,1997,27169206,7765067,-19404139,6
5298,0.676667,40000000,87840042,47840042,Spawn,Michael Jai White|Martin Sheen|John Leguizamo|Theresa Randle|Nicol Williamson,Mark A.Z. DippÃ©,96,Action|Adventure|Fantasy|Horror|Science Fiction,1997-07-31,183,5.0,1997,54338412,119327211,64988799,5
5300,0.663483,250000,501818,251818,Cube,Nicole de Boer|Nicky Guadagni|David Hewlett|Andrew Miller|Julian Richings,Vincenzo Natali,90,Thriller|Science Fiction|Mystery,1997-09-09,508,6.7,1997,339615,681699,342084,7
5301,0.660297,28000000,5684789,-22315211,Kundun,Tenzin Thuthob Tsarong|Tencho Gyalpo|Tsewang Migyur Khangsar|Gyurme Tethong|Robert Lin,Martin Scorsese,134,Drama,1997-12-25,34,7.1,1997,38036888,7722560,-30314328,7
5302,0.648088,80000000,17626234,-62373766,The Postman,Kevin Costner|Will Patton|Olivia Williams|Larenz Tate|Tom Petty,Kevin Costner,177,Drama|Adventure,1997-12-25,148,6.1,1997,108676825,23944539,-84732286,6
5303,0.638429,50000000,48169156,-1830844,G.I. Jane,Demi Moore|Viggo Mortensen|Anne Bancroft|Jason Beghe|Daniel von Bargen,Ridley Scott,125,Action|Drama,1997-08-22,208,6.0,1997,67923016,65435887,-2487129,6
5304,0.636839,60000000,33956608,-26043392,The Relic,Penelope Ann Miller|Tom Sizemore|Linda Hunt|James Whitmore|Clayton Rohner,Peter Hyams,110,Horror|Thriller|Mystery,1997-01-10,57,5.7,1997,81507619,46128704,-35378915,6
5315,0.530543999999999,60000000,16000000,-44000000,Fire Down Below,Steven Seagal|Marg Helgenberger|Stephen Lang|Brad Hunt|Kris Kristofferson,FÃ©lix EnrÃ­quez AlcalÃ¡,105,Action|Adventure|Crime|Thriller,1997-09-05,34,5.0,1997,81507619,21735365,-59772254,5
5317,0.512273,38000000,122417389,84417389,MouseHunt,Nathan Lane|Lee Evans|Vicki Lewis|Maury Chaykin|Eric Christmas,Gore Verbinski,98,Comedy|Family,1997-12-19,134,6.1,1997,51621492,166299165,114677673,6
5318,0.511529,5000000,3263585,-1736415,The Sweet Hereafter,Ian Holm|Caerthan Banks|Sarah Polley|Tom McCamus|Gabrielle Rose,Atom Egoyan,112,Drama,1997-05-14,41,6.4,1997,6792301,4433450,-2358851,6
5322,0.473762,15000000,44862187,29862187,Cop Land,Sylvester Stallone|Harvey Keitel|Ray Liotta|Robert De Niro|Peter Berg,James Mangold,104,Action|Crime|Drama,1997-08-15,185,6.5,1997,20376904,60943500,40566596,6
5324,0.46602,20000000,60000000,40000000,Selena,Jennifer Lopez|Edward James Olmos|Constance Marie|Jon Seda|Lupe Ontiveros,Gregory Nava,127,Documentary|Drama,1997-03-21,82,6.9,1997,27169206,81507619,54338413,7
5325,0.464907,25000000,100000000,75000000,Spice World - The Movie,Victoria Beckham|Melanie Brown|Emma Bunton|Melanie Chisholm|Geri Halliwell,Bob Spiers,93,Adventure|Fantasy|Drama|Comedy|Music,1997-12-19,65,5.2,1997,33961508,135846032,101884524,5
5326,0.463524,18000000,8038061,-9961939,The Ice Storm,Kevin Kline|Joan Allen|Sigourney Weaver|Henry Czerny|Tobey Maguire,Ang Lee,112,Drama,1997-09-27,67,6.3,1997,24452285,10919386,-13532899,6
5328,0.436806,3000000,23144499,20144499,Air Bud,Kevin Zegers|Wendy Makkena|Michael Jeter|Bill Cobbs|Brendan Fletcher,Charles Martin Smith,98,Comedy|Family|Drama,1997-08-01,50,5.3,1997,4075380,31440883,27365503,5
5332,0.425112,32000000,3566637,-28433363,Cats Don't Dance,Scott Bakula|Jasmine Guy|Natalie Cole|Ashley Peldon|Lindsay Ridgeway,Mark Dindal,75,Animation|Comedy|Family|Music,1997-03-26,10,7.1,1997,43470730,4845134,-38625596,7
5334,1.086558,30000000,51376861,21376861,Mortal Kombat: Annihilation,Robin Shou|Talisa Soto|James Remar|Sandra Hess|Lynn 'Red' Williams,John R. Leonetti,95,Action|Fantasy|Science Fiction,1997-11-21,118,3.9,1997,40753809,69793427,29039618,4
5336,0.447075,55000000,31987563,-23012437,Metro,Eddie Murphy|Kim Miyori|Art Evans|James Carpenter|Michael Rapaport,Thomas Carter,117,Action|Adventure|Comedy|Crime|Thriller,1997-01-16,64,5.3,1997,74715317,43453835,-31261482,5
5340,0.401471,5000000,15738769,10738769,Wishmaster,Andrew Divoff|Tammy Lauren|Robert Englund|Chris Lemmon|Wendy Benson-Landes,Robert Kurtzman,90,Horror,1997-09-19,41,5.4,1997,6792301,21380493,14588192,5
5341,0.362661,35000000,31611225,-3388775,For Richer or Poorer,Tim Allen|Kirstie Alley|Wayne Knight|Larry Miller|Jay O. Sanders,Bryan Spicer,115,Comedy,1997-12-11,23,5.8,1997,47546111,42942594,-4603517,6
5343,0.223994,10000000,17979739,7979739,Turbo: A Power Rangers Movie,Johnny Yong Bosch|Nakia Burrise|Jason David Frank|Catherine Sutherland|Amy Jo Johnson,Shuki Levy|David Winning,99,Action|Adventure|Family|Fantasy|Science Fiction,1997-03-27,33,4.6,1997,13584603,24424762,10840159,5
5348,0.37438,20000000,13801755,-6198245,The Man Who Knew Too Little,Bill Murray|Peter Gallagher|Joanne Whalley|Alfred Molina|Richard Wilson,Jon Amiel,97,Comedy|Thriller|Crime|Action,1997-11-14,64,6.5,1997,27169206,18749136,-8420070,6
5349,0.364359,55000000,11466088,-43533912,Turbulence,Ray Liotta|Lauren Holly|Brendan Gleeson|HÃ©ctor Elizondo|Rachel Ticotin,Robert Butler,100,Action|Thriller|Crime,1997-01-09,23,5.3,1997,74715317,15576225,-59139092,5
5354,0.345909,16000000,1686429,-14313571,Steel,Shaquille O'Neal|Annabeth Gish|Richard Roundtree|Judd Nelson|Irma P. Hall,Kenneth Johnson,97,Science Fiction|Action|Adventure,1997-08-15,19,4.3,1997,21735365,2290946,-19444419,4
5358,0.325869,28000000,41230799,13230799,Private Parts,Howard Stern|Mary McCormack|Kelly Bishop|Paul Giamatti|Leslie Bibb,Betty Thomas,109,Comedy|Drama,1997-03-07,38,6.6,1997,38036888,56010404,17973516,7
5362,0.05639,12000000,4000000,-8000000,Playing God,David Duchovny|Timothy Hutton|Angelina Jolie|Michael Massee|Stacey Travis,Andy Wilson,94,Drama|Action|Thriller|Crime,1997-10-17,15,5.7,1997,16301523,5433841,-10867682,6
5364,0.285559,19000000,44332015,25332015,Picture Perfect,Jennifer Aniston|Jay Mohr|Kevin Bacon|Olympia Dukakis|Illeana Douglas,Glenn Gordon Caron,105,Comedy|Romance,1997-08-01,57,5.2,1997,25810746,60223283,34412537,5
5365,0.2817,35000000,791830,-34208170,Anna Karenina,Sophie Marceau|Sean Bean|Alfred Molina|Mia Kirshner|James Fox,Bernard Rose,108,Drama|Romance,1997-04-04,11,6.0,1997,47546111,1075669,-46470442,6
5372,0.263311,25000000,11838218,-13161782,Most Wanted,Keenen Ivory Wayans|Jon Voight|Robert Kotecki|Rick Cramer|Kenn Whitaker,David Hogan,99,Action|Thriller,1997-10-10,12,6.0,1997,33961508,16081749,-17879759,6
5380,0.245162,35000000,25105255,-9894745,Midnight in the Garden of Good and Evil,John Cusack|Kevin Spacey|Jude Law|Alison Eastwood|Jack Thompson,Clint Eastwood,155,Crime|Drama|Mystery|Thriller,1997-11-21,76,6.4,1997,47546111,34104492,-13441619,6
5386,0.223151,22000000,26570463,4570463,An American Werewolf in Paris,Tom Everett Scott|Julie Delpy|Vince Vieluf|Julie Bowen|Phil Buckman,Anthony Waller,105,Horror|Comedy,1997-12-25,68,5.3,1997,29886127,36094919,6208792,5
5387,0.22136,36000000,74000000,38000000,Amistad,Morgan Freeman|Nigel Hawthorne|Anthony Hopkins|Djimon Hounsou|Matthew McConaughey,Steven Spielberg,155,Drama|History|Mystery,1997-12-03,167,6.6,1997,48904571,100526063,51621492,7
5389,0.214637,6000000,6330054,330054,Affliction,Nick Nolte|James Coburn|Sissy Spacek|Willem Dafoe|Brigid Tierney,Paul Schrader,114,Drama,1997-08-28,20,5.0,1997,8150761,8599127,448366,5
5390,0.212272,30000000,13130349,-16869651,Rosewood,Ving Rhames|Jon Voight|Don Cheadle|Michael Rooker|Bruce McGill,John Singleton,140,Drama|History,1997-02-21,14,6.0,1997,40753809,17837058,-22916751,6
5391,0.21055,73000000,229074524,156074524,The Lost World: Jurassic Park,Jeff Goldblum|Julianne Moore|Pete Postlethwaite|Richard Attenborough|Vince Vaughn,Steven Spielberg,129,Adventure|Action|Science Fiction,1997-05-23,1655,6.1,1997,99167603,311188651,212021048,6
5392,0.206863,37000000,6482195,-30517805,Switchback,Dennis Quaid|Danny Glover|R. Lee Ermey|Claudia Stedelin|Brent Hinkley,Jeb Stuart,118,Action|Adventure|Mystery|Thriller,1997-10-31,20,5.7,1997,50263031,8805804,-41457227,6
5402,0.158203,4000000,29456000,25456000,La vÃ©ritÃ© si je mens !,Richard Anconina|Vincent Elbaz|Richard Bohringer|JosÃ© Garcia|Amira Casar,Thomas Gilou,100,Comedy,1997-04-01,59,6.4,1997,5433841,40014807,34580966,6
5415,0.065672,786675,861789,75114,The Castle,Michael Caton|Anne Tenney|Stephen Curry|Anthony Simcoe|Sophie Lee,Rob Sitch,85,Drama|Comedy,1997-04-10,32,7.0,1997,1068666,1170706,102040,7
5422,6.112766,150000000,1274219009,1124219009,Frozen,Kristen Bell|Idina Menzel|Jonathan Groff|Josh Gad|Santino Fontana,Chris Buck|Jennifer Lee,102,Animation|Adventure|Family,2013-11-27,3369,7.5,2013,140405002,1192711491,1052306489,7
5423,5.242753,105000000,716392705,611392705,Gravity,Sandra Bullock|George Clooney|Ed Harris|Orto Ignatiussen|Phaldut Sharma,Alfonso CuarÃ³n,91,Science Fiction|Thriller|Drama,2013-09-27,3775,7.4,2013,98283502,670567465,572283963,7
5424,5.1119,170000000,479765000,309765000,Thor: The Dark World,Chris Hemsworth|Natalie Portman|Tom Hiddleston|Anthony Hopkins|Christopher Eccleston,Alan Taylor,112,Action|Adventure|Fantasy,2013-10-29,3025,6.8,2013,159125669,449076041,289950372,7
5425,4.946136,200000000,1215439994,1015439994,Iron Man 3,Robert Downey Jr.|Gwyneth Paltrow|Guy Pearce|Don Cheadle|Ben Kingsley,Shane Black,130,Action|Adventure|Science Fiction,2013-04-18,6882,6.9,2013,187206670,1137692372,950485702,7
5426,4.942928,75000000,117698894,42698894,Now You See Me,Jesse Eisenberg|Mark Ruffalo|Woody Harrelson|MÃ©lanie Laurent|Isla Fisher,Louis Leterrier,115,Thriller|Crime,2013-05-29,3453,7.3,2013,70202501,110170090,39967589,7
5427,4.921275,130000000,847423452,717423452,The Hunger Games: Catching Fire,Jennifer Lawrence|Josh Hutcherson|Liam Hemsworth|Woody Harrelson|Elizabeth Banks,Francis Lawrence,146,Science Fiction|Thriller|Action|Adventure,2013-11-15,4269,7.4,2013,121684335,793216614,671532279,7
5428,4.877927,100000000,392000694,292000694,The Wolf of Wall Street,Leonardo DiCaprio|Jonah Hill|Margot Robbie|Kyle Chandler|Rob Reiner,Martin Scorsese,180,Crime|Drama|Comedy,2013-12-25,4027,7.9,2013,93603335,366925723,273322388,8
5429,4.705208,180000000,407602906,227602906,Pacific Rim,Idris Elba|Charlie Hunnam|Charlie Day|Ron Perlman|Burn Gorman,Guillermo del Toro,131,Action|Science Fiction|Adventure,2013-07-11,3590,6.7,2013,168486003,381529914,213043911,7
5430,4.405923,120000000,286168572,166168572,Oblivion,Tom Cruise|Morgan Freeman|Olga Kurylenko|Andrea Riseborough|Nikolaj Coster-Waldau,Joseph Kosinski,126,Action|Science Fiction|Adventure|Mystery,2013-04-10,3729,6.3,2013,112324002,267863327,155539325,6
5431,4.310786,250000000,958400000,708400000,The Hobbit: The Desolation of Smaug,Martin Freeman|Ian McKellen|Richard Armitage|Ken Stott|Graham McTavish,Peter Jackson,161,Adventure|Fantasy,2013-12-11,2952,7.6,2013,234008338,897094365,663086027,8
5432,3.97246,225000000,662845518,437845518,Man of Steel,Henry Cavill|Amy Adams|Michael Shannon|Diane Lane|Russell Crowe,Zack Snyder,143,Action|Adventure|Fantasy|Science Fiction,2013-06-12,4729,6.5,2013,210607504,620445512,409838008,6
5433,3.951582,23000000,47351251,24351251,Her,Joaquin Phoenix|Scarlett Johansson|Rooney Mara|Amy Adams|Olivia Wilde,Spike Jonze,126,Romance|Science Fiction|Drama,2013-12-18,2422,7.8,2013,21528767,44322350,22793583,8
5434,3.928789,76000000,970761885,894761885,Despicable Me 2,Steve Carell|Kristen Wiig|Benjamin Bratt|Miranda Cosgrove|Russell Brand,Pierre Coffin|Chris Renaud,98,Animation|Comedy|Family,2013-06-25,3436,7.0,2013,71138534,908665501,837526967,7
5435,3.877342,190000000,467365246,277365246,Star Trek Into Darkness,Chris Pine|Zachary Quinto|Zoe Saldana|Karl Urban|Simon Pegg,J.J. Abrams,132,Action|Adventure|Science Fiction,2013-05-05,3363,7.4,2013,177846337,437469458,259623121,7
5436,3.625529,20000000,187000000,167000000,12 Years a Slave,Chiwetel Ejiofor|Michael Fassbender|Lupita Nyong'o|Benedict Cumberbatch|Paul Dano,Steve McQueen,134,Drama|History,2013-10-18,2241,7.9,2013,18720667,175038236,156317569,8
5437,3.518275,38000000,98337295,60337295,Riddick,Vin Diesel|Karl Urban|Katee Sackhoff|Jordi MollÃ |Bokeem Woodbine,David Twohy,119,Science Fiction|Action|Thriller,2013-09-02,1530,6.2,2013,35569267,92046987,56477720,6
5438,3.472358,13000000,318000141,305000141,The Conjuring,Patrick Wilson|Vera Farmiga|Ron Livingston|Lili Taylor|Joey King,James Wan,112,Horror|Thriller,2013-07-18,1910,7.4,2013,12168433,297658738,285490305,7
5439,3.200427,105000000,351040419,246040419,The Great Gatsby,Leonardo DiCaprio|Tobey Maguire|Carey Mulligan|Joel Edgerton|Elizabeth Debicki,Baz Luhrmann,143,Drama|Romance,2013-05-10,2403,7.2,2013,98283502,328585540,230302038,7
5441,2.951594,115000000,286140700,171140700,Elysium,Matt Damon|Jodie Foster|Sharlto Copley|Alice Braga|Diego Luna,Neill Blomkamp,109,Science Fiction|Action|Drama|Thriller,2013-08-07,2366,6.5,2013,107643835,267837238,160193403,6
5442,2.815499,92000000,304654182,212654182,A Good Day to Die Hard,Bruce Willis|Jai Courtney|Sebastian Koch|Mary Elizabeth Winstead|Yuliya Snigir,John Moore,98,Action|Thriller,2013-02-06,3003,5.2,2013,86115068,285166475,199051407,5
5443,2.811403,3000000,89328627,86328627,The Purge,Lena Headey|Ethan Hawke|Max Burkholder|Adelaide Kane|Rhys Wakefield,James DeMonaco,86,Science Fiction|Horror|Thriller,2013-05-31,1522,5.8,2013,2808100,83614574,80806474,6
5444,2.643496,200000000,743559607,543559607,Monsters University,Billy Crystal|John Goodman|Steve Buscemi|Helen Mirren|Joel Murray,Dan Scanlon,104,Animation|Family,2013-06-20,2251,7.0,2013,187206670,695996591,508789921,7
5445,2.604638,200000000,531865000,331865000,World War Z,Brad Pitt|Mireille Enos|Abigail Hargrove|Sterling Jerins|James Badge Dale,Marc Forster,116,Action|Drama|Horror|Science Fiction|Thriller,2013-06-20,3822,6.7,2013,187206670,497843379,310636709,7
5446,2.497001,90000000,188133322,98133322,The Secret Life of Walter Mitty,Ben Stiller|Kristen Wiig|Patton Oswalt|Shirley MacLaine|Adam Scott,Ben Stiller,114,Adventure|Comedy|Drama|Fantasy,2013-12-18,2221,7.0,2013,84243001,176099064,91856063,7
5447,2.476989,110000000,125537191,15537191,Ender's Game,Asa Butterfield|Harrison Ford|Hailee Steinfeld|Abigail Breslin|Ben Kingsley,Gavin Hood,114,Science Fiction|Action|Adventure,2013-10-23,1608,6.6,2013,102963668,117506997,14543329,7
5448,2.443357,37000000,269994119,232994119,We're the Millers,Jason Sudeikis|Jennifer Aniston|Will Poulter|Emma Roberts|Ed Helms,Rawson Marshall Thurber,110,Comedy|Crime,2013-08-07,1960,6.9,2013,34633234,252723500,218090266,7
5449,2.196946,61000000,131940411,70940411,2 Guns,Denzel Washington|Mark Wahlberg|Paula Patton|Bill Paxton|Fred Ward,Baltasar KormÃ¡kur,109,Action|Crime|Drama|Comedy|Thriller,2013-08-02,1185,6.6,2013,57098034,123500625,66402591,7
5451,2.119986,38000000,90247624,52247624,Rush,Daniel BrÃ¼hl|Chris Hemsworth|Olivia Wilde|Alexandra Maria Lara|Natalie Dormer,Ron Howard,123,Drama|Action,2013-09-02,1472,7.7,2013,35569267,84474786,48905519,8
5452,2.109247,130000000,371876278,241876278,G.I. Joe: Retaliation,Dwayne Johnson|D.J. Cotrona|Adrianne Palicki|Bruce Willis|Ray Park,Jon M. Chu,110,Adventure|Action|Science Fiction|Thriller,2013-03-26,2615,5.4,2013,121684335,348088599,226404264,5
5453,2.070019,11000000,32935319,21935319,Inside Llewyn Davis,Oscar Isaac|Carey Mulligan|Justin Timberlake|Jerry Grayson|Robin Bartlett,Joel Coen|Ethan Coen,105,Drama|Music,2013-10-06,550,7.1,2013,10296366,30828557,20532191,7
5454,2.063266,70000000,161025640,91025640,Olympus Has Fallen,Gerard Butler|Aaron Eckhart|Angela Bassett|Morgan Freeman|Radha Mitchell,Antoine Fuqua,120,Action|Thriller,2013-03-20,2403,6.2,2013,65522334,150725369,85203035,6
5455,2.032753,90000000,174578751,84578751,Percy Jackson: Sea of Monsters,Logan Lerman|Alexandra Daddario|Douglas Smith|Leven Rambin|Brandon T. Jackson,Thor Freudenthal,106,Adventure|Family|Fantasy,2013-08-07,1039,5.9,2013,84243001,163411533,79168532,6
5456,2.032167,46000000,122126687,76126687,Prisoners,Hugh Jackman|Jake Gyllenhaal|Paul Dano|Maria Bello|Melissa Leo,Denis Villeneuve,153,Drama|Thriller|Crime,2013-09-18,1826,7.8,2013,43057534,114314652,71257118,8
5458,2.024873,40000000,251171807,211171807,American Hustle,Christian Bale|Bradley Cooper|Amy Adams|Jeremy Renner|Jennifer Lawrence,David O. Russell,138,Drama|Crime,2013-12-12,1861,6.8,2013,37441334,235105188,197663854,7
5459,1.999054,35000000,116980662,81980662,Warm Bodies,Nicholas Hoult|Teresa Palmer|Analeigh Tipton|Rob Corddry|Dave Franco,Jonathan Levine,97,Horror|Comedy|Romance,2013-01-31,1964,6.4,2013,32761167,109497801,76736634,6
5461,1.92107,50000000,224803475,174803475,Hansel & Gretel: Witch Hunters,Jeremy Renner|Gemma Arterton|Famke Janssen|Pihla Viitala|Derek Mears,Tommy Wirkola,88,Fantasy|Horror|Action,2013-01-17,2564,5.7,2013,46801667,210423550,163621883,6
5462,1.91745,175000000,150962475,-24037525,47 Ronin,Keanu Reeves|Hiroyuki Sanada|Kou Shibasaki|Tadanobu Asano|Min Tanaka,Carl Rinsch,118,Action|Adventure|Fantasy,2013-12-06,940,5.8,2013,163805836,141305911,-22499925,6
5464,1.875017,60000000,90565421,30565421,The Mortal Instruments: City of Bones,Lily Collins|Jamie Campbell Bower|Kevin Zegers|Jemima West|Robert Sheehan,Harald Zwart,130,Action|Adventure|Drama|Mystery|Romance,2013-08-21,1020,6.2,2013,56162001,84772254,28610253,6
5465,1.874575,100000000,268426634,168426634,Epic,Josh Hutcherson|Amanda Seyfried|Colin Farrell|Jason Sudeikis|Aziz Ansari,Chris Wedge,102,Animation|Adventure|Family|Fantasy,2013-05-15,857,6.4,2013,93603335,251256282,157652947,6
5466,1.821423,40000000,149295601,109295601,Lone Survivor,Mark Wahlberg|Taylor Kitsch|Emile Hirsch|Ben Foster|Yousuf Azami,Peter Berg,121,Action|Drama|Thriller|War,2013-12-24,1101,7.4,2013,37441334,139745661,102304327,7
5468,1.765514,5000000,55198285,50198285,Dallas Buyers Club,Matthew McConaughey|Jennifer Garner|Jared Leto|Denis O'Hare|Steve Zahn,Jean-Marc VallÃ©e,117,Drama|History,2013-09-07,1831,7.8,2013,4680166,51667435,46987269,8
5469,1.68986899999999,130000000,61648500,-68351500,R.I.P.D.,Jeff Bridges|Ryan Reynolds|Kevin Bacon|Stephanie Szostak|Mary-Louise Parker,Robert Schwentke,96,Fantasy|Action|Comedy|Crime,2013-07-18,876,5.3,2013,121684335,57705052,-63979283,5
5471,1.653164,50000000,219788712,169788712,Planes,Dane Cook|Carlos Alazraqui|Val Kilmer|Julia Louis-Dreyfus|Brad Garrett,Klay Hall,91,Animation|Family|Adventure|Comedy,2013-08-09,427,5.7,2013,46801667,205729564,158927897,6
5472,1.626627,5000000,31724284,26724284,Spring Breakers,James Franco|Selena Gomez|Vanessa Hudgens|Ashley Benson|Rachel Korine,Harmony Korine,94,Drama|Crime,2013-01-24,996,5.0,2013,4680166,29694987,25014821,5
5474,1.559076,13000000,68572378,55572378,The Call,Halle Berry|Abigail Breslin|Morris Chestnut|Michael Imperioli|Ella Rae Peck,Brad Anderson,94,Thriller,2013-03-14,960,6.6,2013,12168433,64186032,52017599,7
5475,1.526466,17000000,97542952,80542952,Evil Dead,Jane Levy|Jessica Lucas|Shiloh Fernandez|Lou Taylor Pucci|Elizabeth Blackmore,Fede Alvarez,91,Horror,2013-04-05,1254,6.3,2013,15912566,91303456,75390890,6
5476,1.496605,28000000,134402450,106402450,Last Vegas,Robert De Niro|Morgan Freeman|Michael Douglas|Kevin Kline|Mary Steenburgen,Jon Turteltaub,105,Comedy,2013-10-31,563,6.4,2013,26208933,125805175,99596242,6
5477,1.483329,30000000,36894225,6894225,The Family,Robert De Niro|Michelle Pfeiffer|Dianna Agron|John D'Leo|Tommy Lee Jones,Luc Besson,111,Crime|Comedy|Action,2013-09-13,710,6.1,2013,28081000,34534225,6453225,6
5480,1.454579,15000000,35485608,20485608,The Place Beyond the Pines,Ryan Gosling|Bradley Cooper|Eva Mendes|Dane DeHaan|Emory Cohen,Derek Cianfrance,140,Drama|Crime,2013-03-20,1116,6.7,2013,14040500,33215712,19175212,7
5481,1.447973,80000000,246984278,166984278,Grown Ups 2,Adam Sandler|Kevin James|Chris Rock|David Spade|Salma Hayek,Dennis Dugan,100,Comedy,2013-07-11,806,5.9,2013,74882668,231185521,156302853,6
5482,1.439458,103000000,362000072,259000072,The Hangover Part III,Bradley Cooper|Ed Helms|Zach Galifianakis|Justin Bartha|Ken Jeong,Todd Phillips,100,Comedy,2013-05-23,2010,6.0,2013,96411435,338844141,242432706,6
5483,1.432796,135000000,585178928,450178928,The Croods,Nicolas Cage|Emma Stone|Ryan Reynolds|Catherine Keener|Cloris Leachman,Kirk De Micco|Chris Sanders,98,Adventure|Animation|Comedy|Family|Fantasy,2013-03-20,1755,6.8,2013,126364502,547746993,421382491,7
5484,1.419386,22000000,43058898,21058898,Homefront,Jason Statham|James Franco|Izabela Vidovic|Winona Ryder|Rachelle Lefevre,Gary Fleder,100,Action|Thriller,2013-11-27,618,6.4,2013,20592733,40304564,19711831,6
5485,1.41459,50000000,122915111,72915111,Escape Plan,Sylvester Stallone|Arnold Schwarzenegger|Jim Caviezel|Vinnie Jones|50 Cent,Mikael HÃ¥fstrÃ¶m,115,Action|Thriller,2013-10-09,1114,6.7,2013,46801667,115052643,68250976,7
5486,1.412233,30000000,82394288,52394288,Carrie,ChloÃ« Grace Moretz|Julianne Moore|Judy Greer|Alex Russell|Portia Doubleday,Kimberly Peirce,100,Drama|Horror,2013-10-16,897,5.8,2013,28081000,77123801,49042801,6
5487,1.40572,55000000,95000000,40000000,Captain Phillips,Tom Hanks|Catherine Keener|Max Martini|Chris Mulkey|Yul Vazquez,Paul Greengrass,134,Action|Drama|Thriller,2013-10-10,1729,7.7,2013,51481834,88923168,37441334,8
5488,1.388168,25000000,71009334,46009334,The Counselor,Michael Fassbender|Cameron Diaz|Javier Bardem|Goran Visnjic|PenÃ©lope Cruz,Ridley Scott,117,Thriller|Crime|Drama,2013-10-25,497,4.9,2013,23400833,66467104,43066271,5
5489,1.375772,150000000,205366737,55366737,White House Down,Channing Tatum|Jamie Foxx|Joey King|Maggie Gyllenhaal|Richard Jenkins,Roland Emmerich,131,Action|Drama|Thriller,2013-06-27,1371,6.4,2013,140405002,192230115,51825113,6
5490,1.366699,8000000,63464861,55464861,Begin Again,Mark Ruffalo|Keira Knightley|Adam Levine|Hailee Steinfeld|Catherine Keener,John Carney,104,Comedy|Music|Romance|Drama,2013-09-07,880,7.2,2013,7488266,59405226,51916960,7
5491,1.363563,35000000,21819348,-13180652,The Big Wedding,Robert De Niro|Diane Keaton|Katherine Heigl|Amanda Seyfried|Topher Grace,Justin Zackham,90,Comedy,2013-04-25,283,5.6,2013,32761167,20423637,-12337530,6
5492,1.358934,12000000,1456675,-10543325,Life of Crime,John Hawkes|Mos Def|Jennifer Aniston|Tim Robbins|Isla Fisher,Daniel Schechter,94,Comedy|Crime,2013-09-14,94,5.6,2013,11232400,1363496,-9868904,6
5494,1.3317,195000000,197687603,2687603,Jack the Giant Slayer,Nicholas Hoult|Eleanor Tomlinson|Ewan McGregor|Stanley Tucci|Ian McShane,Bryan Singer,114,Action|Family|Fantasy,2013-02-27,2186,5.5,2013,182526503,185042189,2515686,5
5495,1.321896,30000000,62616646,32616646,Runner Runner,Ben Affleck|Gemma Arterton|Justin Timberlake|Anthony Mackie|David Costabile,Brad Furman,91,Crime|Thriller|Drama,2013-09-24,413,5.5,2013,28081000,58611269,30530269,5
5496,1.319947,55000000,9489829,-45510171,Bullet to the Head,Sylvester Stallone|Sung Kang|Sarah Shahi|Adewale Akinnuoye-Agbaje|Jason Momoa,Walter Hill,92,Action|Crime|Thriller,2013-01-31,347,5.2,2013,51481834,8882796,-42599038,5
5497,1.316881,11000000,7847000,-3153000,What If,Daniel Radcliffe|Zoe Kazan|Rafe Spall|Megan Park|Adam Driver,Michael Dowse,93,Drama|Comedy|Romance,2013-09-07,482,6.7,2013,10296366,7345053,-2951313,7
5498,1.30454,26000000,51164106,25164106,Delivery Man,Vince Vaughn|Cobie Smulders|Chris Pratt|Britt Robertson|Jack Reynor,Ken Scott,105,Comedy,2013-10-10,377,6.1,2013,24336867,47891309,23554442,6
5499,1.302011,32000000,126041322,94041322,This Is the End,James Franco|Jonah Hill|Seth Rogen|Jay Baruchel|Danny McBride,Seth Rogen|Evan Goldberg,107,Action|Comedy,2013-06-12,1687,6.2,2013,29953067,117978881,88025814,6
5500,1.291008,15000000,151831537,136831537,Jackass Presents: Bad Grandpa,Johnny Knoxville|Jackson Nicoll|Georgina Cates|Spike Jonze|Catherine Keener,Jeff Tremaine,92,Comedy,2013-10-22,496,6.1,2013,14040500,142119382,128078882,6
5501,1.290891,35000000,46216641,11216641,Parker,"Jason Statham|Jennifer Lopez|Nick Nolte|Michael Chiklis|Clifton Collins, Jr.",Taylor Hackford,118,Action|Crime,2013-01-23,1196,5.6,2013,32761167,43260317,10499150,6
5502,1.28446,130000000,243843127,113843127,After Earth,Jaden Smith|Will Smith|Sophie Okonedo|ZoÃ« Kravitz|Glenn Morshower,M. Night Shyamalan,100,Science Fiction|Action|Adventure,2013-05-30,1792,5.1,2013,121684335,228245299,106560964,5
5504,1.275381,43000000,158674180,115674180,The Heat,Sandra Bullock|Melissa McCarthy|DemiÃ¡n Bichir|Michael Rapaport|Taran Killam,Paul Feig,117,Action|Comedy|Crime,2013-06-27,1166,6.6,2013,40249434,148524324,108274890,7
5505,1.261132,35000000,112544580,77544580,Saving Mr. Banks,Emma Thompson|Tom Hanks|Paul Giamatti|Colin Farrell|Ruth Wilson,John Lee Hancock,125,Comedy|Drama|History,2013-11-16,811,7.3,2013,32761167,105345480,72584313,7
5506,1.251506,28000000,29000000,1000000,Kick-Ass 2,Aaron Taylor-Johnson|ChloÃ« Grace Moretz|Christopher Mintz-Plasse|Clark Duke|Jim Carrey,Jeff Wadlow,103,Action|Adventure|Crime,2013-07-17,1479,6.3,2013,26208933,27144967,936034,6
5507,1.227417,5000000,44030246,39030246,Oculus,Katee Sackhoff|Karen Gillan|Brenton Thwaites|James Lafferty|Rory Cochrane,Mike Flanagan,104,Horror,2013-09-08,665,6.2,2013,4680166,41213778,36533612,6
5508,1.21451,255000000,89289910,-165710090,The Lone Ranger,Johnny Depp|Armie Hammer|William Fichtner|Helena Bonham Carter|James Badge Dale,Gore Verbinski,149,Action|Adventure|Western,2013-07-03,1607,6.0,2013,238688504,83578333,-155110171,6
5509,1.212556,60000000,105200903,45200903,Gangster Squad,Sean Penn|Ryan Gosling|Emma Stone|Josh Brolin|Nick Nolte,Ruben Fleischer,113,Crime|Drama|Action|Thriller,2013-01-10,1352,6.1,2013,56162001,98471553,42309552,6
5510,1.200825,35000000,173965010,138965010,Identity Thief,Jason Bateman|Melissa McCarthy|Jon Favreau|Amanda Peet|T.I.,Seth Gordon,111,Comedy|Crime,2013-02-07,1361,5.6,2013,32761167,162837051,130075884,6
5512,1.188033,12000000,12077441,77441,Stoker,Mia Wasikowska|Nicole Kidman|Matthew Goode|Dermot Mulroney|Jacki Weaver,Chan-wook Park,99,Drama|Horror|Thriller,2013-02-28,594,6.3,2013,11232400,11304887,72487,6
5514,1.134425,9000000,6108720,-2891280,All Is Lost,Robert Redford,J.C. Chandor,106,Action|Adventure|Drama,2013-10-18,463,6.5,2013,8424300,5717965,-2706335,6
5515,1.120621,20000000,47241945,27241945,Texas Chainsaw 3D,Alexandra Daddario|Dan Yeager|Bill Moseley|Marilyn Burns|Tania Raymonde,John Luessenhop,92,Horror|Thriller,2013-01-03,302,5.4,2013,18720667,44220036,25499369,5
5516,1.116296,2500000,6854611,4354611,The Spectacular Now,Miles Teller|Shailene Woodley|Brie Larson|Dayo Okeniyi|Masam Holden,James Ponsoldt,95,Comedy|Drama|Romance,2013-08-02,669,6.8,2013,2340083,6416144,4076061,7
5517,1.114792,20000000,24261569,4261569,Trance,James McAvoy|Vincent Cassel|Rosario Dawson|Matt Cross|Danny Sapani,Danny Boyle,101,Thriller|Crime|Drama|Mystery,2013-03-27,666,6.4,2013,18720667,22709637,3988970,6
5518,1.108437,50000000,173649015,123649015,Anchorman 2: The Legend Continues,Will Ferrell|Steve Carell|Paul Rudd|Christina Applegate|David Koechner,Adam McKay,119,Comedy,2013-12-18,639,6.0,2013,46801667,162541269,115739602,6
5520,1.094958,200000000,491868548,291868548,Oz: The Great and Powerful,James Franco|Mila Kunis|Rachel Weisz|Michelle Williams|Zach Braff,Sam Raimi,130,Fantasy|Adventure|Family,2013-03-07,2855,5.6,2013,187206670,460405366,273198696,6
5521,1.089268,135000000,282570682,147570682,Turbo,Ryan Reynolds|Paul Giamatti|Michael PeÃ±a|Samuel L. Jackson|Luis GuzmÃ¡n,David Soren,96,Animation|Family,2013-07-11,805,6.1,2013,126364502,264495582,138131080,6
5522,1.078745,20000000,8352885,-11647115,Redemption,Jason Statham|Agata Buzek|Vicky McClure|Lee Asquith-Coe|Benedict Wong,Steven Knight,100,Action|Thriller,2013-05-07,415,5.7,2013,18720667,7818578,-10902089,6
5523,1.07557,25000000,86175291,61175291,Pain & Gain,Mark Wahlberg|Dwayne Johnson|Anthony Mackie|Tony Shalhoub|Ed Harris,Michael Bay,130,Thriller|Crime|Action,2013-04-18,1143,6.1,2013,23400833,80662946,57262113,6
5526,1.06549,44000000,63327201,19327201,The Host,Saoirse Ronan|Diane Kruger|Jake Abel|William Hurt|Frances Fisher,Andrew Niccol,125,Action|Adventure|Romance|Science Fiction|Thriller,2013-03-22,1399,6.0,2013,41185467,59276372,18090905,6
5527,1.064357,30000000,4861022,-25138978,Oldboy,Josh Brolin|Elizabeth Olsen|Samuel L. Jackson|Sharlto Copley|Lance Reddick,Spike Lee,104,Drama|Thriller|Mystery|Action,2013-11-14,403,6.0,2013,28081000,4550078,-23530922,6
5528,1.055997,18000000,20275812,2275812,Labor Day,Josh Brolin|Kate Winslet|Gattlin Griffith|Tobey Maguire|Tom Lipinski,Jason Reitman,111,Drama,2013-12-27,189,6.6,2013,16848600,18978836,2130236,7
5529,1.054366,15000000,146497771,131497771,Mama,Jessica Chastain|Nikolaj Coster-Waldau|Megan Charpentier|Isabelle NÃ©lisse|Daniel Kash,Andy Muschietti,100,Horror,2013-01-17,931,6.0,2013,14040500,137126799,123086299,6
5531,1.047604,32000000,57284237,25284237,The Physician,Tom Payne|Ben Kingsley|Stellan SkarsgÃ¥rd|Olivier Martinez|Emma Rigby,Philipp StÃ¶lzl,155,Adventure|Drama|History,2013-12-25,253,7.2,2013,29953067,53619956,23666889,7
5532,1.047374,13000000,18000000,5000000,Admission,Tina Fey|Paul Rudd|Ann Harada|Ben Levin|Dan Levy,Paul Weitz,107,Comedy|Drama|Romance,2013-03-21,230,5.4,2013,12168433,16848600,4680167,5
5534,1.031715,25000000,115922175,90922175,The Butler,Forest Whitaker|David Banner|Michael Rainey Jr.|LaJessie Smith|Mariah Carey,Lee Daniels,132,Drama,2013-08-16,724,7.2,2013,23400833,108507022,85106189,7
5535,1.020237,6000000,32438988,26438988,Movie 43,Dennis Quaid|Greg Kinnear|Common|Charlie Saxton|Will Sasso,Steven Brill|Elizabeth Banks|Steve Carr|Rusty Cundieff|James Duffy|Griffin Dunne|Peter Farrelly|Patrik Forsberg|James Gunn|Brett Ratner|Will Graham|Jonathan van Tulleken,90,Comedy,2013-01-01,564,4.4,2013,5616200,30363974,24747774,4
5536,1.010837,13000000,48065672,35065672,21 & Over,Miles Teller|Skylar Astin|Justin Chon|Sarah Wright|Jonathan Keltz,Scott Moore|Jon Lucas,93,Comedy,2013-03-01,594,5.7,2013,12168433,44991072,32822639,6
5537,1.002527,40000000,74597643,34597643,Escape from Planet Earth,Brendan Fraser|Rob Corddry|Ricky Gervais|Jessica Alba|Sarah Jessica Parker,Callan Brunker,89,Animation|Comedy|Adventure|Family|Science Fiction,2013-02-14,242,5.8,2013,37441334,69825881,32384547,6
5538,0.983805,40000000,44907260,4907260,Grudge Match,Robert De Niro|Sylvester Stallone|Alan Arkin|Jon Bernthal|Kevin Hart,Peter Segal,113,Comedy,2013-12-25,280,6.0,2013,37441334,42034693,4593359,6
5539,0.976612,10900000,16505460,5605460,Belle,Gugu Mbatha-Raw|Tom Wilkinson|Miranda Richardson|Penelope Wilton|Emily Watson,Amma Asante,105,Drama,2013-09-08,138,7.1,2013,10202763,15449661,5246898,7
5541,0.968034,12000000,15008161,3008161,Machete Kills,Danny Trejo|Mel Gibson|Amber Heard|Michelle Rodriguez|SofÃ­a Vergara,Robert Rodriguez,107,Action|Crime|Thriller,2013-09-12,399,5.2,2013,11232400,14048139,2815739,5
5542,0.96795,28000000,97594140,69594140,Safe Haven,Julianne Hough|Josh Duhamel|Cobie Smulders|David Lyons|Mike Pniewski,Lasse HallstrÃ¶m,115,Romance,2013-02-07,591,6.8,2013,26208933,91351370,65142437,7
5545,0.941711,9500000,7800000,-1700000,Bad Words,Jason Bateman|Kathryn Hahn|Allison Janney|Philip Baker Hall|Rohan Chand,Jason Bateman,88,Comedy,2013-09-06,227,6.2,2013,8892316,7301060,-1591256,6
5546,0.939402,15000000,19145732,4145732,The Bling Ring,Emma Watson|Israel Broussard|Taissa Farmiga|Katie Chang|Claire Julien,Sofia Coppola,90,Drama|Crime,2013-06-12,714,5.3,2013,14040500,17921043,3880543,5
5547,0.937954,11000000,3639345,-7360655,Empire State,Liam Hemsworth|Dwayne Johnson|Emma Roberts|Nikki Reed|Lydia Hull,Dito Montiel,94,Action|Drama,2013-09-03,157,5.0,2013,10296366,3406548,-6889818,5
5548,0.934716,23000000,15600000,-7400000,Behind the Candelabra,Michael Douglas|Matt Damon|Rob Lowe|Dan Aykroyd|Scott Bakula,Steven Soderbergh,118,Drama|Romance,2013-05-26,209,6.6,2013,21528767,14602120,-6926647,7
5549,0.932599,78000000,248384621,170384621,Cloudy with a Chance of Meatballs 2,Bill Hader|Anna Faris|James Caan|Will Forte|Andy Samberg,Cody Cameron|Kris Pearn,95,Animation|Family|Comedy,2013-09-26,637,6.4,2013,73010601,232496289,159485688,6
5551,0.92639,18000000,97505481,79505481,Blue Jasmine,Cate Blanchett|Alec Baldwin|Sally Hawkins|Bobby Cannavale|Louis C.K.,Woody Allen,98,Comedy|Drama,2013-07-25,680,6.9,2013,16848600,91268382,74419782,7
5552,0.921438,28000000,1021398,-26978602,Third Person,Liam Neeson|Mila Kunis|James Franco|Olivia Wilde|Adrien Brody,Paul Haggis,137,Drama|Romance,2013-09-09,146,5.6,2013,26208933,956062,-25252871,6
5556,0.892454999999999,2500000,60141683,57641683,A Haunted House,Marlon Wayans|Essence Atkins|Nick Swardson|Cedric the Entertainer|David Koechner,Michael Tiddes,86,Comedy|Horror,2013-01-11,345,5.5,2013,2340083,56294621,53954538,5
5557,0.890458,4800000,10337387,5537387,Only God Forgives,Ryan Gosling|Kristin Scott Thomas|Gordon Brown|Tom Burke|Vithaya Pansringarm,Nicolas Winding Refn,90,Drama|Thriller|Crime,2013-05-30,562,5.3,2013,4492960,9676139,5183179,5
5558,0.886993,30000000,63372757,33372757,Side Effects,Rooney Mara|Jude Law|Channing Tatum|Catherine Zeta-Jones|Vinessa Shaw,Steven Soderbergh,106,Thriller|Crime|Drama,2013-02-07,987,6.3,2013,28081000,59319014,31238014,6
5561,0.873687999999999,13500000,19255873,5755873,La migliore offerta,Geoffrey Rush|Jim Sturgess|Sylvia Hoeks|Donald Sutherland|Maximilian Dirr,Giuseppe Tornatore,124,Drama|Romance|Crime|Mystery,2013-01-01,389,7.7,2013,12636450,18024139,5387689,8
5562,0.869067,30000000,27437881,-2562119,The Incredible Burt Wonderstone,Steve Carell|Jim Carrey|Steve Buscemi|Olivia Wilde|James Gandolfini,Don Scardino,100,Comedy,2013-03-14,587,5.2,2013,28081000,25682771,-2398229,5
5563,0.864696999999999,10000000,21587700,11587700,Mud,Matthew McConaughey|Tye Sheridan|Jacob Lofland|Sam Shepard|Reese Witherspoon,Jeff Nichols,130,Drama,2013-05-01,739,6.9,2013,9360333,20206807,10846474,7
5566,0.860381,16000000,318982,-15681018,Adore,Naomi Watts|Robin Wright|Xavier Samuel|James Frecheville|Ben Mendelsohn,Anne Fontaine,100,Drama,2013-04-03,185,6.2,2013,14976533,298577,-14677956,6
5567,0.859276,18000000,22309223,4309223,The Railway Man,Jeremy Irvine|Colin Firth|Stellan SkarsgÃ¥rd|Michael MacKenzie|Nicole Kidman,Jonathan Teplitzky,116,Drama|History,2013-12-26,181,6.6,2013,16848600,20882176,4033576,7
5568,0.844465999999999,56000000,19701164,-36298836,Broken City,Mark Wahlberg|Russell Crowe|Catherine Zeta-Jones|Jeffrey Wright|Barry Pepper,Allen Hughes,109,Thriller|Crime|Drama,2013-01-18,438,5.7,2013,52417867,18440946,-33976921,6
5572,0.816581,80000000,126546518,46546518,Walking With Dinosaurs,Charlie Rowe|Justin Long|Karl Urban|Angourie Rice|John Leguizamo,Neil Nightingale|Barry Cook,87,Animation|Family|Adventure,2013-12-18,92,5.0,2013,74882668,118451761,43569093,5
5575,0.799644999999999,2900000,74918,-2825082,No One Lives,Luke Evans|Adelaide Clemens|Lee Tergesen|Derek Magyar|America Olivo,RyÃ»hei Kitamura,86,Horror|Thriller,2013-03-09,83,5.3,2013,2714496,70125,-2644371,5
5576,0.794369,8500000,9747,-8490253,Welcome to the Punch,James McAvoy|Mark Strong|David Morrissey|Peter Mullan|Daniel Mays,Eran Creevy,99,Action|Adventure|Crime,2013-03-15,198,5.5,2013,7956283,9123,-7947160,5
5577,0.787443,60000000,60052138,52138,Beautiful Creatures,Alden Ehrenreich|Alice Englert|Jeremy Irons|Viola Davis|Emmy Rossum,Richard LaGravenese,124,Fantasy|Drama|Romance,2013-02-13,650,5.5,2013,56162001,56210804,48803,5
5578,0.784571,27220000,5496951,-21723049,The Frozen Ground,Nicolas Cage|Vanessa Hudgens|John Cusack|Radha Mitchell|Jodi Lyn O'Keefe,Scott Walker,105,Thriller|Crime,2013-07-18,304,6.2,2013,25478827,5145329,-20333498,6
5579,0.782462,105000000,347434178,242434178,The Smurfs 2,Neil Patrick Harris|Christina Ricci|Katy Perry|Hank Azaria|Brendan Gleeson,Raja Gosnell,105,Fantasy|Family|Comedy|Animation,2013-07-30,498,5.5,2013,98283502,325209978,226926476,5
5580,0.779447999999999,16000000,5867686,-10132314,The Immigrant,Jeremy Renner|Marion Cotillard|Joaquin Phoenix|Dagmara DomiÅ„czyk|Gabriel Rush,James Gray,120,Drama|Romance,2013-07-03,163,6.0,2013,14976533,5492349,-9484184,6
5581,0.774149,40000000,95020213,55020213,42,Chadwick Boseman|T.R. Knight|Harrison Ford|Nicole Beharie|Christopher Meloni,Brian Helgeland,128,Drama,2013-04-12,648,6.8,2013,37441334,88942088,51500754,7
5582,0.765495,10000000,1585582,-8414418,Lovelace,Amanda Seyfried|Peter Sarsgaard|Hank Azaria|Adam Brody|James Franco,Rob Epstein|Jeffrey Friedman,92,Drama,2013-08-08,147,6.0,2013,9360333,1484157,-7876176,6
5584,0.752327,4600000,23198652,18598652,The Way Way Back,Liam James|Steve Carell|Toni Collette|AnnaSophia Robb|Sam Rockwell,Jim Rash|Nat Faxon,103,Comedy|Drama,2013-06-06,490,7.1,2013,4305753,21714712,17408959,7
5585,0.751379,28000000,8555008,-19444992,The Fifth Estate,Benedict Cumberbatch|Dan Stevens|Daniel BrÃ¼hl|Alicia Vikander|Carice van Houten,Bill Condon,128,Drama|Thriller,2013-10-11,231,5.6,2013,26208933,8007772,-18201161,6
5586,0.74452,25000000,6399,-24993601,The Adventurer: The Curse of the Midas Box,Aneurin Barnard|Michael Sheen|Lena Headey|Sam Neill|Ioan Gruffudd,Jonathan Newman,99,Fantasy|Adventure|Family,2013-12-05,49,5.2,2013,23400833,5989,-23394844,5
5587,0.744185,25500000,2415472,-23084528,Blood Ties,Clive Owen|Billy Crudup|Marion Cotillard|Mila Kunis|Zoe Saldana,Guillaume Canet,128,Thriller|Crime|Drama,2013-08-22,125,5.8,2013,23868850,2260962,-21607888,6
5588,0.734349,120000000,415440673,295440673,The Wolverine,Hugh Jackman|Tao Okamoto|Rila Fukushima|Hiroyuki Sanada|Svetlana Khodchenkova,James Mangold,126,Action|Science Fiction|Adventure|Fantasy,2013-07-23,2986,6.4,2013,112324002,388866326,276542324,6
5589,0.733975,35000000,42930462,7930462,Snitch,Dwayne Johnson|Barry Pepper|Jon Bernthal|Susan Sarandon|Michael Kenneth Williams,Ric Roman Waugh,112,Thriller|Drama,2013-02-21,917,5.7,2013,32761167,40184344,7423177,6
5590,0.732485,55000000,110000000,55000000,Free Birds,Owen Wilson|Woody Harrelson|Amy Poehler|George Takei|Colm Meaney,Jimmy Hayward,91,Animation|Comedy|Family,2013-10-30,185,5.8,2013,51481834,102963668,51481834,6
5591,0.724877,12000000,17654912,5654912,Nebraska,Bruce Dern|Will Forte|Bob Odenkirk|June Squibb|Stacy Keach,Alexander Payne,115,Drama|Adventure,2013-09-21,400,7.3,2013,11232400,16525586,5293186,7
5593,0.723277,20000000,78378744,58378744,Scary Movie 5,Simon Rex|Ashley Tisdale|Charlie Sheen|Lindsay Lohan|Erica Ash,Malcolm D. Lee,86,Comedy,2013-04-11,532,4.6,2013,18720667,73365118,54644451,5
5598,0.707968,25000000,2054941,-22945059,Man of Tai Chi,Keanu Reeves|Tiger Hu Chen|Jeremy Marinas|Steven Dasz|Karen Mok,Keanu Reeves,105,Action|Drama,2013-07-04,193,5.6,2013,23400833,1923493,-21477340,6
5599,0.707197,8500000,22456509,13956509,Baggage Claim,Paula Patton|Adam Brody|Djimon Hounsou|Taye Diggs|Christina Milian,David E. Talbert,96,Comedy,2013-09-27,65,5.8,2013,7956283,21020041,13063758,6
5603,0.687654,25000000,74188937,49188937,August: Osage County,Meryl Streep|Julia Roberts|Chris Cooper|Ewan McGregor|Margo Martindale,John Wells,121,Comedy|Drama,2013-12-26,307,6.8,2013,23400833,69443319,46042486,7
5615,0.639506,3000000,11176469,8176469,Before Midnight,Ethan Hawke|Julie Delpy|Seamus Davey-Fitzpatrick|Jennifer Prior|Charlotte Prior,Richard Linklater,108,Romance|Drama,2013-04-05,346,7.1,2013,2808100,10461547,7653447,7
5618,0.625753,5000000,86362372,81362372,Paranormal Activity: The Marked Ones,Richard Cabral|Carlos Pratts|Eddie J. Fernandez|Jorge Diaz|David Fernandez Jr.,Christopher B. Landon,84,Horror|Thriller,2013-12-31,283,5.3,2013,4680166,80838060,76157894,5
5624,0.598453,12000000,35931410,23931410,Jobs,Ashton Kutcher|Dermot Mulroney|Amanda Crew|James Woods|Josh Gad,Joshua Michael Stern,128,Drama|History,2013-08-16,908,6.0,2013,11232400,33632998,22400598,6
5625,0.596009,3500000,25174316,21674316,Dark Skies,Keri Russell|Josh Hamilton|Dakota Goyo|J.K. Simmons|Trevor St. John,Scott Stewart,97,Science Fiction|Thriller|Horror,2013-02-21,404,6.0,2013,3276116,23563999,20287883,6
5626,0.592819,1000000,2963902,1963902,In a World...,Lake Bell|Fred Melamed|Michaela Watkins|Ken Marino|Demetri Martin,Lake Bell,93,Comedy,2013-08-09,143,6.4,2013,936033,2774311,1838278,6
5628,0.58119,35000000,13785015,-21214985,Paranoia,Liam Hemsworth|Harrison Ford|Gary Oldman|Amber Heard|Josh Holloway,Robert Luketic,106,Drama|Thriller,2013-08-14,238,5.6,2013,32761167,12903233,-19857934,6
5636,0.5641,5000000,1189612,-3810388,Repentance,Forest Whitaker|Anthony Mackie|Sanaa Lathan|Nicole Ari Parker|Mike Epps,Philippe Caland,90,Horror|Thriller,2013-01-20,18,4.8,2013,4680166,1113516,-3566650,5
5644,0.54416,22000000,15400000,-6600000,Out of the Furnace,Christian Bale|Zoe Saldana|Woody Harrelson|Sam Shepard|Willem Dafoe,Scott Cooper,116,Thriller|Drama|Crime,2013-12-06,469,6.4,2013,20592733,14414913,-6177820,6
5645,0.53635,1500000,3566225,2066225,The To Do List,Aubrey Plaza|Johnny Simmons|Bill Hader|Alia Shawkat|Sarah Steele,Maggie Carey,104,Comedy|Romance,2013-07-24,225,5.6,2013,1404050,3338105,1934055,6
5650,0.522347,160000000,788679850,628679850,Fast & Furious 6,Paul Walker|Vin Diesel|Dwayne Johnson|Jordana Brewster|Luke Evans,Justin Lin,130,Action|Thriller|Crime,2013-05-06,4368,6.6,2013,149765336,738230644,588465308,7
5656,0.506169,20000000,16549477,-3450523,Battle of the Year,Josh Holloway|Josh Peck|Chris Brown|Laz Alonso|Caity Lotz,Benson Lee,110,Music|Drama,2013-09-21,62,5.9,2013,18720667,15490862,-3229805,6
5661,0.476673,100000,444098,344098,Upstream Color,Amy Seimetz|Shane Carruth|Andrew Sensenig|Thiago Martins|Carolyn King,Shane Carruth,96,Drama|Science Fiction,2013-04-05,163,6.5,2013,93603,415690,322087,6
5673,0.457857,20000000,27187375,7187375,Khumba,Jake T. Austin|Liam Neeson|Steve Buscemi|AnnaSophia Robb|Laurence Fishburne,Anthony Silverston,85,Animation|Adventure|Family,2013-07-18,51,5.8,2013,18720667,25448289,6727622,6
5674,0.457768,10000000,30283,-9969717,Jimmy P.,Benicio del Toro|Mathieu Amalric|Elya Baskin|A Martinez|Misty Upham,Arnaud Desplechin,117,Drama,2013-09-11,18,4.6,2013,9360333,28345,-9331988,5
5679,0.442256,17500000,7018189,-10481811,Black Nativity,Forest Whitaker|Angela Bassett|Jennifer Hudson|Tyrese Gibson|Jacob Latimore,Kasi Lemmons,93,Drama|Music,2013-11-27,10,6.2,2013,16380583,6569258,-9811325,6
5697,0.412492,4000000,9221,-3990779,The Sacrament,Joe Swanberg|AJ Bowen|Kentucker Audley|Gene Jones|Amy Seimetz,Ti West,99,Mystery|Horror|Thriller,2013-09-02,69,5.4,2013,3744133,8631,-3735502,5
5704,0.387592,7000000,6147,-6993853,Sweetwater,Ed Harris|January Jones|Jason Isaacs|Eduardo Noriega|Jason Aldean,Logan Miller,95,Western|Thriller,2013-01-24,41,5.7,2013,6552233,5753,-6546480,6
5713,0.381676,10000000,1034589,-8965411,Phantom,Ed Harris|David Duchovny|Lance Henriksen|William Fichtner|Johnathon Schaech,Todd Robinson,99,Thriller,2013-01-03,77,5.4,2013,9360333,968409,-8391924,5
5722,0.364964,8000000,9630444,1630444,Wolf Creek 2,John Jarratt|Ryan Corr|Shannon Ashlyn|Phillipe Klaus|Gerard Kennedy,Greg McLean,106,Horror|Thriller,2013-08-30,81,5.6,2013,7488266,9014416,1526150,6
5727,0.359864,18000000,7972967,-10027033,Metallica: Through the Never,Dane DeHaan|Mackenzie Gray|James Hetfield|Lars Ulrich|Kirk Hammett,NimrÃ³d Antal,93,Music,2013-09-25,53,6.6,2013,16848600,7462963,-9385637,7
5732,0.354271,70000000,18662027,-51337973,Legends of Oz: Dorothy's Return,Lea Michele|Dan Aykroyd|Patrick Stewart|Hugh Dancy|Jim Belushi,Dan St. Pierre,88,Animation|Music|Family,2013-06-13,36,6.1,2013,65522334,17468279,-48054055,6
5741,0.341686,4900000,2159041,-2740959,Austenland,Keri Russell|J. J. Feild|Bret McKenzie|Jennifer Coolidge|James Callis,Jerusha Hess,97,Comedy|Romance,2013-08-15,111,6.6,2013,4586563,2020934,-2565629,7
5746,0.33771,6500000,2401510,-4098490,The East,Brit Marling|Alexander SkarsgÃ¥rd|Ellen Page|Toby Kebbell|Shiloh Fernandez,Zal Batmanglij,116,Drama|Thriller,2013-05-31,179,6.3,2013,6084216,2247893,-3836323,6
5750,0.332741,17000000,71625195,54625195,The Best Man Holiday,Terrence Howard|Harold Perrineau|Morris Chestnut|Sanaa Lathan|Taye Diggs,Malcolm D. Lee,123,Comedy,2013-11-15,78,7.0,2013,15912566,67043571,51131005,7
5772,0.312975,33000000,9494789,-23505211,The Young and Prodigious T.S. Spivet,Kyle Catlett|Helena Bonham Carter|Judy Davis|Callum Keith Rennie|Niamh Wilson,Jean-Pierre Jeunet,105,Adventure|Drama|Family,2013-10-16,157,6.7,2013,30889100,8887439,-22001661,7
5775,0.510294999999999,250000,56825,-193175,The Canyons,Lindsay Lohan|Gus Van Sant|James Deen|Nolan Gerard Funk|Amanda Brooks,Paul Schrader,99,Thriller|Drama,2013-07-29,41,4.4,2013,234008,53190,-180818,4
5785,0.296763,15,122,107,Make Your Move,Derek Hough|BoA|Will Yun Lee|Izabella Miko|Miki Ishikawa,Duane Adler,110,Music,2013-08-07,20,5.9,2013,14,114,100,6
5787,0.295687,4000000,350006,-3649994,The Face of Love,Annette Bening|Ed Harris|Robin Williams|Jess Weixler|Amy Brenneman,Arie Posin,92,Drama|Romance,2013-10-25,30,5.8,2013,3744133,327617,-3416516,6
5812,0.273681,10000000,653651,-9346349,Parkland,Zac Efron|Billy Bob Thornton|Ron Livingston|Tom Welling|Paul Giamatti,Peter Landesman,94,History|Drama|Thriller|Mystery,2013-10-02,86,5.8,2013,9360333,611839,-8748494,6
5833,0.238632,5000000,15179302,10179302,The Last Exorcism Part II,Ashley Bell|Julia Garner|Andrew Sensenig|Spencer Treat Clark|Judd Lormand,Ed Gass-Donnelly,88,Horror|Thriller,2013-02-28,145,4.5,2013,4680166,14208332,9528166,4
5837,0.230595,6000000,1066471,-4933529,What Maisie Knew,Alexander SkarsgÃ¥rd|Julianne Moore|Steve Coogan|Onata Aprile|Joanna Vanderham,Scott McGehee|David Siegel,93,Drama,2013-05-02,98,7.5,2013,5616200,998252,-4617948,7
5840,0.229656,35000000,27330000,-7670000,Mandela: Long Walk to Freedom,Idris Elba|Naomie Harris|Tony Kgoroge|Riaad Moosa|Fana Mokoena,Justin Chadwick,141,Drama|History,2013-12-06,165,6.5,2013,32761167,25581791,-7179376,6
5846,0.227851,12000000,100129872,88129872,Philomena,Judi Dench|Steve Coogan|Sophie Kennedy Clark|Mare Winningham|Barbara Jefford,Stephen Frears,98,Drama,2013-11-01,360,7.4,2013,11232400,93724899,82492499,7
5852,0.222776,10,11,1,Hross Ã­ oss,Ingvar Eggert SigurÃ°sson|Charlotte BÃ¸ving|Steinn Ãrmann MagnÃºsson|KristbjÃ¶rg Kjeld|Helgi BjÃ¶rnsson,Benedikt Erlingsson,85,Drama|Romance|Comedy,2013-08-30,11,6.5,2013,9,10,1,6
5860,0.457265,15000000,21766271,6766271,Diana,Naomi Watts|Naveen Andrews|Charles Edwards|Douglas Hodge|Lee Asquith-Coe,Oliver Hirschbiegel,113,Drama|Romance,2013-09-19,122,5.0,2013,14040500,20373955,6333455,5
5875,0.384555,7500000,1359910,-6140090,Gimme Shelter,Vanessa Hudgens|Rosario Dawson|Brendan Fraser|Stephanie Szostak|James Earl Jones,Ron Krauss,101,Drama,2013-10-17,55,6.4,2013,7020250,1272921,-5747329,6
5903,0.367908,18000000,10501938,-7498062,Getaway,Ethan Hawke|Selena Gomez|Jon Voight|Paul Freeman|Bruce Payne,Courtney Solomon,90,Action|Crime,2013-08-29,174,5.0,2013,16848600,9830164,-7018436,5
5908,0.171647,1052753,466088,-586665,On the Job,Piolo Pascual|Gerald Anderson|Angel Aquino|Shaina Magdayao|Michael De Mesa,Erik Matti,120,Action|Crime,2013-05-23,23,5.9,2013,985411,436273,-549138,6
5932,0.411515,3000000,1675381,-1324619,Nothing Left to Fear,Clancy Brown|James Tupper|Anne Heche|Ethan Peck|Jennifer Stone,Anthony Leonardi III,100,Horror,2013-09-26,39,4.6,2013,2808100,1568212,-1239888,5
6010,0.0758669999999999,1200000,2861020,1661020,Home Run,Scott Elrod|Dorian Brown|Charles Henry Wyson|James Devoti|Nicole Leigh,David Boyd,114,Drama,2013-04-19,19,6.5,2013,1123240,2678010,1554770,6
6041,0.040858,58000000,44000000,-14000000,The Internship,Owen Wilson|Vince Vaughn|Tiya Sircar|Rose Byrne|Josh Gad,Shawn Levy,119,Comedy,2013-06-07,1174,6.1,2013,54289934,41185467,-13104467,6
6065,0.010335,30000000,68129518,38129518,Ð¡Ñ‚Ð°Ð»Ð¸Ð½Ð³Ñ€Ð°Ð´,Thomas Kretschmann|Yanina Studilina|Philippe Reinhardt|Heiner Lauterbach|Maria Smolnikova,Fyodor Bondarchuk,131,War|Action,2013-10-09,64,5.5,2013,28081000,63771501,35690501,5
6081,6.095293,19000000,381109762,362109762,Back to the Future,Michael J. Fox|Christopher Lloyd|Lea Thompson|Crispin Glover|Thomas F. Wilson,Robert Zemeckis,116,Adventure|Comedy|Science Fiction|Family,1985-07-03,3785,7.8,1985,38516154,772572771,734056617,8
6082,2.834739,1000000,51525171,50525171,The Breakfast Club,Emilio Estevez|Anthony Michael Hall|Judd Nelson|Molly Ringwald|Paul Gleason,John Hughes,97,Comedy|Drama,1985-02-15,1139,7.6,1985,2027166,104450077,102422911,8
6083,1.753688,20000000,18432000,-1568000,Ladyhawke,Matthew Broderick|Rutger Hauer|Michelle Pfeiffer|Alfred Molina|Leo McKern,Richard Donner,121,Adventure|Fantasy,1985-04-03,124,6.6,1985,40543321,37364724,-3178597,7
6084,1.746063,12305523,36230219,23924696,Mad Max Beyond Thunderdome,Mel Gibson|Tina Turner|Bruce Spence|Helen Buday|Angelo Rossitto,George Miller|George Ogilvie,107,Action|Adventure|Drama|Science Fiction,1985-06-29,428,5.8,1985,24945338,73444670,48499332,6
6085,1.623978,30000000,152427960,122427960,A View to a Kill,Roger Moore|Christopher Walken|Tanya Roberts|Grace Jones|Patrick Macnee,John Glen,131,Adventure|Action|Thriller,1985-05-24,272,5.8,1985,60814981,308996785,248181804,6
6086,1.613752,25000000,15502112,-9497888,Legend,Tom Cruise|Mia Sara|Tim Curry|David Bennent|Alice Playten,Ridley Scott,114,Action|Adventure|Fantasy|Romance,1985-07-19,120,6.3,1985,50679151,31425355,-19253796,6
6087,1.596994,19000000,61389680,42389680,The Goonies,Sean Astin|Josh Brolin|Jeff Cohen|Corey Feldman|Robert Davi,Richard Donner,114,Adventure|Comedy|Family,1985-06-06,870,7.2,1985,38516154,124447075,85930921,7
6088,1.299275,3000000,29999213,26999213,A Nightmare on Elm Street Part 2: Freddy's Revenge,Robert Englund|Mark Patton|Kim Myers|Robert Rusler|Clu Gulager,Jack Sholder,87,Horror,1985-11-01,168,5.7,1985,6081498,60813386,54731888,6
6089,1.177428,44000000,300400432,256400432,Rambo: First Blood Part II,Sylvester Stallone|Richard Crenna|Charles Napier|Steven Berkoff|Julia Nickson,George P. Cosmatos,96,Action|Adventure|Drama|Thriller|War,1985-05-21,476,6.2,1985,89195306,608961557,519766251,6
6090,1.168819,31000000,128499205,97499205,Out of Africa,Meryl Streep|Robert Redford|Klaus Maria Brandauer|Michael Kitchen|Malick Bowens,Sydney Pollack,161,Drama,1985-12-10,128,6.7,1985,62842147,260489226,197647079,7
6091,1.149954,31000000,300473716,269473716,Rocky IV,Sylvester Stallone|Talia Shire|Burt Young|Carl Weathers|Brigitte Nielsen,Sylvester Stallone,91,Drama,1985-11-21,517,6.6,1985,62842147,609110116,546267969,7
6093,1.034373,25000000,21288692,-3711308,The Black Cauldron,Grant Bardsley|Susan Sheridan|John Byner|Nigel Hawthorne|John Hurt,Ted Berman|Richard Rich,80,Animation,1985-07-24,114,6.2,1985,50679151,43155713,-7523438,6
6094,1.012186,15000000,146292009,131292009,The Color Purple,Whoopi Goldberg|Margaret Avery|Danny Glover|Akosua Busia|Oprah Winfrey,Steven Spielberg,154,Drama,1985-12-18,168,7.5,1985,30407490,296558194,266150704,7
6095,0.898411,10000000,57500000,47500000,Commando,Arnold Schwarzenegger|Rae Dawn Chong|Dan Hedaya|Vernon Wells|James Olson,Mark L. Lester,90,Action|Adventure|Thriller,1985-10-03,391,6.3,1985,20271660,116562048,96290388,6
6096,0.887605,12500000,238227,-12261773,King Solomon's Mines,Richard Chamberlain|Sharon Stone|Herbert Lom|John Rhys-Davies|Ken Gampu,J. Lee Thompson,100,Action|Adventure|Comedy,1985-03-20,50,4.9,1985,25339575,482925,-24856650,5
6097,0.876636,4000000,14237000,10237000,The Return of the Living Dead,Clu Gulager|James Karen|Don Calfa|Thom Mathews|John Philbin,Dan O'Bannon,91,Comedy|Horror,1985-05-15,104,7.1,1985,8108664,28860763,20752099,7
6098,0.873551,12000000,68706993,56706993,Witness,Harrison Ford|Kelly McGillis|Josef Sommer|Lukas Haas|Jan Rubes,Peter Weir,113,Crime|Drama|Romance|Thriller,1985-02-08,176,6.7,1985,24325992,139280483,114954491,7
6102,0.717479,9000000,24922237,15922237,Fright Night,Chris Sarandon|William Ragsdale|Amanda Bearse|Roddy McDowall|Stephen Geoffreys,Tom Holland,106,Horror|Thriller|Comedy,1985-08-02,98,6.8,1985,18244494,50521512,32277018,7
6105,0.70478,17900000,6948633,-10951367,Red Sonja,"Arnold Schwarzenegger|Brigitte Nielsen|Sandahl Bergman|Paul L. Smith|Ernie Reyes, Jr.",Richard Fleischer,89,Adventure|Fantasy|Action,1985-04-09,100,5.2,1985,36286272,14086032,-22200240,5
6106,0.689416,3500000,34000000,30500000,Day of the Dead,Lori Cardille|Terry Alexander|Joseph Pilato|Jarlath Conroy|Anthony Dileo Jr.,George A. Romero,102,Horror|Science Fiction,1985-07-19,91,6.7,1985,7095081,68923645,61828564,7
6107,0.688022,15000000,14643997,-356003,Clue: The Movie,Eileen Brennan|Tim Curry|Madeline Kahn|Christopher Lloyd|Michael McKean,Jonathan Lynn,94,Comedy|Thriller|Crime|Mystery,1985-12-13,202,7.1,1985,30407490,29685813,-721677,7
6108,0.662175,2200000,21930418,19730418,Friday the 13th: A New Beginning,Melanie Kinnaman|John Shepherd|Shavar Ross|Richard Young|Marco St. John,Danny Steinmann,92,Horror|Thriller,1985-03-22,82,5.2,1985,4459765,44456598,39996833,5
6109,0.657238,50000000,23717291,-26282709,Santa Claus: The Movie,Dudley Moore|John Lithgow|David Huddleston|Burgess Meredith|Judy Cornwell,Jeannot Szwarc,108,Adventure|Comedy|Fantasy|Science Fiction|Family,1985-10-29,26,5.9,1985,101358302,48078887,-53279415,6
6116,0.617698,15000000,10631333,-4368667,The Purple Rose of Cairo,Mia Farrow|Jeff Daniels|Danny Aiello|Irving Metzman|Stephanie Farrow,Woody Allen,82,Fantasy|Comedy|Romance,1985-03-01,99,7.0,1985,30407490,21551477,-8856013,7
6119,0.587272999999999,25000000,96773200,71773200,The Jewel of the Nile,Michael Douglas|Kathleen Turner|Danny DeVito|Spiros FocÃ¡s|Avner Eisenberg,Lewis Teague,106,Action|Adventure|Comedy|Romance,1985-12-04,135,6.1,1985,50679151,196175345,145496194,6
6121,0.536718,900000,2023414,1123414,Re-Animator,Jeffrey Combs|Bruce Abbott|Barbara Crampton|David Gale|Robert Sampson,Stuart Gordon,86,Science Fiction|Comedy|Horror,1985-10-18,98,6.9,1985,1824449,4101796,2277347,7
6122,0.5129,9000000,20518905,11518905,Porky's Revenge,Dan Monahan|Wyatt Knight|Tony Ganios|Mark Herrier|Kaki Hunter,James Komack,92,Comedy,1985-03-22,21,4.4,1985,18244494,41595227,23350733,4
6129,0.458359,4500000,10609321,6109321,After Hours,Griffin Dunne|Rosanna Arquette|Verna Bloom|Tommy Chong|Linda Fiorentino,Martin Scorsese,97,Comedy|Thriller|Drama,1985-09-13,98,7.0,1985,9122247,21506855,12384608,7
6130,0.427104,6000000,40940662,34940662,Pee-wee's Big Adventure,Paul Reubens|E.G. Daily|Mark Holton|Diane Salinger|Judd Omen,Tim Burton,90,Adventure|Comedy|Family,1985-07-26,102,6.5,1985,12162996,82993520,70830524,6
6137,0.384037,20000000,45833132,25833132,Brewster's Millions,Richard Pryor|John Candy|Lonette McKee|Stephen Collins|Jerry Orbach,Walter Hill,97,Comedy,1985-05-22,55,6.5,1985,40543321,92911369,52368048,6
6152,0.280847,5000000,27400000,22400000,Desperately Seeking Susan,Madonna|Rosanna Arquette|Aidan Quinn|Mark Blum|Robert Joy,Susan Seidelman,104,Drama|Action|Comedy|Romance,1985-03-29,38,6.2,1985,10135830,55544349,45408519,6
6156,0.252673999999999,9000000,7936012,-1063988,Runaway Train,Jon Voight|Eric Roberts|Rebecca De Mornay|Kyle T. Heffner|John P. Ryan,Andrei Konchalovsky,111,Action|Thriller,1985-11-15,48,6.6,1985,18244494,16087614,-2156880,7
6161,0.229931,25000000,11137801,-13862199,Return to Oz,Fairuza Balk|Nicol Williamson|Piper Laurie|Jean Marsh|Justin Case,Walter Murch,113,Adventure|Fantasy|Science Fiction|Family,1985-06-21,50,6.0,1985,50679151,22578172,-28100979,6
6165,0.214009,5000000,502758,-4497242,Mishima: A Life in Four Chapters,Ken Ogata|GÃ´ RijÃ»|Masato Aizawa|Masayuki Shionoya|Hiroshi Mikami,Paul Schrader,121,Drama,1985-05-15,11,6.3,1985,10135830,1019173,-9116657,6
6168,0.208914,3200000,10000000,6800000,Once Bitten,Jim Carrey|Lauren Hutton|Karen Kopins|Cleavon Little|Stuart Charno,Howard Storm,94,Horror|Comedy|Romance,1985-11-15,32,5.5,1985,6486931,20271660,13784729,5
6172,0.592905,10000000,25754284,15754284,The Last Dragon,Taimak|Julius Carry|Vanity|Christopher Murney|Faith Prince,Michael Schultz,108,Action|Adventure|Comedy|Drama,1985-03-22,31,6.8,1985,20271660,52208210,31936550,7
6175,0.150168,25000000,9873044,-15126956,Explorers,Ethan Hawke|River Phoenix|Bobby Fite|Bradley Gregg|Georg Olden,Joe Dante,109,Adventure|Family|Fantasy|Romance|Science Fiction,1985-07-12,77,6.1,1985,50679151,20014299,-30664852,6
6178,0.135989,19000000,12918858,-6081142,Perfect,John Travolta|Jamie Lee Curtis|Marilu Henner|Laraine Newman|Jann Wenner,James Bridges,115,Drama|Romance,1985-06-07,13,4.3,1985,38516154,26188670,-12327484,4
6179,0.132713,114,6700000,6699886,Into the Night,Jeff Goldblum|Michelle Pfeiffer|Stacey Pickren|Carmen Argenziano|Dan Aykroyd,John Landis,115,Comedy|Drama|Thriller,1985-02-15,24,6.1,1985,231,13582012,13581781,6
6183,0.112015,860000,2451545,1591545,My Beautiful Laundrette,Gordon Warnecke|Daniel Day-Lewis|Roshan Seth|Saeed Jaffrey|Derrick Branche,Stephen Frears,97,Drama,1985-09-07,23,6.2,1985,1743362,4969688,3226326,6
6185,0.215817,2410000,10755447,8345447,Missing in Action 2: The Beginning,Chuck Norris|Soon-Tek Oh|Steven Williams|Bennett Ohta|Cosie Costa,Lance Hool,100,Action|Adventure|War,1985-03-01,30,5.0,1985,4885470,21803077,16917607,5
6190,5.939927,150000000,895921036,745921036,Harry Potter and the Goblet of Fire,Daniel Radcliffe|Rupert Grint|Emma Watson|Ralph Fiennes|Michael Gambon,Mike Newell,157,Adventure|Fantasy|Family,2005-11-05,3406,7.3,2005,167484493,1000352539,832868046,7
6191,5.400826,150000000,374218673,224218673,Batman Begins,Christian Bale|Michael Caine|Liam Neeson|Katie Holmes|Gary Oldman,Christopher Nolan,140,Action|Crime|Drama,2005-06-14,4914,7.3,2005,167484493,417838832,250354339,7
6192,3.628726,180000000,748806957,568806957,"The Chronicles of Narnia: The Lion, the Witch and the Wardrobe",William Moseley|Anna Popplewell|Skandar Keynes|Georgie Henley|Liam Neeson,Andrew Adamson,143,Adventure|Family|Fantasy,2005-12-07,1402,6.5,2005,200981392,836090359,635108967,6
6193,3.617106,54000000,132511035,78511035,V for Vendetta,Natalie Portman|Hugo Weaving|Stephen Rea|Stephen Fry|John Hurt,James McTeigue,132,Action|Thriller|Fantasy,2005-12-11,2670,7.6,2005,60294417,147956957,87662540,8
6194,3.520836,40000000,158733820,118733820,Sin City,Jessica Alba|Devon Aoki|Alexis Bledel|Powers Boothe|Rosario Dawson,Robert Rodriguez|Frank Miller|Quentin Tarantino,124,Action|Thriller|Crime,2005-03-31,1691,7.1,2005,44662531,177236356,132573825,7
6195,3.508379,150000000,474968763,324968763,Charlie and the Chocolate Factory,Johnny Depp|Freddie Highmore|AnnaSophia Robb|Julia Winter|Helena Bonham Carter,Tim Burton,115,Adventure|Comedy|Family|Fantasy,2005-07-09,1826,6.5,2005,167484493,530332684,362848191,6
6196,3.457537,113000000,850000000,737000000,Star Wars: Episode III - Revenge of the Sith,Ewan McGregor|Natalie Portman|Hayden Christensen|Ian McDiarmid|Samuel L. Jackson,George Lucas,140,Science Fiction|Adventure|Action,2005-05-17,2629,7.0,2005,126171651,949078796,822907145,7
6197,3.087036,50000000,104478416,54478416,The Hitchhiker's Guide to the Galaxy,Martin Freeman|Zooey Deschanel|Sam Rockwell|Mos Def|John Malkovich,Garth Jennings,109,Adventure|Comedy|Family|Science Fiction,2005-01-15,780,6.6,2005,55828164,116656763,60828599,7
6198,2.623346,126000000,162949164,36949164,The Island,Ewan McGregor|Scarlett Johansson|Djimon Hounsou|Sean Bean|Steve Buscemi,Michael Bay,136,Action|Thriller|Science Fiction|Adventure,2005-07-20,1027,6.4,2005,140686974,181943054,41256080,6
6199,2.444998,75000000,532680671,457680671,Madagascar,Ben Stiller|Chris Rock|David Schwimmer|Jada Pinkett Smith|Sacha Baron Cohen,Eric Darnell|Tom McGrath,86,Family|Animation,2005-05-25,2107,6.4,2005,83742246,594771682,511029436,6
6200,2.368513,100000000,330579719,230579719,Fantastic Four,Ioan Gruffudd|Jessica Alba|Chris Evans|Michael Chiklis|Julian McMahon,Tim Story,106,Action|Adventure|Fantasy|Science Fiction,2005-07-07,1715,5.6,2005,111656328,369113178,257456850,6
6201,2.26533,100000000,230427240,130427240,Constantine,Keanu Reeves|Rachel Weisz|Shia LaBeouf|Djimon Hounsou|Max Baker,Francis Lawrence,121,Drama|Fantasy|Horror,2005-02-15,1049,6.5,2005,111656328,257286597,145630269,6
6202,2.248624,40000000,285176741,245176741,Wedding Crashers,Owen Wilson|Vince Vaughn|Christopher Walken|Rachel McAdams|Isla Fisher,David Dobkin,119,Comedy|Romance,2005-07-14,795,6.3,2005,44662531,318417880,273755349,6
6203,2.220063,62000000,52304001,-9695999,Ã†on Flux,Charlize Theron|Marton Csokas|Jonny Lee Miller|Sophie Okonedo|Caroline Chikezie,Karyn Kusama,93,Action|Science Fiction,2005-11-30,408,5.3,2005,69226923,58400727,-10826196,5
6204,2.07205,56000000,113006880,57006880,The Pacifier,Vin Diesel|Lauren Graham|Faith Ford|Chris Potter|Brittany Snow,Adam Shankman,95,Action|Comedy|Drama|Family|Thriller,2005-03-04,493,5.8,2005,62527544,126179333,63651789,6
6205,1.844731,132000000,591739379,459739379,War of the Worlds,Tom Cruise|Dakota Fanning|Miranda Otto|Justin Chatwin|Tim Robbins,Steven Spielberg,116,Adventure|Thriller|Science Fiction,2005-06-28,1238,5.9,2005,147386354,660714467,513328113,6
6206,1.813128,85000000,162242962,77242962,Memoirs of a Geisha,Zhang Ziyi|Gong Li|Youki Kudoh|Tsai Chin|Suzuka Ohgo,Rob Marshall,145,Drama|History|Romance,2005-12-06,409,7.1,2005,94907879,181154535,86246656,7
6207,1.78595,26000000,109449237,83449237,The 40 Year Old Virgin,Steve Carell|Catherine Keener|Paul Rudd|Romany Malco|Seth Rogen,Judd Apatow,116,Comedy|Romance,2005-08-11,1236,6.2,2005,29030645,122207000,93176355,6
6208,1.766397,150000000,314432665,164432665,Chicken Little,Zach Braff|Garry Marshall|Don Knotts|Patrick Stewart|Amy Sedaris,Mark Dindal,81,Animation|Family|Comedy,2005-11-04,542,5.6,2005,167484493,351083970,183599477,6
6209,1.72647,70000000,368100420,298100420,Hitch,Will Smith|Eva Mendes|Kevin James|Amber Valletta|Julie Ann Emery,Andy Tennant,118,Comedy|Drama|Romance,2005-02-10,1010,6.3,2005,78159430,411007415,332847985,6
6210,1.699822,32000000,85167639,53167639,Transporter 2,Jason Statham|Amber Valletta|Kate Nauta|Alessandro Gassman|FranÃ§ois BerlÃ©and,Louis Leterrier,87,Action|Thriller|Crime,2005-08-02,677,6.1,2005,35730025,95095059,59365034,6
6212,1.610259,25000000,122489822,97489822,Nanny McPhee,Emma Thompson|Colin Firth|Kelly Macdonald|Thomas Brodie-Sangster|Eliza Bennett,Kirk Jones,97,Fantasy|Comedy|Family,2005-10-21,355,6.1,2005,27914082,136767638,108853556,6
6213,1.592578,130000000,211643158,81643158,Kingdom of Heaven,Orlando Bloom|Eva Green|Jeremy Irons|Marton Csokas|Brendan Gleeson,Ridley Scott,144,Drama|Action|Adventure|History|War,2005-05-03,677,6.4,2005,145153227,236312980,91159753,6
6214,1.513147,43000000,154749918,111749918,Monster-in-Law,Jennifer Lopez|Jane Fonda|Michael Vartan|Wanda Sykes|Adam Scott,Robert Luketic,101,Comedy,2005-05-13,240,5.7,2005,48012221,172788077,124775856,6
6215,1.508329,207000000,550000000,343000000,King Kong,Naomi Watts|Jack Black|Adrien Brody|Thomas Kretschmann|Colin Hanks,Peter Jackson,187,Adventure|Drama|Action,2005-12-14,1289,6.4,2005,231128600,614109809,382981209,6
6216,1.497085,53000000,95226116,42226116,Be Cool,John Travolta|Uma Thurman|Vince Vaughn|Cedric the Entertainer|AndrÃ© Benjamin,F. Gary Gray,118,Comedy|Crime,2005-03-04,170,5.3,2005,59177854,106325985,47148131,5
6217,1.496807,50000000,44434439,-5565561,Into the Blue,Paul Walker|Jessica Alba|Scott Caan|Ashley Scott|Josh Brolin,John Stockwell,110,Action|Thriller|Adventure|Crime,2005-09-30,289,5.9,2005,55828164,49613863,-6214301,6
6218,1.480854,28000000,121147947,93147947,Pride & Prejudice,Keira Knightley|Matthew Macfadyen|Rosamund Pike|Simon Woods|Donald Sutherland,Joe Wright,128,Drama|Romance,2005-09-16,749,7.6,2005,31263772,135269350,104005578,8
6219,1.475604,14000000,178043761,164043761,Brokeback Mountain,Heath Ledger|Jake Gyllenhaal|Randy Quaid|Michelle Williams|Anne Hathaway,Ang Lee,134,Drama|Romance,2005-09-02,780,7.2,2005,15631886,198797127,183165241,7
6220,1.464718,75000000,260696994,185696994,Robots,Robin Williams|Ewan McGregor|Halle Berry|Mel Brooks|Paula Abdul,Chris Wedge|Carlos Saldanha,91,Animation|Comedy|Family|Science Fiction,2005-03-11,858,5.9,2005,83742246,291084693,207342447,6
6222,1.40558799999999,87000000,71073932,-15926068,xXx: State of the Union,Ice Cube|Willem Dafoe|Samuel L. Jackson|Scott Speedman|Xzibit,Lee Tamahori,101,Action|Crime|Adventure,2005-04-27,292,4.8,2005,97141006,79358543,-17782463,5
6223,1.351718,25000000,39053061,14053061,The Sisterhood of the Traveling Pants,Amber Tamblyn|Alexis Bledel|America Ferrera|Blake Lively|Jenna Boyd,Ken Kwapis,119,Drama|Comedy,2005-06-01,195,6.3,2005,27914082,43605214,15691132,6
6224,1.330824,110000000,478207520,368207520,Mr. & Mrs. Smith,Angelina Jolie|Brad Pitt|Vince Vaughn|Adam Brody|Kerry Washington,Doug Liman,120,Action|Comedy|Drama|Thriller,2005-06-07,1750,6.5,2005,122821961,533948961,411127000,6
6226,1.310993,75000000,142400065,67400065,The Legend of Zorro,Antonio Banderas|Catherine Zeta-Jones|AdriÃ¡n Alonso Barona|Julio Oscar Mechoso|Nick Chinlund,Martin Campbell,129,Action|Adventure|Drama|Western,2005-10-24,592,5.8,2005,83742246,158998685,75256439,6
6227,1.274645,42000000,24127895,-17872105,Lord of War,Nicolas Cage|Bridget Moynahan|Jared Leto|Ethan Hawke|Eamonn Walker,Andrew Niccol,122,Crime|Drama|Thriller,2005-09-16,822,6.9,2005,46895658,26940321,-19955337,7
6228,1.273393,65000000,64321501,-678499,Zathura: A Space Adventure,Jonah Bobo|Josh Hutcherson|Dax Shepard|Tim Robbins|Frank Oz,Jon Favreau,101,Family|Fantasy|Science Fiction|Adventure,2005-11-06,389,5.9,2005,72576613,71819026,-757587,6
6229,1.270018,43000000,56681566,13681566,Elektra,Jennifer Garner|Goran Visnjic|Will Yun Lee|Cary-Hiroyuki Tagawa|Terence Stamp,Rob Bowman,97,Action,2005-01-13,329,5.0,2005,48012221,63288555,15276334,5
6231,1.265401,40000000,117195061,77195061,Corpse Bride,Johnny Depp|Helena Bonham Carter|Emily Watson|Tracey Ullman|Paul Whitehouse,Tim Burton|Mike Johnson,77,Romance|Fantasy|Animation|Music,2005-09-09,1022,7.0,2005,44662531,130855702,86193171,7
6232,1.212451,30000000,192452832,162452832,The Curse of the Were-Rabbit,Peter Sallis|Helena Bonham Carter|Ralph Fiennes|Nicholas Smith|Liz Smith,Steve Box|Nick Park,85,Adventure|Animation|Comedy|Family,2005-09-04,373,6.6,2005,33496898,214885767,181388869,7
6233,1.210683,70000000,88933562,18933562,Rumor Has It...,Jennifer Aniston|Kevin Costner|Shirley MacLaine|Mark Ruffalo|Richard Jenkins,Rob Reiner,97,Comedy,2005-12-23,181,5.2,2005,78159430,99299950,21140520,5
6235,1.200307,29000000,21126225,-7873775,The Jacket,Adrien Brody|Keira Knightley|Kris Kristofferson|Jennifer Jason Leigh|Kelly Lynch,John Maybury,103,Drama|Mystery|Thriller|Fantasy,2005-03-04,219,6.6,2005,32380335,23588767,-8791568,7
6236,1.148377,72000000,96889998,24889998,Jarhead,Jamie Foxx|Jake Gyllenhaal|Scott MacDonald|Lucas Black|Peter Sarsgaard,Sam Mendes,125,Drama|War,2005-11-04,448,6.4,2005,80392556,108183814,27791258,6
6238,1.110148,39000000,38869464,-130536,Serenity,Nathan Fillion|Gina Torres|Alan Tudyk|Morena Baccarin|Adam Baldwin,Joss Whedon,119,Science Fiction|Action|Adventure|Thriller,2005-08-25,814,7.3,2005,43545968,43400216,-145752,7
6239,1.107734,4000000,152925093,148925093,Saw II,Tobin Bell|Shawnee Smith|Donnie Wahlberg|Franky G|Glenn Plummer,Darren Lynn Bousman,92,Horror,2005-10-28,617,6.2,2005,4466253,170750544,166284291,6
6240,1.102836,58000000,102854431,44854431,Just Like Heaven,Reese Witherspoon|Mark Ruffalo|Donal Logue|Dina Spybey-Waters|Ben Shenkman,Mark Waters,95,Comedy|Fantasy|Romance,2005-09-16,304,6.5,2005,64760670,114843481,50082811,6
6241,1.094959,50000000,66002004,16002004,Herbie Fully Loaded,Lindsay Lohan|Michael Keaton|Matt Dillon|Breckin Meyer|Justin Long,Angela Robinson,101,Comedy|Family|Adventure|Fantasy|Romance,2005-06-18,294,5.2,2005,55828164,73695414,17867250,5
6242,1.08379,57000000,52034889,-4965111,Elizabethtown,Orlando Bloom|Kirsten Dunst|Susan Sarandon|Alec Baldwin|Bruce McGill,Cameron Crowe,123,Comedy|Drama|Romance,2005-09-03,192,6.0,2005,63644107,58100246,-5543861,6
6244,1.075427,45000000,92374674,47374674,Four Brothers,Mark Wahlberg|Tyrese Gibson|AndrÃ© Benjamin|Garrett Hedlund|Terrence Howard,John Singleton,109,Action|Crime,2005-08-11,379,6.6,2005,50245348,103142169,52896821,7
6245,1.056592,4800000,80578934,75778934,Hostel,Jay Hernandez|Derek Richardson|Eythor Gudjonsson|Barbara Nedeljakova|Jana Kaderabkova,Eli Roth,94,Horror,2005-01-06,448,5.7,2005,5359503,89971479,84611976,6
6246,1.05364,15000000,15785148,785148,Kiss Kiss Bang Bang,Robert Downey Jr.|Val Kilmer|Michelle Monaghan|Corbin Bernsen|Dash Mihok,Shane Black,103,Action|Comedy|Crime|Mystery,2005-02-12,527,7.1,2005,16748449,17625116,876667,7
6247,1.053307,88000000,108539911,20539911,Cinderella Man,Russell Crowe|RenÃ©e Zellweger|Paul Giamatti|Craig Bierko|Paddy Considine,Ron Howard,144,Romance|Drama|History,2005-06-02,370,7.0,2005,98257569,121191680,22934111,7
6248,1.051177,15000000,85306374,70306374,Match Point,Jonathan Rhys Meyers|Scarlett Johansson|Emily Mortimer|Brian Cox|Penelope Wilton,Woody Allen,124,Drama|Thriller|Crime|Romance,2005-05-12,620,7.1,2005,16748449,95249965,78501516,7
6249,1.048193,15000000,51053787,36053787,Hoodwinked!,Anne Hathaway|Glenn Close|Jim Belushi|Patrick Warburton|Anthony Anderson,Cory Edwards|Todd Edwards|Tony Leech,80,Animation|Comedy|Family,2005-12-16,288,6.0,2005,16748449,57004784,40256335,6
6250,1.045798,25000000,122644820,97644820,Hide and Seek,Robert De Niro|Dakota Fanning|Famke Janssen|Elisabeth Shue|Amy Irving,John Polson,101,Horror|Mystery|Thriller,2005-01-27,240,6.2,2005,27914082,136940703,109026621,6
6251,1.014707,85000000,131426169,46426169,Bewitched,Nicole Kidman|Will Ferrell|Shirley MacLaine|Michael Caine|Jason Schwartzman,Nora Ephron,102,Comedy|Fantasy|Romance,2005-06-21,262,4.9,2005,94907879,146745635,51837756,5
6254,1.001465,60000000,55987321,-4012679,Doom,Dwayne Johnson|Karl Urban|Rosamund Pike|Ben Daniels|Deobia Oparei,Andrzej Bartkowiak,100,Action|Adventure|Science Fiction|Thriller|Horror,2005-10-20,321,4.9,2005,66993797,62513387,-4480410,5
6256,0.982784,60000000,129181830,69181830,Cheaper by the Dozen 2,Steve Martin|Eugene Levy|Bonnie Hunt|Tom Welling|Jonathan Bennett,Adam Shankman,94,Adventure|Comedy|Family,2005-12-21,285,5.8,2005,66993797,144239689,77245892,6
6257,0.956847,30000000,50451307,20451307,Fever Pitch,Drew Barrymore|Jimmy Fallon|Jason Spevack|Jack Kehler|Maureen Keiller,Bobby Farrelly|Peter Farrelly,103,Comedy|Drama|Romance,2005-04-06,112,5.7,2005,33496898,56332077,22835179,6
6258,0.94817,30000000,58405313,28405313,Must Love Dogs,Diane Lane|John Cusack|Elizabeth Perkins|Christopher Plummer|Dermot Mulroney,Gary David Goldberg,98,Comedy|Romance,2005-07-21,80,6.0,2005,33496898,65213228,31716330,6
6259,0.918476,20000000,7535331,-12464669,Proof,Gwyneth Paltrow|Anthony Hopkins|Jake Gyllenhaal|Hope Davis|Danny McCarthy,John Madden,100,Drama|Mystery,2005-09-05,88,6.1,2005,22331265,8413673,-13917592,6
6260,0.906223,80000000,162944923,82944923,The Interpreter,Nicole Kidman|Sean Penn|Catherine Keener|Jesper Christensen|Yvan Attal,Sydney Pollack,128,Action,2005-04-04,197,6.2,2005,89325063,181938319,92613256,6
6261,0.899944,88000000,105316267,17316267,The Brothers Grimm,Heath Ledger|Matt Damon|Mackenzie Crook|Roger Ashton-Griffiths|Peter Stormare,Terry Gilliam,118,Adventure|Fantasy|Action|Comedy|Thriller,2005-08-25,451,5.4,2005,98257569,117592277,19334708,5
6262,0.893879,30000000,18618284,-11381716,An Unfinished Life,Robert Redford|Jennifer Lopez|Morgan Freeman|Becca Gardner|Josh Lucas,Lasse HallstrÃ¶m,108,Drama,2005-09-09,82,6.9,2005,33496898,20788492,-12708406,7
6263,0.887848,52000000,77944725,25944725,Hostage,Bruce Willis|Kevin Pollak|Jimmy Bennett|Michelle Horn|Ben Foster,Florent-Emilio Siri,113,Mystery|Drama|Thriller|Crime,2005-03-09,280,6.0,2005,58061291,87030218,28968927,6
6264,0.885834,50000000,110803676,60803676,The Dukes of Hazzard,Johnny Knoxville|Seann William Scott|Jessica Simpson|Willie Nelson|Burt Reynolds,Jay Chandrasekhar,104,Action|Adventure|Comedy,2005-08-05,185,5.2,2005,55828164,123719316,67891152,5
6265,0.869394,70000000,130358911,60358911,Munich,Eric Bana|Daniel Craig|CiarÃ¡n Hinds|Mathieu Kassovitz|Hanns Zischler,Steven Spielberg,164,Drama|Action|History|Thriller,2005-12-22,382,6.7,2005,78159430,145553974,67394544,7
6266,0.857834,19000000,144216468,125216468,The Exorcism of Emily Rose,Laura Linney|Tom Wilkinson|Campbell Scott|Jennifer Carpenter|Kenneth Welsh,Scott Derrickson,122,Crime|Drama|Horror|Thriller,2005-09-09,323,6.2,2005,21214702,161026813,139812111,6
6267,0.852969,6500000,24793509,18293509,Thank You for Smoking,Aaron Eckhart|Maria Bello|Cameron Bright|Adam Brody|Sam Elliott,Jason Reitman,92,Comedy|Drama,2005-09-05,341,7.1,2005,7257661,27683521,20425860,7
6268,0.839023,22000000,22400154,400154,Deuce Bigalow: European Gigolo,Rob Schneider|Eddie Griffin|Jeroen KrabbÃ©|Til Schweiger|Hanna Verboom,Mike Bigelow,83,Comedy,2005-08-06,118,4.8,2005,24564392,25011189,446797,5
6269,0.835676,50000000,94000000,44000000,Syriana,George Clooney|Matt Damon|Jeffrey Wright|Chris Cooper|Amanda Peet,Stephen Gaghan,128,Drama|Thriller,2005-11-23,245,6.0,2005,55828164,104956949,49128785,6
6271,0.82677,22000000,57479076,35479076,Derailed,Clive Owen|Jennifer Aniston|Vincent Cassel|Melissa George|Addison Timlin,Mikael HÃ¥fstrÃ¶m,108,Drama|Thriller,2005-11-11,173,6.2,2005,24564392,64179026,39614634,6
6272,0.826568,50000000,42093706,-7906294,Oliver Twist,Barney Clark|Ben Kingsley|Jamie Foreman|Harry Eden|Edward Hardwicke,Roman Polanski,130,Crime|Drama|Family,2005-09-23,143,6.6,2005,55828164,47000286,-8827878,7
6273,0.824869,43000000,91974818,48974818,The Skeleton Key,Kate Hudson|Gena Rowlands|Peter Sarsgaard|John Hurt|Joy Bryant,Iain Softley,104,Drama|Horror|Mystery|Thriller,2005-07-29,289,6.3,2005,48012221,102695705,54683484,6
6274,0.79295,12000000,10289,-11989711,Chaos,Jason Statham|Ryan Phillippe|Wesley Snipes|Henry Czerny|Justine Waddell,Tony Giglio,106,Drama|Action|Crime,2005-01-17,162,6.3,2005,13398759,11488,-13387271,6
6275,0.786786,30000000,93772522,63772522,Racing Stripes,Frankie Muniz|Mandy Moore|Hayden Panettiere|Bruce Greenwood|Wendie Malick,Frederik Du Chau,102,Comedy,2005-01-06,80,5.1,2005,33496898,104702955,71206057,5
6276,0.784909,7000000,54600000,47600000,"Good Night, and Good Luck.",David Strathairn|Jeff Daniels|Alex Borstein|Rose Abdoo|Dianne Reeves,George Clooney,93,Drama|History,2005-09-16,154,6.4,2005,7815943,60964355,53148412,6
6277,0.775677,30000000,76669806,46669806,Coach Carter,Samuel L. Jackson|Rob Brown|Robert Ri'chard|Rick Gonzalez|Channing Tatum,Thomas Carter,136,Drama,2005-01-14,272,7.3,2005,33496898,85606690,52109792,7
6278,0.773901,32000000,60740827,28740827,A History of Violence,Viggo Mortensen|Maria Bello|Heidi Hayes|Ashton Holmes|William Hurt,David Cronenberg,96,Drama|Thriller|Crime,2005-09-23,403,6.7,2005,35730025,67820977,32090952,7
6279,0.773231,19000000,108047131,89047131,The Amityville Horror,Ryan Reynolds|Melissa George|Jesse James|ChloÃ« Grace Moretz|Jimmy Bennett,Andrew Douglas,90,Horror|Thriller|Drama,2005-04-15,293,6.0,2005,21214702,120641460,99426758,6
6280,0.767076,100000000,202026112,102026112,Fun with Dick and Jane,Jim Carrey|TÃ©a Leoni|Alec Baldwin|Richard Jenkins|Angie Harmon,Dean Parisot,90,Comedy,2005-12-21,363,5.9,2005,111656328,225574940,113918612,6
6281,0.743639,45000000,50871113,5871113,Unleashed,Jet Li|Morgan Freeman|Bob Hoskins|Vincent Regan|Dylan Brown,Louis Leterrier,103,Action|Crime,2005-02-02,279,6.5,2005,50245348,56800817,6555469,6
6282,0.738384,45000000,16809014,-28190986,Rebound,Martin Lawrence|Wendy Raquel Robinson|Breckin Meyer|Horatio Sanz|Patrick Warburton,Steve Carr,103,Comedy|Family,2005-07-01,52,5.5,2005,50245348,18768327,-31477021,5
6283,0.737768,35000000,68915888,33915888,Guess Who,Bernie Mac|Ashton Kutcher|Zoe Saldana|Judith Scott|Hal Williams,Kevin Rodney Sullivan,105,Comedy|Romance,2005-03-25,139,5.4,2005,39079715,76948950,37869235,5
6284,0.733587,169000,18564702,18395702,Keeping Mum,Rowan Atkinson|Kristin Scott Thomas|Maggie Smith|Patrick Swayze|Tamsin Egerton,Niall Johnson,103,Comedy,2005-12-02,73,6.5,2005,188699,20728664,20539965,6
6285,0.726858,35000000,30526509,-4473491,Two for the Money,Al Pacino|Matthew McConaughey|Rene Russo|Armand Assante|Jeremy Piven,D.J. Caruso,122,Comedy|Crime|Drama|Thriller,2005-10-07,78,5.9,2005,39079715,34084779,-4994936,6
6286,0.722961,2000000,5967038,3967038,Harsh Times,Christian Bale|Freddy RodrÃ­guez|Eva Longoria|Chaka Forman|Tammy Trull,David Ayer,120,Crime|Drama|Thriller|Action,2005-09-11,85,6.0,2005,2233126,6662575,4429449,6
6287,0.719502,55000000,223387299,168387299,Flightplan,Jodie Foster|Peter Sarsgaard|Sean Bean|Kate Beahan|Michael Irby,Robert Schwentke,98,Thriller|Drama|Mystery,2005-09-22,427,6.0,2005,61410980,249426057,188015077,6
6288,0.718616,30000000,35294470,5294470,Assault on Precinct 13,Ethan Hawke|Laurence Fishburne|Gabriel Byrne|Maria Bello|Drea de Matteo,Jean-FranÃ§ois Richet,109,Thriller,2005-01-19,160,5.9,2005,33496898,39408509,5911611,6
6290,0.709235,10000000,45742101,35742101,Broken Flowers,Bill Murray|Julie Delpy|Sharon Stone|Tilda Swinton|Jessica Lange,Jim Jarmusch,105,Comedy|Drama|Mystery|Romance,2005-05-17,182,6.7,2005,11165632,51073950,39908318,7
6291,0.707056,20000000,12482775,-7517225,The Weather Man,Nicolas Cage|Michael Caine|Hope Davis|Gemmenne de la PeÃ±a|Nicholas Hoult,Gore Verbinski,101,Comedy|Drama,2005-10-20,147,5.7,2005,22331265,13937808,-8393457,6
6293,0.699883,1000000,27762648,26762648,Wolf Creek,John Jarratt|Cassandra Magrath|Kestie Morassi|Nathan Phillips|Andy McPhee,Greg McLean,99,Horror|Thriller,2005-01-01,126,5.8,2005,1116563,30998753,29882190,6
6294,0.694404,15000000,46770602,31770602,Land of the Dead,Simon Baker|John Leguizamo|Dennis Hopper|Robert Joy|Asia Argento,George A. Romero,93,Horror,2005-06-24,171,5.8,2005,16748449,52222337,35473888,6
6297,0.681157,28000000,186438883,158438883,Walk the Line,Joaquin Phoenix|Reese Witherspoon|Ginnifer Goodwin|Robert Patrick|Tyler Hilton,James Mangold,136,Drama|Music|Romance,2005-09-13,415,7.0,2005,31263772,208170812,176907040,7
6299,0.665701,30000000,42886719,12886719,A Lot Like Love,Ashton Kutcher|Amanda Peet|Aimee Garcia|Taryn Manning|Ali Larter,Nigel Cole,107,Comedy,2005-04-22,192,6.5,2005,33496898,47885736,14388838,6
6300,0.664688,40000000,46442528,6442528,Get Rich or Die Tryin',50 Cent|Joy Bryant|Adewale Akinnuoye-Agbaje|Omar Benson Miller|Terrence Howard,Jim Sheridan,117,Drama,2005-11-09,121,6.5,2005,44662531,51856021,7193490,6
6301,0.663860999999999,45000000,56070433,11070433,Kicking & Screaming,Will Ferrell|Robert Duvall|Kate Walsh|Musetta Vander|Josh Hutcherson,Jesse Dylan,95,Romance|Comedy|Family,2005-05-13,102,5.8,2005,50245348,62606187,12360839,6
6302,0.663397999999999,4000000,866999,-3133001,MirrorMask,Stephanie Leonidas|Jason Barry|Rob Brydon|Gina McKee|Dora Bryan,Dave McKean,101,Adventure|Fantasy|Drama|Science Fiction|Family,2005-01-25,44,6.5,2005,4466253,968059,-3498194,6
6303,0.661616,35000000,19294901,-15705099,Cursed,Portia de Rossi|Christina Ricci|Jesse Eisenberg|Milo Ventimiglia|Judy Greer,Wes Craven,97,Horror|Comedy,2005-02-24,75,5.0,2005,39079715,21543978,-17535737,5
6304,0.661473,50000000,8342132,-41657868,Stay,Ewan McGregor|Ryan Gosling|Naomi Watts|Kate Burton|Elizabeth Reaser,Marc Forster,99,Mystery|Thriller|Drama,2005-09-24,162,6.4,2005,55828164,9314518,-46513646,6
6305,0.643145,25000000,27645491,2645491,Ice Princess,Michelle Trachtenberg|Joan Cusack|Amy Stewart|Hayden Panettiere|Kim Cattrall,Tim Fywell,98,Comedy,2005-03-17,96,5.8,2005,27914082,30867940,2953858,6
6306,0.636922,82000000,190320568,108320568,The Longest Yard,Adam Sandler|Chris Rock|Burt Reynolds|Michael Irvin|Nelly,Peter Segal,113,Comedy|Drama,2005-05-19,443,6.2,2005,91558189,212504959,120946770,6
6307,0.635843,3000000,18637690,15637690,Waiting...,Ryan Reynolds|Anna Faris|Justin Long|David Koechner|Luis GuzmÃ¡n,Rob McKittrick,94,Comedy,2005-10-07,108,6.0,2005,3349689,20810160,17460471,6
6308,0.635481,32000000,97918663,65918663,Are We There Yet?,Ice Cube|Nia Long|Aleisha Allen|Philip Bolden|Jay Mohr,Brian Levant,95,Comedy|Family|Adventure|Romance,2005-01-20,135,5.4,2005,35730025,109332384,73602359,5
6309,0.6269,80000000,5989640,-74010360,A Sound of Thunder,Heike Makatsch|Armin Rohde|David Oyelowo|Wilfried Hochholdinger|Edward Burns,Peter Hyams,110,Thriller|Science Fiction|Adventure|Action,2005-05-15,58,4.8,2005,89325063,6687812,-82637251,5
6312,0.608364,18000000,46201432,28201432,The Fog,Tom Welling|Maggie Grace|Selma Blair|DeRay Davis|Kenneth Welsh,Rupert Wainwright,100,Horror|Thriller,2005-10-14,85,4.2,2005,20098139,51586822,31488683,4
6313,0.606286,135000000,76932943,-58067057,Stealth,Josh Lucas|Jessica Biel|Jamie Foxx|Sam Shepard|Richard Roxburgh,Rob Cohen,121,Action,2005-07-28,195,5.0,2005,150736044,85900499,-64835545,5
6314,0.600522,15000000,47175038,32175038,The Wedding Date,Debra Messing|Dermot Mulroney|Amy Adams|Jack Davenport|Jeremy Sheffield,Clare Kilner,88,Comedy|Romance,2005-02-04,133,6.2,2005,16748449,52673915,35925466,6
6315,0.592368999999999,25000000,2405420,-22594580,BloodRayne,Kristanna Loken|Ben Kingsley|Michelle Rodriguez|Michael Madsen|Matthew Davis,Uwe Boll,95,Action|Adventure|Fantasy|Horror,2005-10-22,62,3.8,2005,27914082,2685803,-25228279,4
6320,0.571693,130000000,119269486,-10730514,Sahara,Matthew McConaughey|PenÃ©lope Cruz|Steve Zahn|William H. Macy|Lennie James,Breck Eisner,124,Action|Adventure|Comedy|Drama|Mystery,2005-04-06,243,5.6,2005,145153227,133171929,-11981298,6
6321,0.564298,10000000,17297244,7297244,The Matador,Pierce Brosnan|Greg Kinnear|Hope Davis|Portia Dawson|Adam Scott,Richard Shepard,96,Action|Comedy|Crime|Drama|Thriller,2005-05-12,70,6.0,2005,11165632,19313467,8147835,6
6322,0.561685,7000000,49084830,42084830,Capote,Philip Seymour Hoffman|Allie Mickelson|Craig Archibald|Bronwen Coleman|Kate Shindle,Bennett Miller,114,Crime|Drama,2005-09-30,202,6.7,2005,7815943,54806319,46990376,7
6323,0.558258,35000000,19478106,-15521894,Valiant,Ewan McGregor|Ricky Gervais|Tim Curry|Jim Broadbent|Hugh Laurie,Gary Chapman,76,Animation|Family|Adventure,2005-03-25,138,5.3,2005,39079715,21748538,-17331177,5
6324,0.55197,25000000,82466670,57466670,The Constant Gardener,Ralph Fiennes|Rachel Weisz|Danny Huston|Bill Nighy|Donald Sumpter,Fernando Meirelles,129,Drama|Mystery|Thriller,2005-08-31,206,6.7,2005,27914082,92079256,64165174,7
6326,0.548165999999999,950000,7022209,6072209,Hard Candy,Patrick Wilson|Ellen Page|Sandra Oh|Odessa Rae|G.J. Echternkamp,David Slade,103,Drama|Thriller,2005-01-14,353,6.8,2005,1060735,7840740,6780005,7
6327,0.543159,40000000,68766121,28766121,House of Wax,Elisha Cuthbert|Paris Hilton|Brian Van Holt|Jared Padalecki|Chad Michael Murray,Jaume Collet-Serra,113,Horror,2005-05-06,334,5.3,2005,44662531,76781726,32119195,5
6328,0.538043,80000000,10166502,-69833498,The Great Raid,Benjamin Bratt|Robert Mammone|Max Martini|James Carpinello|Mark Consuelos,John Dahl,132,Action|Adventure|Drama|History|War,2005-08-12,53,6.5,2005,89325063,11351542,-77973521,6
6329,0.534781,50000000,22944502,-27055498,Domino,Keira Knightley|Mickey Rourke|Edgar RamÃ­rez|Delroy Lindo|Mo'Nique,Tony Scott,127,Action|Crime,2005-09-22,277,6.1,2005,55828164,25618988,-30209176,6
6332,0.511084,25000000,36351350,11351350,Beauty Shop,Queen Latifah|Alicia Silverstone|Andie MacDowell|Alfre Woodard|Mena Suvari,Bille Woodruff,105,Comedy|Romance,2005-06-02,73,5.1,2005,27914082,40588582,12674500,5
6335,0.509128999999999,50000000,69425966,19425966,The Adventures of Sharkboy and Lavagirl,Taylor Lautner|Taylor Dooley|Cayden Boyd|George Lopez|David Arquette,Robert Rodriguez,92,Adventure|Fantasy|Action|Family,2005-06-10,148,4.3,2005,55828164,77518484,21690320,4
6337,0.500883,25000000,15431177,-9568823,The Greatest Game Ever Played,Shia LaBeouf|Stephen Dillane|Josh Flitter|Peter Firth|Peyton List,Bill Paxton,120,Drama|Family,2005-09-30,64,7.0,2005,27914082,17229885,-10684197,7
6341,0.484314,15000000,12036149,-2963851,The Three Burials of Melquiades Estrada,Tommy Lee Jones|Barry Pepper|Dwight Yoakam|January Jones|Melissa Leo,Tommy Lee Jones,121,Adventure|Crime|Drama|Mystery|Western,2005-11-17,75,6.7,2005,16748449,13439122,-3309327,7
6344,0.466529,1000000,10047674,9047674,Cry_Wolf,Julian Morris|Lindy Booth|Jared Padalecki|Jon Bon Jovi|Sandra McCoy,Jeff Wadlow,90,Horror|Thriller,2005-09-16,62,5.4,2005,1116563,11218863,10102300,5
6345,0.463862,30000000,27610873,-2389127,Goal!: The Dream Begins,Kuno Becker|Alessandro Nivola|Anna Friel|Stephen Dillane|Gary Lewis,Danny Cannon,118,Drama,2005-06-06,119,6.5,2005,33496898,30829287,-2667611,6
6346,0.463596,10000000,91196419,81196419,White Noise,Michael Keaton|Chandra West|Deborah Kara Unger|Ian McNeice|Keegan Connor Tracy,Geoffrey Sax,101,Drama|Horror|Thriller,2005-01-07,125,5.5,2005,11165632,101826573,90660941,5
6348,0.45648,475000,3919254,3444254,Brick,Joseph Gordon-Levitt|Emilie de Ravin|Nora Zehetner|Lukas Haas|Richard Roundtree,Rian Johnson,110,Drama|Mystery,2005-01-30,177,6.8,2005,530367,4376095,3845728,7
6349,0.453059,30000000,251495,-29748505,Dominion: Prequel to the Exorcist,Stellan SkarsgÃ¥rd|Gabriel Mann|Clara Bellar|Billy Crawford|Ralph Brown,Paul Schrader,117,Horror|Thriller|Drama,2005-05-20,38,4.6,2005,33496898,280810,-33216088,5
6351,0.449627,30000000,30536013,536013,The New World,Colin Farrell|Q'orianka Kilcher|Christopher Plummer|Christian Bale|August Schellenberg,Terrence Malick,135,Drama|History|Romance,2005-12-25,157,6.1,2005,33496898,34095391,598493,6
6352,0.449064,14200000,674918,-13525082,Manderlay,Bryce Dallas Howard|Isaach De BankolÃ©|Danny Glover|Willem Dafoe|MichaÃ«l Abiteboul,Lars von Trier,139,Drama,2005-05-16,33,6.9,2005,15855198,753588,-15101610,7
6354,0.444301,35000000,86369815,51369815,Sky High,Michael Angarano|Kurt Russell|Kelly Preston|Danielle Panabaker|Kevin Heffernan,Mike Mitchell,100,Adventure|Comedy|Family,2005-07-29,292,5.8,2005,39079715,96437364,57357649,6
6355,0.443093999999999,900000,381420,-518580,The Quiet,Elisha Cuthbert|Camilla Belle|Edie Falco|Martin Donovan|Shawn Ashmore,Jamie Babbit,96,Drama|Thriller,2005-09-12,34,5.6,2005,1004906,425879,-579027,6
6356,0.441927,26000000,57891803,31891803,Red Eye,Rachel McAdams|Cillian Murphy|Brian Cox|Jayma Mays|Laura Johnson,Wes Craven,85,Horror|Thriller,2005-08-04,225,6.1,2005,29030645,64639862,35609217,6
6365,0.42232,7000000,2697930,-4302070,Everything is Illuminated,Elijah Wood|Eugene Hutz|Boris Leskin|Jana Hrabetova|Jonathan Safran Foer,Liev Schreiber,106,Comedy|Drama,2005-09-16,130,7.4,2005,7815943,3012409,-4803534,7
6369,0.406323,1500000,712294,-787706,The Ballad of Jack and Rose,Daniel Day-Lewis|Camilla Belle|Catherine Keener|Ryan McDonald|Paul Dano,Rebecca Miller,111,Drama,2005-03-25,22,6.4,2005,1674844,795321,-879523,6
6370,0.405822,45000000,72028752,27028752,"Yours, Mine & Ours",Dennis Quaid|Rene Russo|Sean Faris|Katija Pevec|Dean Collins,Raja Gosnell,90,Comedy|Family|Romance,2005-11-23,144,5.7,2005,50245348,80424660,30179312,6
6375,0.390848,45000000,38058335,-6941665,The Producers,Matthew Broderick|Uma Thurman|Will Ferrell|Eileen Essell|Gary Beach,Susan Stroman,134,Comedy|Music,2005-12-25,84,5.9,2005,50245348,42494539,-7750809,6
6377,0.387304,818418,4851244,4032826,Romanzo criminale,Stefano Accorsi|Kim Rossi Stuart|Pierfrancesco Favino|Claudio Santamaria|Riccardo Scamarcio,Michele Placido,152,Drama,2005-09-30,56,6.9,2005,913815,5416720,4502905,7
6379,0.37807,8000000,22201636,14201636,Hustle & Flow,Terrence Howard|Anthony Anderson|Taryn Manning|Taraji P. Henson|Elise Neal,Craig Brewer,116,Drama,2005-07-22,50,6.2,2005,8932506,24789531,15857025,6
6380,0.374704,1000000,13350369,12350369,Transamerica,Felicity Huffman|Kevin Zegers|Elizabeth PeÃ±a|Danny Burstein|Maurice Orozco,Duncan Tucker,103,Drama,2005-12-23,65,6.5,2005,1116563,14906531,13789968,6
6384,0.370396,20000000,10442808,-9557192,Alone in the Dark,Christian Slater|Tara Reid|Stephen Dorff|Frank C. Turner|Matthew Walker,Uwe Boll,96,Action|Fantasy|Horror|Thriller,2005-01-28,74,3.5,2005,22331265,11660056,-10671209,3
6385,0.369596,20000000,67192859,47192859,Boogeyman,Emily Deschanel|Barry Watson|Skye McCole Bartusiak|Lucy Lawless|Tory Mussett,Stephen Kay,89,Thriller|Horror|Drama|Mystery,2005-02-04,91,4.5,2005,22331265,75025079,52693814,4
6386,0.367248,13000000,23727301,10727301,Les PoupÃ©es Russes,Romain Duris|Kelly Reilly|Audrey Tautou|CÃ©cile De France|Kevin Bishop,CÃ©dric Klapisch,129,Comedy|Drama|Romance,2005-06-15,106,6.7,2005,14515322,26493033,11977711,7
6399,0.332997,30000000,15007991,-14992009,The Cave,Cole Hauser|Eddie Cibrian|Morris Chestnut|Lena Headey|Piper Perabo,Bruce Hunt,97,Action|Adventure|Horror|Thriller,2005-08-25,111,5.2,2005,33496898,16757371,-16739527,5
6400,0.330618,40000000,31670620,-8329380,Rent,Anthony Rapp|Adam Pascal|Rosario Dawson|Jesse L. Martin|Wilson Jermaine Heredia,Chris Columbus,135,Comedy|Drama|Music|Romance,2005-11-23,89,6.5,2005,44662531,35362251,-9300280,6
6406,0.326577,1500000,11098131,9598131,The Squid and the Whale,Jeff Daniels|Laura Linney|Jesse Eisenberg|Owen Kline|William Baldwin,Noah Baumbach,81,Comedy|Drama,2005-10-05,118,6.7,2005,1674844,12391765,10716921,7
6420,0.290754,2000000,653621,-1346379,Inside Deep Throat,Dennis Hopper|Peter Bart|Warren Beatty|Carl Bernstein,Fenton Bailey|Randy Barbato,92,Documentary,2005-02-11,17,6.8,2005,2233126,729809,-1503317,7
6423,0.287286,7500000,143000,-7357000,Man-Thing,Matthew Le Nevez|Rachael Taylor|Jack Thompson|Rawiri Paratene|Steve Bastoni,Brett Leonard,97,Action|Horror|Science Fiction,2005-04-21,15,3.9,2005,8374224,159668,-8214556,4
6424,0.285062,1549000,7096000,5547000,Tau man ji D,Jay Chou|Shawn Yue|Edison Chen|Anthony Wong|Anne Suzuki,Andrew Lau|Alan Mak,107,Action|Crime|Thriller|Drama,2005-05-12,33,6.0,2005,1729556,7923133,6193577,6
6432,0.278997,4750000,206871,-4543129,Tamara,Jenna Dewan|Marc Devigne|Chad Faust|Katie Stuart|Bryan Clark,Jeremy Haft,98,Fantasy|Horror|Thriller,2005-05-12,31,4.9,2005,5303675,230984,-5072691,5
6435,0.270403,10284523,11588205,1303682,Shopgirl,Steve Martin|Claire Danes|Jason Schwartzman|Bridgette Wilson|Frances Conroy,Anand Tucker,104,Comedy|Drama|Romance,2005-10-21,31,5.8,2005,11483320,12938964,1455644,6
6437,0.269437,35000000,25224242,-9775758,North Country,Charlize Theron|Elle Peterson|Thomas Curtis|Frances McDormand|Sean Bean,Niki Caro,126,Drama,2005-02-12,63,6.8,2005,39079715,28164462,-10915253,7
6445,0.401768,450000,973525,523525,Conversations with Other Women,Helena Bonham Carter|Aaron Eckhart|Yury Tsykun|Brian Geraghty|Brianna Brown,Hans Canosa,84,Drama|Romance,2005-09-02,14,6.3,2005,502453,1087002,584549,6
6446,0.252383,8000000,852872,-7147128,Down in the Valley,Edward Norton|Evan Rachel Wood|David Morse|Rory Culkin|Bruce Dern,David Jacobson,112,Drama|Romance,2005-05-13,33,5.8,2005,8932506,952285,-7980221,6
6448,0.246144,12000000,84967,-11915033,Mozart and the Whale,Josh Hartnett|Radha Mitchell|Gary Cole|Sheila Kelley|Erica Leerhsen,Petter NÃ¦ss,92,Comedy|Drama|Romance,2005-09-10,22,6.8,2005,13398759,94871,-13303888,7
6449,0.242227,30000000,34252847,4252847,Bad News Bears,Billy Bob Thornton|Ken Medlock|Aman Johal|Greg Kinnear|Marcia Gay Harden,Richard Linklater,113,Comedy|Family,2005-07-22,34,5.5,2005,33496898,38245471,4748573,5
6464,0.198611,14000000,32645546,18645546,Because of Winn-Dixie,Jeff Daniels|AnnaSophia Robb|Cicely Tyson|Eva Marie Saint|Dave Matthews,Wayne Wang,106,Comedy|Drama|Family,2005-02-18,35,6.1,2005,15631886,36450818,20818932,6
6467,0.195984,25000000,13411957,-11588043,Lords of Dogtown,Emile Hirsch|Victor Rasuk|Rebecca De Mornay|John Robinson|Michael Angarano,Catherine Hardwicke,107,Drama,2005-06-03,118,6.9,2005,27914082,14975298,-12938784,7
6469,0.191177,2000000,5048693,3048693,The Proposition,Guy Pearce|Ray Winstone|Emily Watson|Danny Huston|David Wenham,John Hillcoat,104,Action|Adventure|Crime|Drama|Thriller,2005-10-06,103,7.0,2005,2233126,5637185,3404059,7
6475,0.183927,9600000,4386236,-5213764,The Lost City,Andy GarcÃ­a|Richard Bradford|Nestor Carbonell|Enrique Murciano|Dominik GarcÃ­a-Lorido,Andy GarcÃ­a,144,Drama|Romance,2005-09-03,13,6.4,2005,10719007,4897510,-5821497,6
6480,0.177398,30000000,25473093,-4526907,Dark Water,Jennifer Connelly|John C. Reilly|Tim Roth|Dougray Scott|Pete Postlethwaite,Walter Salles,105,Drama|Horror|Thriller,2005-06-27,113,5.2,2005,33496898,28442320,-5054578,5
6500,0.151442,3000000,11718595,8718595,Dave Chappelle's Block Party,Dave Chappelle|Erykah Badu|Common|Mos Def|Bilal,Michel Gondry,100,Comedy|Documentary|Music,2005-09-12,15,7.0,2005,3349689,13084552,9734863,7
6502,0.149319,14000000,6856989,-7143011,Bee Season,Richard Gere|Flora Cross|Max Minghella|Kate Bosworth|Juliette Binoche,Scott McGehee,104,Drama|Family,2005-09-03,10,5.1,2005,15631886,7656262,-7975624,5
6507,0.141936999999999,8000000,2019009,-5980991,Maurice Richard,Roy Dupuis|Michel Barrette|RÃ©my Girard|Tony Calabretta|Sean Avery,Charles BinamÃ©,124,Drama,2005-10-25,10,5.5,2005,8932506,2254351,-6678155,5
6539,0.075624,3000000,9879971,6879971,Tsotsi,Presley Chweneyagae|Jerry Mofokeng|Terry Pheto|Kenneth Nkosi|Zenzo Ngqobe,Gavin Hood,94,Crime|Drama,2005-08-18,42,6.8,2005,3349689,11031612,7681923,7
6554,5.838503,50000000,111340801,61340801,Underworld: Evolution,Kate Beckinsale|Scott Speedman|Tony Curran|Shane Brolly|Derek Jacobi,Len Wiseman,106,Fantasy|Action|Science Fiction|Thriller,2006-01-12,1015,6.3,2006,54083457,120433910,66350453,6
6555,4.205992,200000000,1065659812,865659812,Pirates of the Caribbean: Dead Man's Chest,Johnny Depp|Orlando Bloom|Keira Knightley|Bill Nighy|Jack Davenport,Gore Verbinski,151,Adventure|Fantasy|Action,2006-06-20,3181,6.8,2006,216333831,1152691351,936357520,7
6556,3.941265,120000000,461983149,341983149,Cars,Owen Wilson|Paul Newman|Bonnie Hunt|Larry the Cable Guy|Cheech Marin,John Lasseter|Joe Ranft,117,Animation|Adventure|Comedy|Family,2006-06-08,2336,6.4,2006,129800298,499712923,369912625,6
6557,3.78958,150000000,599045960,449045960,Casino Royale,Daniel Craig|Eva Green|Mads Mikkelsen|Judi Dench|Jeffrey Wright,Martin Campbell,144,Adventure|Action|Thriller,2006-11-14,2738,7.1,2006,162250373,647969539,485719166,7
6558,3.655536,125000000,758239851,633239851,The Da Vinci Code,Tom Hanks|Audrey Tautou|Ian McKellen|Paul Bettany|Jean Reno,Ron Howard,149,Thriller|Mystery,2006-05-17,1585,6.4,2006,135208644,820164661,684956017,6
6559,3.206696,12000000,114194847,102194847,Step Up,Channing Tatum|Jenna Dewan|Damaine Radcliff|De'Shawn Washington|Mario,Anne Fletcher,104,Music|Drama|Romance|Crime,2006-08-11,619,6.7,2006,12980029,123521044,110541015,7
6560,3.145562,80000000,660940780,580940780,Ice Age: The Meltdown,Ray Romano|John Leguizamo|Denis Leary|Queen Latifah|Seann William Scott,Carlos Saldanha,91,Animation|Family|Comedy|Adventure,2006-03-23,1775,6.4,2006,86533532,714919257,628385725,6
6561,3.098051,150000000,397850012,247850012,Mission: Impossible III,Tom Cruise|Philip Seymour Hoffman|Ving Rhames|Billy Crudup|Jonathan Rhys Meyers,J.J. Abrams,126,Adventure|Action|Thriller,2006-05-03,1363,6.3,2006,162250373,430342087,268091714,6
6562,3.03143,35000000,326551094,291551094,The Devil Wears Prada,Meryl Streep|Anne Hathaway|Emily Blunt|Stanley Tucci|Simon Baker,David Frankel,109,Comedy|Drama|Romance,2006-06-30,1773,7.0,2006,37858420,353220246,315361826,7
6563,2.81975,90000000,289847354,199847354,The Departed,Leonardo DiCaprio|Matt Damon|Jack Nicholson|Mark Wahlberg|Martin Sheen,Martin Scorsese,151,Drama|Thriller|Crime,2006-10-05,2635,7.7,2006,97350224,313518943,216168719,8
6564,2.606305,85000000,194168700,109168700,The Holiday,Cameron Diaz|Kate Winslet|Jude Law|Jack Black|Eli Wallach,Nancy Meyers,136,Comedy|Romance,2006-12-08,748,6.7,2006,91941878,210026294,118084416,7
6565,2.582095,40000000,109676311,69676311,The Prestige,Hugh Jackman|Christian Bale|Michael Caine|Scarlett Johansson|Andy Serkis,Christopher Nolan,130,Drama|Mystery|Thriller,2006-10-19,2519,7.8,2006,43266766,118633483,75366717,8
6566,2.313345,110000000,574480841,464480841,Night at the Museum,Ben Stiller|Jake Cherry|Carla Gugino|Robin Williams|Dick Van Dyke,Shawn Levy,108,Action|Adventure|Comedy|Family|Fantasy,2006-10-20,1572,6.2,2006,118983607,621398207,502414600,6
6567,2.160936,25000000,135330182,110330182,Babel,Brad Pitt|Cate Blanchett|Gael GarcÃ­a Bernal|Rinko Kikuchi|Adriana Barraza,Alejandro GonzÃ¡lez IÃ±Ã¡rritu,143,Drama,2006-09-08,606,6.7,2006,27041728,146382484,119340756,7
6568,2.108369,76000000,69959751,-6040249,Children of Men,Clive Owen|Michael Caine|Julianne Moore|Charlie Hunnam|Chiwetel Ejiofor,Alfonso CuarÃ³n,109,Drama|Action|Thriller|Science Fiction,2006-09-22,1211,7.3,2006,82206856,75673304,-6533552,7
6570,1.957331,270000000,391081192,121081192,Superman Returns,Brandon Routh|Kevin Spacey|Kate Bosworth|James Marsden|Parker Posey,Bryan Singer,154,Adventure|Fantasy|Action|Science Fiction,2006-06-28,834,5.3,2006,292050672,423020463,130969791,5
6571,1.930735,18000000,261572744,243572744,Borat: Cultural Learnings of America for Make Benefit Glorious Nation of Kazakhstan,Sacha Baron Cohen|Ken Davitian|Luenell|Pamela Anderson|Bob Barr,Larry Charles,82,Comedy,2006-11-02,979,6.4,2006,19470044,282935169,263465125,6
6572,1.888746,82500000,237681299,155181299,Click,Adam Sandler|Kate Beckinsale|Christopher Walken|David Hasselhoff|Henry Winkler,Frank Coraci,107,Comedy|Drama|Fantasy|Romance,2006-06-22,1273,5.9,2006,89237705,257092530,167854825,6
6574,1.76935,52000000,204999686,152999686,The Break-Up,Vince Vaughn|Jennifer Aniston|Joey Lauren Adams|Cole Hauser|Jon Favreau,Peyton Reed,106,Romance|Comedy,2006-06-01,520,5.5,2006,56246796,221741837,165495041,5
6575,1.747256,45000000,184376254,139376254,Inside Man,Denzel Washington|Clive Owen|Jodie Foster|Christopher Plummer|Willem Dafoe,Spike Lee,129,Crime|Drama|Thriller,2006-03-23,990,7.2,2006,48675112,199434107,150758995,7
6576,1.615244,80000000,155019340,75019340,Over the Hedge,Bruce Willis|Garry Shandling|Steve Carell|Wanda Sykes|William Shatner,Tim Johnson|Karey Kirkpatrick,83,Comedy|Animation|Family,2006-04-22,617,6.2,2006,86533532,167679639,81146107,6
6577,1.6128,50000000,132180323,82180323,Perfume: The Story of a Murderer,Ben Whishaw|Simon Chandler|David Calder|Richard Felix|Birgit Minichmayr,Tom Tykwer,147,Crime|Fantasy|Drama,2006-09-13,647,7.0,2006,54083457,142975378,88891921,7
6578,1.60314,100000000,170877916,70877916,Blood Diamond,Leonardo DiCaprio|Djimon Hounsou|Jennifer Connelly|Kagiso Kuypers|Arnold Vosloo,Edward Zwick,143,Drama|Thriller|Action,2006-12-07,1394,7.2,2006,108166915,184833371,76666456,7
6580,1.526073,12000000,42931041,30931041,Crank,Jason Statham|Amy Smart|Jose Pablo Cantillo|Efren Ramirez|Dwight Yoakam,Brian Taylor|Mark Neveldine,88,Action|Thriller|Crime,2006-08-31,732,6.5,2006,12980029,46437182,33457153,6
6581,1.520387,27000000,56308881,29308881,Lucky Number Slevin,Josh Hartnett|Bruce Willis|Lucy Liu|Morgan Freeman|Ben Kingsley,Paul McGuigan,110,Drama|Thriller|Crime|Mystery,2006-02-24,787,7.3,2006,29205067,60907579,31702512,7
6582,1.51114,40000000,120455994,80455994,Eight Below,Paul Walker|Bruce Greenwood|Moon Bloodgood|Jason Biggs|Gerard Plunkett,Frank Marshall,120,Adventure|Drama|Family,2006-02-17,328,6.6,2006,43266766,130293533,87026767,7
6583,1.498538,25000000,117719158,92719158,Final Destination 3,Mary Elizabeth Winstead|Ryan Merriman|Kris Lemche|Alexz Johnson|Sam Easton,James Wong,93,Horror|Mystery,2006-02-10,535,5.8,2006,27041728,127333182,100291454,6
6584,1.498352,50000000,97607453,47607453,Silent Hill,Radha Mitchell|Sean Bean|Laurie Holden|Deborah Kara Unger|Kim Coates,Christophe Gans,125,Horror|Mystery,2006-04-21,580,6.3,2006,54083457,105578971,51495514,6
6585,1.470711,20000000,33889159,13889159,She's the Man,Amanda Bynes|Channing Tatum|Laura Ramsey|Vinnie Jones|David Cross,Andy Fickman,105,Comedy|Drama|Family|Romance,2006-03-17,395,6.3,2006,21633383,36656858,15023475,6
6586,1.432839,35000000,15304890,-19695110,The Fountain,Hugh Jackman|Rachel Weisz|Ellen Burstyn|Mark Margolis|Stephen McHattie,Darren Aronofsky,96,Drama|Adventure|Science Fiction|Romance,2006-09-06,371,6.7,2006,37858420,16554827,-21303593,7
6587,1.411147,100000000,384335608,284335608,Happy Feet,Lombardo Boyar|Robin Williams|Johnny A. Sanchez|Carlos Alazraqui|Jeffrey Garcia,George Miller,108,Music|Animation|Comedy|Family,2006-11-16,876,5.8,2006,108166915,415723973,307557058,6
6588,1.409773,24000000,155721132,131721132,Rocky Balboa,Sylvester Stallone|Burt Young|Milo Ventimiglia|Geraldine Hughes|James Francis Kelly III,Sylvester Stallone,102,Drama,2006-12-20,455,6.4,2006,25960059,168438745,142478686,6
6590,1.390297,149000000,64459316,-84540684,Flushed Away,Hugh Jackman|Kate Winslet|Ian McKellen|Jean Reno|Bill Nighy,David Bowers|Sam Fell,85,Adventure|Animation|Comedy|Family,2006-10-22,488,6.0,2006,161168704,69723654,-91445050,6
6591,1.363623,80000000,37384046,-42615954,The Wild,Kiefer Sutherland|Jim Belushi|Eddie Izzard|Janeane Garofalo|William Shatner,Steve 'Spaz' Williams,94,Family|Animation,2006-03-06,137,5.2,2006,86533532,40437169,-46096363,5
6592,1.35007,75000000,180557550,105557550,DÃ©jÃ  Vu,Denzel Washington|Paula Patton|Val Kilmer|Jim Caviezel|Adam Goldberg,Tony Scott,126,Action|Thriller|Science Fiction,2006-11-21,862,6.5,2006,81125186,195303533,114178347,6
6593,1.296272,100000000,249288105,149288105,Eragon,Ed Speleers|Jeremy Irons|Sienna Guillory|Robert Carlyle|Djimon Hounsou,Stefen Fangmeier,104,Fantasy|Action|Adventure|Family,2006-12-14,536,4.8,2006,108166915,269647254,161480339,5
6594,1.259442,40000000,114830111,74830111,The Lake House,Keanu Reeves|Sandra Bullock|Shohreh Aghdashloo|Christopher Plummer|Ebon Moss-Bachrach,Alejandro Agresti,99,Romance|Drama|Mystery,2006-06-16,389,6.3,2006,43266766,124208189,80941423,6
6595,1.241836,45000000,178262620,133262620,Scary Movie 4,Anna Faris|Regina Hall|Craig Bierko|Bill Pullman|Anthony Anderson,David Zucker,83,Comedy,2006-04-13,368,5.3,2006,48675112,192821178,144146066,5
6596,1.235478,75000000,140175006,65175006,Monster House,Ryan Newman|Steve Buscemi|Mitchel Musso|Sam Lerner|Spencer Locke,Gil Kenan,91,Animation|Comedy|Family|Fantasy,2006-07-21,501,6.3,2006,81125186,151622980,70497794,6
6598,1.223177,50000000,88715192,38715192,Failure to Launch,Matthew McConaughey|Sarah Jessica Parker|Zooey Deschanel|Justin Bartha|Bradley Cooper,Tom Dey,97,Comedy,2006-03-10,242,5.6,2006,54083457,95960487,41877030,6
6599,1.21726,40000000,120175290,80175290,Apocalypto,Rudy Youngblood|Dalia HernÃ¡ndez|Jonathan Brewer|Morris Birdyellowhead|Raoul Max Trujillo,Mel Gibson,139,Thriller|Action|Adventure|Drama,2006-12-07,667,7.1,2006,43266766,129989904,86723138,7
6600,1.211868,50000000,55181129,5181129,The Ant Bully,Julia Roberts|Meryl Streep|Nicolas Cage|Paul Giamatti|Bruce Campbell,John A. Davis,88,Fantasy|Adventure|Animation|Comedy|Family,2006-07-27,228,5.5,2006,54083457,59687725,5604268,5
6601,1.20839,15000000,69623713,54623713,The Hills Have Eyes,Aaron Stanford|Kathleen Quinlan|Vinessa Shaw|Emilie de Ravin|Dan Byrd,Alexandre Aja,107,Horror|Thriller,2006-03-10,359,6.0,2006,16225037,75309823,59084786,6
6603,1.194602,28000000,38159905,10159905,Just My Luck,Lindsay Lohan|Samaire Armstrong|Chris Pine|Missi Pyle|Makenzie Vega,Donald Petrie,103,Comedy|Drama|Family|Fantasy|Romance,2006-05-12,271,5.7,2006,30286736,41276392,10989656,6
6604,1.18228,85000000,59908565,-25091435,The Good Shepherd,Matt Damon|Angelina Jolie|Alec Baldwin|Tammy Blanchard|Billy Crudup,Robert De Niro,167,Drama|Thriller|History,2006-12-11,174,5.9,2006,91941878,64801247,-27140631,6
6605,1.1334,30000000,31070211,1070211,Ultraviolet,Milla Jovovich|Cameron Bright|Nick Chinlund|William Fichtner|Ida Martin,Kurt Wimmer,88,Science Fiction|Action|Thriller,2006-03-03,256,5.0,2006,32450074,33607688,1157614,5
6607,1.114239,135000000,163794509,28794509,Miami Vice,Jamie Foxx|Colin Farrell|Gong Li|Luis Tosar|Naomie Harris,Michael Mann,134,Action|Adventure|Crime|Thriller,2006-07-27,283,5.7,2006,146025336,177171468,31146132,6
6608,1.110072,18000000,41009669,23009669,John Tucker Must Die,Jesse Metcalfe|Brittany Snow|Sophia Bush|Arielle Kebbel|Ashanti,Betty Thomas,87,Comedy,2006-07-27,206,6.0,2006,19470044,44358894,24888850,6
6609,1.109411,31000000,28000000,-3000000,Tristan & Isolde,James Franco|Sophia Myles|Rufus Sewell|David O'Hara|Henry Cavill,Kevin Reynolds,125,Drama,2006-04-07,123,6.2,2006,33531743,30286736,-3245007,6
6610,1.103135,90000000,65900249,-24099751,Flags of Our Fathers,Ryan Phillippe|Adam Beach|Jesse Bradford|John Benjamin Hickey|John Slattery,Clint Eastwood,132,War|Drama|History,2006-10-19,308,6.7,2006,97350224,71282266,-26067958,7
6611,1.102933,2000000,5179037,3179037,Shortbus,Sook-Yin Lee|Paul Dawson|PJ DeBoy|Jay Brannan|Lindsay Beamish,John Cameron Mitchell,101,Romance|Drama|Comedy,2006-05-20,78,6.5,2006,2163338,5602004,3438666,6
6613,1.057194,50000000,69834815,19834815,Curious George,Frank Welker|Will Ferrell|Shane Baumel|Eugene Levy|Timyra-Joi Beatty,Matthew O'Callaghan,86,Adventure|Animation|Comedy|Family,2006-02-10,68,5.8,2006,54083457,75538165,21454708,6
6614,1.038954,40000000,38755073,-1244927,The Wicker Man,Nicolas Cage|Ellen Burstyn|Kate Beahan|Frances Conroy|Leelee Sobieski,Neil LaBute,102,Mystery|Thriller|Horror,2006-09-01,179,4.0,2006,43266766,41920167,-1346599,4
6615,1.027989,17000000,57103895,40103895,Smokin' Aces,Ryan Reynolds|Ray Liotta|Joseph Ruskin|Alex Rocco|Wayne Newton,Joe Carnahan,109,Action|Comedy|Crime|Thriller,2006-12-09,306,6.3,2006,18388375,61767522,43379147,6
6617,0.987722,50000000,87528173,37528173,RV,Robin Williams|Cheryl Hines|Joanna 'JoJo' Levesque|Josh Hutcherson|Jeff Daniels,Barry Sonnenfeld,99,Comedy|Family|Adventure,2006-04-28,251,5.7,2006,54083457,94676525,40593068,6
6619,0.969469,65000000,43545364,-21454636,We Are Marshall,Matthew McConaughey|Matthew Fox|Anthony Mackie|David Strathairn|Ian McShane,McG,124,Drama,2006-12-12,107,6.5,2006,70308495,47101677,-23206818,6
6620,0.965931,40000000,86915017,46915017,The Illusionist,Edward Norton|Jessica Biel|Paul Giamatti|Rufus Sewell|Eddie Marsan,Neil Burger,110,Fantasy|Drama|Thriller|Romance,2006-08-18,967,7.0,2006,43266766,94013293,50746527,7
6622,0.941481,17500000,19179969,1679969,Beerfest,Erik Stolhanske|Jay Chandrasekhar|Steve Lemme|Paul Soter|M.C. Gainey,Jay Chandrasekhar,110,Comedy,2006-08-25,88,5.8,2006,18929210,20746380,1817170,6
6623,0.92958,25000000,5549200,-19450800,The Contract,Morgan Freeman|John Cusack|Alice Krige|Megan Dodds|Corey Johnson,Bruce Beresford,96,Drama|Action|Thriller|Crime,2006-04-05,90,5.4,2006,27041728,6002398,-21039330,5
6624,0.928134,55000000,9450897,-45549103,All the King's Men,Sean Penn|Jude Law|Kate Winslet|James Gandolfini|Patricia Clarkson,Steven Zaillian,125,Drama|Thriller,2006-09-10,51,5.4,2006,59491803,10222743,-49269060,5
6626,0.920528,40000000,138259062,98259062,Big Momma's House 2,Martin Lawrence|Nia Long|Emily Procter|Zachary Levi|Mark Moses,John Whitesell,99,Comedy|Crime,2006-01-26,231,5.6,2006,43266766,149550563,106283797,6
6627,0.916551,70000000,38629478,-31370522,Basic Instinct 2,Sharon Stone|David Morrissey|Charlotte Rampling|David Thewlis|Stan Collymore,Michael Caton-Jones,114,Crime|Mystery|Thriller,2006-03-29,101,4.5,2006,75716841,41784314,-33932527,4
6628,0.913299,5000000,26888376,21888376,Clerks II,Brian O'Halloran|Jeff Anderson|Jason Mewes|Kevin Smith|Rosario Dawson,Kevin Smith,97,Comedy,2006-05-25,195,6.9,2006,5408345,29084327,23675982,7
6629,0.912871,72500000,162966177,90466177,Talladega Nights: The Ballad of Ricky Bobby,Will Ferrell|John C. Reilly|Gary Cole|Austin Crim|Jake Johnson,Adam McKay,116,Comedy,2006-08-04,274,6.2,2006,78421013,176275487,97854474,6
6631,0.890909,55000000,307077295,252077295,The Pursuit of Happyness,Will Smith|Jaden Smith|Thandie Newton|Brian Howe|James Karen,Gabriele Muccino,117,Drama,2006-12-14,1392,7.5,2006,59491803,332156039,272664236,7
6632,0.883222,40000000,60474340,20474340,Marie Antoinette,Kirsten Dunst|Jason Schwartzman|Judy Davis|Rip Torn|Asia Argento,Sofia Coppola,123,Drama|History,2006-05-24,363,6.5,2006,43266766,65413228,22146462,6
6633,0.875629999999999,37665000,14655628,-23009372,Freedomland,Samuel L. Jackson|Julianne Moore|Edie Falco|Aunjanue Ellis|William Forsythe,Joe Roth,113,Drama|Thriller|Crime|Mystery,2006-02-17,44,5.3,2006,40741068,15852540,-24888528,5
6637,0.850959,6000000,48027970,42027970,The Last King of Scotland,Forest Whitaker|James McAvoy|Simon McBurney|Gillian Anderson|Kerry Washington,Kevin Macdonald,121,Drama,2006-09-01,274,7.3,2006,6490014,51950373,45460359,7
6638,0.849096,10000000,163876815,153876815,Saw III,Tobin Bell|Shawnee Smith|Angus Macfadyen|Bahar Soomekh|Dina Meyer,Darren Lynn Bousman,108,Horror|Thriller|Crime,2006-10-27,538,6.0,2006,10816691,177260496,166443805,6
6639,0.848086,30000000,495303,-29504697,Idiocracy,Luke Wilson|Maya Rudolph|Dax Shepard|Terry Crews|Anthony 'Citric' Campos,Mike Judge,84,Adventure|Comedy|Science Fiction,2006-09-01,326,6.1,2006,32450074,535753,-31914321,6
6640,0.840205,32000000,80197993,48197993,Nacho Libre,Jack Black|Ana de la Reguera|HÃ©ctor JimÃ©nez|Darius Rose|MoisÃ©s Arias,Jared Hess,92,Comedy|Family,2006-06-16,214,5.5,2006,34613413,86747695,52134282,5
6641,0.838430999999999,50000000,49111202,-888798,The Black Dahlia,Josh Hartnett|Scarlett Johansson|Aaron Eckhart|Hilary Swank|Mia Kirshner,Brian De Palma,121,Drama,2006-09-15,151,5.8,2006,54083457,53122072,-961385,6
6643,0.826011,160000000,181674817,21674817,Poseidon,Kurt Russell|Richard Dreyfuss|Josh Lucas|Jacinda Barrett|Emmy Rossum,Wolfgang Petersen,99,Adventure|Action|Drama|Thriller,2006-05-12,313,5.3,2006,173067065,196512046,23444981,5
6644,0.793804,17000000,7314027,-9685973,American Dreamz,Hugh Grant|Dennis Quaid|Mandy Moore|Willem Dafoe|Chris Klein,Paul Weitz,107,Comedy|Drama|Family,2006-03-04,43,4.6,2006,18388375,7911357,-10477018,5
6647,0.788266,16800000,2281089,-14518911,Fur: An Imaginary Portrait of Diane Arbus,Nicole Kidman|Robert Downey Jr.|Ty Burrell|Harris Yulin|Jane Alexander,Steven Shainberg,122,Drama|Mystery|Romance,2006-08-30,33,6.3,2006,18172041,2467383,-15704658,6
6648,0.780687,54000000,130431368,76431368,"You, Me and Dupree",Kate Hudson|Owen Wilson|Matt Dillon|Michael Douglas|Seth Rogen,Anthony Russo|Joe Russo,108,Comedy|Romance,2006-07-14,242,5.3,2006,58410134,141083588,82673454,5
6649,0.778589,8000000,100523181,92523181,Little Miss Sunshine,Greg Kinnear|Toni Collette|Steve Carell|Paul Dano|Abigail Breslin,Jonathan Dayton|Valerie Faris,102,Comedy|Drama,2006-07-26,952,7.3,2006,8653353,108732824,100079471,7
6650,0.773044,64000000,101595121,37595121,Little Man,Marlon Wayans|Shawn Wayans|Kerry Washington|John Witherspoon|Tracy Morgan,Keenen Ivory Wayans,98,Comedy|Crime,2006-08-31,143,5.6,2006,69226826,109892309,40665483,6
6654,0.743703,12000000,38368909,26368909,Employee of the Month,Dane Cook|Jessica Simpson|Dax Shepard|Andy Dick|Tim Bagley,Greg Coolidge,103,Comedy|Romance,2006-10-06,82,5.4,2006,12980029,41502465,28522436,5
6655,0.727752,25000000,119188334,94188334,The Omen,Liev Schreiber|Julia Stiles|Seamus Davey-Fitzpatrick|David Thewlis|Pete Postlethwaite,John Moore,110,Drama|Horror|Thriller,2006-06-06,154,5.2,2006,27041728,128922344,101880616,5
6656,0.723825,19000000,68673228,49673228,Letters from Iwo Jima,Ken Watanabe|Kazunari Ninomiya|Tsuyoshi Ihara|Ryo Kase|Nakamura ShidÅ II,Clint Eastwood,141,Action|Adventure|Drama|War,2006-12-19,292,6.9,2006,20551714,74281712,53729998,7
6658,0.715451,8500000,5480996,-3019004,A Scanner Darkly,Keanu Reeves|Winona Ryder|Woody Harrelson|Robert Downey Jr.|Mitch Baker,Richard Linklater,100,Animation|Science Fiction|Thriller,2006-05-25,282,6.7,2006,9194187,5928624,-3265563,7
6660,0.713697,30000000,53653224,23653224,Stranger Than Fiction,Will Ferrell|Maggie Gyllenhaal|Dustin Hoffman|Emma Thompson|Queen Latifah,Marc Forster,113,Comedy|Drama|Fantasy|Romance,2006-09-09,378,6.9,2006,32450074,58035037,25584963,7
6661,0.711674,63000000,162945894,99945894,World Trade Center,Nicolas Cage|Maria Bello|Maggie Gyllenhaal|Michael PeÃ±a|Jay Hernandez,Oliver Stone,128,Drama|History|Thriller,2006-08-09,240,5.9,2006,68145156,176253548,108108392,6
6663,0.70435,35000000,42064105,7064105,A Good Year,Russell Crowe|Marion Cotillard|Albert Finney|Tom Hollander|Abbie Cornish,Ridley Scott,118,Comedy|Drama|Romance,2006-09-09,199,6.4,2006,37858420,45499445,7641025,6
6666,0.702198,12000000,1381665,-10618335,Snow Cake,Alan Rickman|Sigourney Weaver|Carrie-Anne Moss|Emily Hampshire|James Allodi,Marc Evans,112,Romance|Drama,2006-02-09,23,7.4,2006,12980029,1494504,-11485525,7
6667,0.701814,15500000,7385434,-8114566,Itâ€™s a Boy Girl Thing,Kevin Zegers|Samaire Armstrong|Sherry Miller|Robert Joy|Sharon Osbourne,Nick Hurran,95,Comedy,2006-12-26,127,6.2,2006,16765871,7988596,-8777275,6
6668,0.698297,20000000,48548426,28548426,Date Movie,Alyson Hannigan|Adam Campbell|Sophie Monk|Jennifer Coolidge|Fred Willard,Aaron Seltzer|Jason Friedberg,83,Comedy,2006-02-17,103,3.9,2006,21633383,52513335,30879952,4
6669,0.692543,23000000,38505009,15505009,Accepted,Justin Long|Jonah Hill|Blake Lively|Adam Herschman|Columbus Short,Steve Pink,93,Comedy,2006-08-18,229,6.1,2006,24878390,41649680,16771290,6
6671,0.685491,85000000,197309027,112309027,Open Season,Martin Lawrence|Ashton Kutcher|Gary Sinise|Debra Messing|Billy Connolly,Roger Allers|Jill Culton|Anthony Stacchi,83,Adventure|Animation|Family,2006-09-29,395,6.1,2006,91941878,213423089,121481211,6
6673,0.674705,51000000,72779000,21779000,Barnyard,Courteney Cox|Kevin James|Sam Elliott|Danny Glover|Wanda Sykes,Steve Oedekerk,90,Animation|Comedy|Family,2006-08-04,124,5.3,2006,55165127,78722799,23557672,5
6674,0.67078,3700000,3338228,-361772,Unknown,Jim Caviezel|Greg Kinnear|Bridget Moynahan|Joe Pantoliano|Barry Pepper,Simon Brand,98,Crime|Drama|Mystery|Thriller,2006-11-03,44,6.4,2006,4002175,3610858,-391317,6
6676,0.6477,70000000,154937680,84937680,Dreamgirls,Jamie Foxx|BeyoncÃ© Knowles|Eddie Murphy|Danny Glover|Jennifer Hudson,Bill Condon,134,Drama,2006-12-25,146,6.5,2006,75716841,167591309,91874468,6
6677,0.646745,33000000,62022014,29022014,Snakes on a Plane,Samuel L. Jackson|Julianna Margulies|Kenan Thompson|Nathan Phillips|Rachel Blanchard,David R. Ellis,105,Horror|Action|Crime|Thriller,2006-08-06,236,5.2,2006,35695082,67087299,31392217,5
6679,0.641047,6500000,13368437,6868437,Friends with Money,Catherine Keener|Jason Isaacs|Timm Sharp|Jennifer Aniston|Joan Cusack,Nicole Holofcener,88,Drama|Comedy|Romance,2006-09-07,67,5.0,2006,7030849,14460225,7429376,5
6680,0.638444,11000000,72778712,61778712,Jackass Number Two,Johnny Knoxville|Bam Margera|Steve-O|Chris Pontius|Ryan Dunn,Jeff Tremaine,95,Action|Comedy|Documentary,2006-09-22,180,6.4,2006,11898360,78722488,66824128,6
6681,0.632875,70000000,55011732,-14988268,The Guardian,Kevin Costner|Ashton Kutcher|Sela Ward|Melissa Sagemiller|Omari Hardwick,Andrew Davis,139,Action,2006-09-28,212,7.0,2006,75716841,59504493,-16212348,7
6683,0.631574,17000000,374743,-16625257,Southland Tales,Dwayne Johnson|Seann William Scott|Sarah Michelle Gellar|Mandy Moore|Will Sasso,Richard Kelly,144,Action|Adventure|Comedy|Drama|Science Fiction,2006-05-15,79,4.9,2006,18388375,405347,-17983028,5
6684,0.62873,85000000,158468292,73468292,The Fast and the Furious: Tokyo Drift,Lucas Black|Sung Kang|Brian Tee|Nathalie Kelley|Shad Moss,Justin Lin,104,Action|Crime|Drama|Thriller,2006-06-03,1074,6.1,2006,91941878,171410264,79468386,6
6686,0.620633,30000000,35078241,5078241,Miss Potter,Ewan McGregor|RenÃ©e Zellweger|Emily Watson|Barbara Flynn|Bill Paterson,Chris Noonan,92,Drama|Family|Romance,2006-12-03,81,6.2,2006,32450074,37943051,5492977,6
6687,0.614854,38000000,29907685,-8092315,Pulse,Kristen Bell|Ian Somerhalder|Christina Milian|Rick Gonzalez|Jonathan Tucker,Jim Sonzero,90,Horror|Thriller,2006-08-11,71,5.1,2006,41103428,32350220,-8753208,5
6689,0.609408,15000000,10903846,-4096154,Black Snake Moan,"Samuel L. Jackson|Christina Ricci|Justin Timberlake|S. Epatha Merkerson|John Cothran, Jr.",Craig Brewer,116,Drama,2006-12-08,110,6.3,2006,16225037,11794353,-4430684,6
6690,0.606808,50000000,9448082,-40551918,Goya's Ghosts,Javier Bardem|Natalie Portman|Stellan SkarsgÃ¥rd|Randy Quaid|JosÃ© Luis GÃ³mez,MiloÅ¡ Forman,114,Drama,2006-11-08,46,6.7,2006,54083457,10219698,-43863759,7
6694,0.589842,25000000,11772461,-13227539,The Hoax,Richard Gere|Alfred Molina|Marcia Gay Harden|Hope Davis|Julie Delpy,Lasse HallstrÃ¶m,116,Comedy|Drama,2006-10-14,22,6.5,2006,27041728,12733907,-14307821,6
6695,0.582876,20000000,22165608,2165608,The Marine,John Cena|Kelly Carlson|Robert Patrick|Abigail Bianca|Anthony Ray Parker,John Bonito,92,Action|Adventure|Drama|Thriller,2006-10-13,94,5.0,2006,21633383,23975854,2342471,5
6698,0.569422999999999,12000000,6754898,-5245102,Running with Scissors,Annette Bening|Brian Cox|Joseph Cross|Joseph Fiennes|Evan Rachel Wood,Ryan Murphy,116,Drama|Comedy,2006-10-27,35,5.6,2006,12980029,7306564,-5673465,6
6699,0.56593,50000000,61112916,11112916,The Shaggy Dog,Tim Allen|Kristin Davis|Danny Glover|Spencer Breslin|Robert Downey Jr.,Brian Robbins,98,Comedy|Family,2006-03-09,73,4.6,2006,54083457,66103956,12020499,5
6700,0.564215999999999,40000000,23937870,-16062130,Stormbreaker,Alex Pettyfer|Sarah Bolger|Ewan McGregor|Robbie Coltrane|Stephen Fry,Geoffrey Sax,93,Adventure|Action|Family,2006-07-21,120,5.0,2006,43266766,25892855,-17373911,5
6701,0.552267,6000000,57231524,51231524,Madea's Family Reunion,Tyler Perry|Blair Underwood|Lynn Whitfield|Boris Kodjoe|Lisa Arrindell,Tyler Perry,110,Drama|Comedy|Romance,2006-02-24,63,6.0,2006,6490014,61905574,55415560,6
6707,0.536631,85000000,144,-84999856,Charlotte's Web,Julia Roberts|Steve Buscemi|John Cleese|Oprah Winfrey|Cedric the Entertainer,Gary Winick,97,Comedy|Family|Fantasy,2006-12-15,161,6.0,2006,91941878,155,-91941723,6
6708,0.530814,30000000,34742066,4742066,Take the Lead,Antonio Banderas|Rob Brown|Yaya DaCosta|Alfre Woodard|John Ortiz,Liz Friedlander,108,Music,2006-03-17,79,6.4,2006,32450074,37579421,5129347,6
6709,0.529881,35000000,12506188,-22493812,Zoom,Tim Allen|Courteney Cox|Chevy Chase|Spencer Breslin|Kevin Zegers,Peter Hewitt,83,Fantasy|Comedy|Family,2006-08-11,84,5.1,2006,37858420,13527557,-24330863,5
6714,0.514836,12000000,23006849,11006849,Aquamarine,Emma Roberts|Joanna 'JoJo' Levesque|Sara Paxton|Jake McDorman|Arielle Kebbel,Elizabeth Allen Rosenbaum,104,Fantasy|Romance|Family|Comedy,2006-03-03,216,5.9,2006,12980029,24885798,11905769,6
6717,0.508401,10000000,7177143,-2822857,Rescue Dawn,Christian Bale|Steve Zahn|Marshall Bell|Toby Huss|Pat Healy,Werner Herzog,126,Adventure|Drama|War,2006-09-09,158,6.6,2006,10816691,7763294,-3053397,7
6718,0.501431,6500000,22889018,16389018,The Wind That Shakes the Barley,Cillian Murphy|PÃ¡draic Delaney|Liam Cunningham|Orla Fitzgerald|Gerard Kearney,Ken Loach,124,Drama|History|War,2006-05-18,71,6.5,2006,7030849,24758344,17727495,6
6720,0.496703,55000000,65664721,10664721,16 Blocks,Bruce Willis|Mos Def|David Morse|Jenna Stern|David Zayas,Richard Donner,105,Action|Adventure|Crime|Thriller,2006-03-01,404,6.1,2006,59491803,71027503,11535700,6
6721,0.489898,4000000,31584901,27584901,Scoop,Scarlett Johansson|Hugh Jackman|Woody Allen|Ian McShane|Kevin McNally,Woody Allen,96,Comedy|Mystery,2006-07-27,208,6.2,2006,4326676,34164413,29837737,6
6723,0.4819,45000000,38399961,-6600039,Last Holiday,Queen Latifah|LL Cool J|Timothy Hutton|Giancarlo Esposito|Alicia Witt,Wayne Wang,112,Adventure|Comedy|Drama,2006-01-13,72,6.4,2006,48675112,41536053,-7139059,6
6725,0.467297,15000000,49469904,34469904,Notes on a Scandal,Judi Dench|Cate Blanchett|Bill Nighy|Juno Temple|Max Lewis,Richard Eyre,92,Drama|Romance,2006-12-25,119,6.3,2006,16225037,53510069,37285032,6
6726,0.463155,15000000,76286096,61286096,United 93,J.J. Johnson|Polly Adams|Trish Gates|Nancy McDoniel|Opal Alladin,Paul Greengrass,111,Drama|History|Crime|Thriller|Action,2006-04-28,180,6.6,2006,16225037,82516317,66291280,7
6727,0.461865,994000,165000,-829000,Kidulthood,Aml Ameen|Red Madrell|Noel Clarke|Adam Deacon|Jaime Winstone,Menhaj Huda,89,Drama,2006-03-03,25,6.5,2006,1075179,178475,-896704,6
6728,0.458112,21000000,480314,-20519686,DOA: Dead or Alive,Jaime Pressly|Devon Aoki|Holly Valance|Sarah Carter|Natassia Malthe,Corey Yuen Kwai,87,Adventure|Action|Thriller,2006-09-07,116,4.9,2006,22715052,519540,-22195512,5
6730,0.451217,15000000,123384128,108384128,The Queen,Helen Mirren|Michael Sheen|James Cromwell|Sylvia Syms|Helen McCrory,Stephen Frears,103,Drama,2006-09-15,159,6.6,2006,16225037,133460805,117235768,7
6732,0.441629,60000000,77920346,17920346,The Sentinel,Michael Douglas|Kiefer Sutherland|Eva Longoria|Martin Donovan|Ritchie Coster,Clark Johnson,108,Action|Thriller|Crime,2006-04-19,112,5.6,2006,64900149,84284035,19383886,6
6734,0.437529,32000000,5914908,-26085092,The Good German,George Clooney|Cate Blanchett|Tobey Maguire|Tony Curran|Leland Orser,Steven Soderbergh,108,War|Crime|Drama|Mystery|Romance,2006-12-08,46,5.8,2006,34613413,6397973,-28215440,6
6735,0.435451,60000000,17800000,-42200000,Flyboys,James Franco|Scott Hazell|Mac McDonald|Philip Winchester|Todd Boyce,Tony Bill,140,Action|Adventure|Drama|History|Romance,2006-09-22,179,6.1,2006,64900149,19253711,-45646438,6
6738,0.433874,15000000,9500000,-5500000,Running Scared,Paul Walker|Cameron Bright|Vera Farmiga|Chazz Palminteri|Karel Roden,Wayne Kramer,122,Action|Crime|Drama|Thriller,2006-01-06,174,6.8,2006,16225037,10275857,-5949180,7
6745,0.405681,25000000,16158487,-8841513,Catch and Release,Jennifer Garner|Timothy Olyphant|Kevin Smith|Sam Jaeger|Juliette Lewis,Susannah Grant,111,Comedy|Drama|Romance,2006-10-20,58,6.0,2006,27041728,17478137,-9563591,6
6746,0.405342,20000000,39143839,19143839,The Grudge 2,Sarah Michelle Gellar|Amber Tamblyn|Edison Chen|Arielle Kebbel|Jennifer Beals,Takashi Shimizu,102,Horror|Thriller,2006-10-13,151,5.3,2006,21633383,42340683,20707300,5
6753,0.384988,8000000,143451,-7856549,10th & Wolf,James Marsden|Brian Dennehy|Leo Rossi|Dennis Hopper|Giovanni Ribisi,Robert Moresco,107,Action|Crime|Drama|Mystery|Thriller,2006-02-19,12,6.0,2006,8653353,155166,-8498187,6
6755,0.3804,45000000,82800000,37800000,Firewall,Harrison Ford|Paul Bettany|Virginia Madsen|Carly Schroeder|Jimmy Bennett,Richard Loncraine,105,Thriller,2006-02-10,145,5.4,2006,48675112,89562206,40887094,5
6756,0.463068,18000000,1196307,-16803693,Seraphim Falls,Liam Neeson|Pierce Brosnan|Michael Wincott|Xander Berkeley|Ed Lauter,David Von Ancken,115,Western|Drama,2006-09-13,65,5.8,2006,19470044,1294008,-18176036,6
6762,0.367893,2000000,622806,-1377194,Sherrybaby,Maggie Gyllenhaal|Michelle Hurst|Sandra RodrÃ­guez|Danny Trejo|Brad William Henke,Laurie Collyer,96,Drama,2006-09-08,14,6.5,2006,2163338,673670,-1489668,6
6763,0.500077,24000000,23321954,-678046,Alatriste,Viggo Mortensen|Elena Anaya|Unax Ugalde|Eduard FernÃ¡ndez|Eduardo Noriega,AgustÃ­n DÃ­az Yanes,145,Action,2006-09-01,31,5.7,2006,25960059,25226638,-733421,6
6764,0.877190999999999,22000000,13405595,-8594405,Tenacious D in The Pick of Destiny,Jack Black|Kyle Gass|Ronnie James Dio|Tim Robbins|Meat Loaf,Liam Lynch,93,Comedy|Music,2006-11-22,206,6.2,2006,23796721,14500418,-9296303,6
6768,0.360145,20000000,41237648,21237648,Man of the Year,Robin Williams|Christopher Walken|Laura Linney|Lewis Black|Jeff Goldblum,Barry Levinson,115,Comedy|Drama|Romance|Thriller,2006-10-09,64,5.4,2006,21633383,44605492,22972109,5
6770,0.357462,20000000,37597471,17597471,The Covenant,Steven Strait|Laura Ramsey|Jessica Lucas|Taylor Kitsch|Chace Crawford,Renny Harlin,97,Action|Adventure|Fantasy|Horror|Science Fiction,2006-09-08,164,5.2,2006,21633383,40668024,19034641,5
6781,0.337268,15000000,66966987,51966987,When a Stranger Calls,Camilla Belle|Katie Cassidy|Tommy Flanagan|Brian Geraghty|Clark Gregg,Simon West,87,Horror|Thriller,2006-02-03,123,5.4,2006,16225037,72436124,56211087,5
6782,0.330582,13000000,1151330,-11848670,Infamous,Sigourney Weaver|Toby Jones|Gwyneth Paltrow|Sandra Bullock|Isabella Rossellini,Douglas McGrath,110,Drama,2006-11-16,24,5.5,2006,14061699,1245358,-12816341,5
6783,0.325485,500000,745327,245327,Another Gay Movie,Michael Carbonaro|Jonah Blechman|Jonathan Chase|Mitch Morris|Ashlie Atkinson,Todd Stephens,92,Comedy|Romance,2006-04-28,28,5.1,2006,540834,806197,265363,5
6786,0.320908,11000000,46396427,35396427,Dhoom 2,Hrithik Roshan|Abhishek Bachchan|Aishwarya Rai Bachchan|Uday Chopra|Bipasha Basu,Sanjay Gadhvi,147,Drama|Action|Thriller|Crime,2006-11-24,43,6.5,2006,11898360,50185584,38287224,6
6787,0.312729,9000000,21510851,12510851,Black Christmas,Katie Cassidy|Michelle Trachtenberg|Kristen Cloke|Mary Elizabeth Winstead|Lacey Chabert,Glen Morgan,84,Horror|Thriller,2006-12-25,44,5.3,2006,9735022,23267624,13532602,5
6788,0.312609,13000000,11130889,-1869111,The Astronaut Farmer,Billy Bob Thornton|Virginia Madsen|Max Thieriot|Jasper Polish|Logan Polish,Michael Polish,104,Adventure|Comedy|Drama|Science Fiction,2006-10-15,49,6.2,2006,14061699,12039939,-2021760,6
6793,0.307279,8000000,426224,-7573776,Fido,Billy Connolly|Carrie-Anne Moss|Dylan Baker|Kesun Loder|Henry Czerny,Andrew Currie,91,Romance|Comedy|Drama|Horror,2006-09-07,61,6.7,2006,8653353,461033,-8192320,7
6795,0.303573999999999,20000000,21170563,1170563,ATL,T.I.|Evan Ross|Jackie Long|Lauren London|Albert Daniels,Christian Robinson,105,Drama,2006-03-31,14,5.3,2006,21633383,22899545,1266162,5
6797,0.300525,4000000,8059140,4059140,Bug,Ashley Judd|Michael Shannon|Harry Connick Jr.|Lynn Collins|BrÃ­an F. O'Byrne,William Friedkin,102,Horror|Thriller,2006-05-19,61,5.6,2006,4326676,8717323,4390647,6
6799,0.298124,75000000,42285169,-32714831,Lady in the Water,Paul Giamatti|Jeffrey Wright|Bob Balaban|Sarita Choudhury|Cindy Cheung,M. Night Shyamalan,110,Drama|Thriller|Fantasy|Mystery,2006-07-21,187,5.2,2006,81125186,45738563,-35386623,5
6807,0.282881,30000000,41480851,11480851,Gridiron Gang,Dwayne Johnson|Xzibit|L. Scott Caldwell|Leon Rippy|Kevin Dunn,Phil Joanou,125,Action|Adventure|Crime|Drama,2006-09-15,123,6.5,2006,32450074,44868557,12418483,6
6821,0.206454,100000,10178331,10078331,Facing the Giants,James Blackwell|Alex Kendrick|Shannen Fields|Chris WIllis|Tracy Goode,Alex Kendrick,111,Drama,2006-09-29,41,6.8,2006,108166,11009586,10901420,7
6832,0.326984,4000000,13401952,9401952,The History Boys,Samuel Anderson|James Corden|Stephen Campbell Moore|Richard Griffiths|Frances de la Tour,Nicholas Hytner,109,Comedy|Drama,2006-10-02,27,5.6,2006,4326676,14496478,10169802,6
6836,0.254596,12000000,20138836,8138836,The Namesake,Kal Penn|Tabu|Irrfan Khan|Sahira Nair|Jacinda Barrett,Mira Nair,122,Drama,2006-09-02,23,7.0,2006,12980029,21783557,8803528,7
6838,0.251388,1000000,46243000,45243000,An Inconvenient Truth,Al Gore|Billy West|Ronald Reagan|George W. Bush|George H. W. Bush,Davis Guggenheim,100,Documentary,2006-01-24,130,6.5,2006,1081669,50019626,48937957,6
6839,0.249949,4000000,4630045,630045,Let's Go to Prison,Dax Shepard|Will Arnett|Chi McBride|David Koechner|Dylan Baker,Bob Odenkirk,84,Comedy|Crime,2006-11-17,36,5.4,2006,4326676,5008176,681500,5
6851,0.225633,2380000,8176544,5796544,This Is England,Thomas Turgoose|Stephen Graham|Jo Hartley|Andrew Shim|Vicky McClure,Shane Meadows,101,Drama|Crime,2006-09-12,187,7.1,2006,2574372,8844315,6269943,7
6857,0.533965999999999,20000000,17807569,-2192431,School for Scoundrels,Billy Bob Thornton|Jon Heder|Jacinda Barrett|Sarah Silverman|Michael Clarke Duncan,Todd Phillips,100,Comedy|Drama|Romance,2006-09-29,53,5.5,2006,21633383,19261898,-2371485,5
6859,0.209369,26000000,17496992,-8503008,Annapolis,James Franco|Donnie Wahlberg|Jim Parrack|Tyrese Gibson|Jordana Brewster,Justin Lin,108,Drama,2006-01-27,56,5.8,2006,28123398,18925956,-9197442,6
6861,0.20754,14500000,22963701,8463701,IndigÃ¨nes,Jamel Debbouze|Samy Naceri|Roschdy Zem|Sami Bouajila|Bernard Blancan,Rachid Bouchareb,128,Drama|History|War,2006-05-25,52,6.7,2006,15684202,24839127,9154925,7
6868,0.200545,15000000,21000000,6000000,Flicka,Tim McGraw|Maria Bello|Armie Hammer|Alison Lohman|Ryan Kwanten,Michael Mayer,95,Drama|Family,2006-10-20,37,6.1,2006,16225037,22715052,6490015,6
6871,0.189838,9000000,27105095,18105095,Stay Alive,Jon Foster|Samaire Armstrong|Frankie Muniz|Jimmi Simpson|Wendell Pierce,William Brent Bell,100,Horror|Thriller,2006-03-24,83,5.3,2006,9735022,29318745,19583723,5
6873,0.188603,15000000,11992014,-3007986,The Return,Adam Scott|Kate Beahan|Sarah Michelle Gellar|Peter O'Brien|Sam Shepard,Asif Kapadia,85,Drama|Thriller,2006-11-10,20,5.2,2006,16225037,12971391,-3253646,5
6875,0.187319,2000000,300000,-1700000,Ten Canoes,Crusoe Kurddal|Jamie Gulpilil|Richard Birrinbirrin|David Gulpilil|Peter Minygululu ,Rolf de Heer|Peter Djigirr,90,Adventure|Comedy|Drama,2006-06-29,12,5.9,2006,2163338,324500,-1838838,6
6883,0.157586,210000000,234360014,24360014,X-Men: The Last Stand,Hugh Jackman|Halle Berry|Ian McKellen|Patrick Stewart|Famke Janssen,Brett Ratner,104,Adventure|Action|Science Fiction|Thriller,2006-05-24,2381,6.2,2006,227150523,253499999,26349476,6
6890,0.145707,1000000,1678874,678874,Who Killed the Electric Car?,Martin Sheen|Mel Gibson|Tom Hanks,Chris Paine,92,Documentary,2006-01-23,25,6.6,2006,1081669,1815986,734317,7
6896,0.133041,8000000,18948425,10948425,Akeelah and the Bee,Keke Palmer|Laurence Fishburne|Angela Bassett|Curtis Armstrong|J.R. Villarreal,Doug Atchison,112,Drama,2006-04-28,46,6.6,2006,8653353,20495926,11842573,7
6914,0.096955,5000000,3833507,-1166493,Trailer Park Boys: The Movie,John Paul Tremblay|Robb Wells|Mike Smith|Patrick Roach|Lucy Decoutere,Mike Clattenburg,95,Action|Comedy,2006-10-06,17,6.3,2006,5408345,4146586,-1261759,6
6922,0.08424,8000000,382267,-7617733,First Snow,Guy Pearce|Piper Perabo|Steven Michael Quezada|J.K. Simmons|Nicholas Ballas,Mark Fergus,101,Drama|Thriller,2006-05-05,15,6.6,2006,8653353,413486,-8239867,7
6925,0.078983,12000000,5542025,-6457975,For Your Consideration,Catherine O'Hara|Harry Shearer|Parker Posey|Christopher Moynihan|John Michael Higgins,Christopher Guest,86,Comedy|Drama,2006-11-22,18,5.4,2006,12980029,5994637,-6985392,5
6945,0.139931,79000,245000,166000,The Foot Fist Way,Danny McBride|Ben Best|Mary Jane Bostic|Jody Hill|Collette Wolfe,Jody Hill,85,Comedy,2006-06-24,19,5.3,2006,85451,265008,179557,5
6948,0.040915,1000000,7202,-992798,Special,Michael Rapaport|Josh Peck|Robert Baker|Jack Kehler|Alexandra Holden,Hal Haberman|Jeremy Passmore,81,Drama|Fantasy|Science Fiction,2006-01-30,13,6.5,2006,1081669,7790,-1073879,6
6962,5.827781,130000000,789804554,659804554,Harry Potter and the Prisoner of Azkaban,Daniel Radcliffe|Rupert Grint|Emma Watson|Gary Oldman|David Thewlis,Alfonso CuarÃ³n,141,Adventure|Fantasy|Family,2004-05-31,3550,7.4,2004,150077901,911786234,761708333,7
6963,4.535598,30000000,152159461,122159461,Kill Bill: Vol. 2,Uma Thurman|David Carradine|Daryl Hannah|Michael Madsen|Gordon Liu Chia-Hui,Quentin Tarantino,136,Action|Crime|Thriller,2004-04-16,2346,7.5,2004,34633361,175659789,141026428,7
6964,3.990488,50000000,40203020,-9796980,Bridget Jones: The Edge of Reason,RenÃ©e Zellweger|Hugh Grant|Colin Firth|Jim Broadbent|Gemma Jones,Beeban Kidron,108,Comedy|Romance,2004-11-10,431,6.0,2004,57722269,46412191,-11310078,6
6965,3.863377,20000000,72258126,52258126,Eternal Sunshine of the Spotless Mind,Jim Carrey|Kate Winslet|Elijah Wood|Mark Ruffalo|Kirsten Dunst,Michel Gondry,108,Science Fiction|Drama|Romance,2004-03-19,2012,7.8,2004,23088907,83418061,60329154,8
6966,3.425628,29000000,115603229,86603229,The Notebook,Rachel McAdams|Ryan Gosling|Gena Rowlands|James Garner|Sam Shepard,Nick Cassavetes,123,Romance|Drama,2004-06-25,1929,7.5,2004,33478916,133457615,99978699,7
6967,3.339406,92000000,631442092,539442092,The Incredibles,Craig T. Nelson|Holly Hunter|Samuel L. Jackson|Jason Lee|Dominique Louis,Brad Bird,115,Action|Adventure|Animation|Family|Science Fiction,2004-11-05,3064,7.2,2004,106208976,728965418,622756442,7
6968,3.196643,75000000,288500217,213500217,The Bourne Supremacy,Matt Damon|Franka Potente|Brian Cox|Julia Stiles|Karl Urban,Paul Greengrass,108,Action|Drama|Thriller,2004-07-23,1966,7.1,2004,86583404,333057748,246474344,7
6969,3.177517,175000000,497409852,322409852,Troy,Brad Pitt|Orlando Bloom|Eric Bana|Brian Cox|Sean Bean,Wolfgang Petersen,163,War|Adventure|Drama,2004-05-13,1598,6.8,2004,202027944,574232515,372204571,7
6970,2.906282,100000000,347451894,247451894,National Treasure,Nicolas Cage|Diane Kruger|Justin Bartha|Sean Bean|Jon Voight,Jon Turteltaub,131,Adventure|Action|Thriller|Mystery,2004-11-19,1179,6.4,2004,115444539,401114240,285669701,6
6971,2.791375,120000000,347234916,227234916,"I, Robot",Will Smith|Bridget Moynahan|Alan Tudyk|James Cromwell|Bruce Greenwood,Alex Proyas,115,Action|Science Fiction,2004-07-15,2339,6.6,2004,138533447,400863751,262330304,7
6972,2.668692,75000000,196482882,121482882,50 First Dates,Adam Sandler|Drew Barrymore|Rob Schneider|Sean Astin|Lusia Strus,Peter Segal,99,Comedy|Romance,2004-02-13,1235,6.5,2004,86583404,226828759,140245355,6
6973,2.629934,17000000,129042871,112042871,Mean Girls,Lindsay Lohan|Rachel McAdams|Tim Meadows|Ana Gasteyer|Amy Poehler,Mark Waters,97,Comedy,2004-04-30,1357,6.8,2004,19625571,148972948,129347377,7
6974,2.499507,160000000,300257475,140257475,Van Helsing,Hugh Jackman|Kate Beckinsale|Richard Roxburgh|David Wenham|Shuler Hensley,Stephen Sommers,132,Horror|Adventure|Action,2004-05-05,918,5.9,2004,184711263,346630860,161919597,6
6975,2.361367,66000000,99318987,33318987,Hellboy,Ron Perlman|Selma Blair|Rupert Evans|John Hurt|Jeffrey Tambor,Guillermo del Toro,122,Fantasy|Action|Science Fiction,2004-04-02,1314,6.4,2004,76193396,114658347,38464951,6
6976,2.241935,165000000,305875730,140875730,The Polar Express,Tom Hanks|Michael Jeter|Eddie Deezen|Chris Coppola|Nona Gaye,Robert Zemeckis,100,Animation|Adventure|Family|Fantasy,2004-11-09,867,6.4,2004,190483490,353116829,162633339,6
6977,2.191033,150000000,919838758,769838758,Shrek 2,Mike Myers|Eddie Murphy|Cameron Diaz|Julie Andrews|Antonio Banderas,Andrew Adamson|Kelly Asbury|Conrad Vernon,93,Adventure|Animation|Comedy|Family|Fantasy,2004-05-19,1676,6.5,2004,173166809,1061903622,888736813,6
6978,2.186534,13000000,96060858,83060858,The Butterfly Effect,Ashton Kutcher|Amy Smart|William Lee Scott|Elden Henson|Melora Walters,Eric Bress|J. Mackye Gruber,113,Science Fiction|Thriller,2004-01-22,1126,7.1,2004,15007790,110897015,95889225,7
6979,2.17643,45000000,129394835,84394835,Resident Evil: Apocalypse,Milla Jovovich|Sienna Guillory|Oded Fehr|Thomas Kretschmann|Sophie Vavasseur,Alexander Witt,94,Horror|Action|Science Fiction,2004-09-10,756,6.1,2004,51950042,149379272,97429230,6
6980,2.175284,110000000,362744280,252744280,Ocean's Twelve,George Clooney|Brad Pitt|Catherine Zeta-Jones|Julia Roberts|Andy GarcÃ­a,Steven Soderbergh,125,Thriller|Crime,2004-12-09,1376,6.4,2004,126988993,418768465,291779472,6
6981,2.041955,80000000,516642939,436642939,Meet the Fockers,Ben Stiller|Teri Polo|Robert De Niro|Dustin Hoffman|Barbra Streisand,Jay Roach,115,Comedy|Romance,2004-12-15,782,6.1,2004,92355631,596436064,504080433,6
6982,2.022895,125000000,544272402,419272402,The Day After Tomorrow,Dennis Quaid|Jake Gyllenhaal|Emmy Rossum|Dash Mihok|Jay O. Sanders,Roland Emmerich,124,Action|Adventure|Science Fiction|Thriller,2004-05-26,1422,6.1,2004,144305674,628332770,484027096,6
6983,1.911206,116000000,102000000,-14000000,The Aviator,Leonardo DiCaprio|Cate Blanchett|Kate Beckinsale|John C. Reilly|Alec Baldwin,Martin Scorsese,170,Drama,2004-12-25,834,6.7,2004,133915666,117753430,-16162236,7
6984,1.83193,65000000,217764291,152764291,Collateral,Tom Cruise|Jamie Foxx|Jada Pinkett Smith|Mark Ruffalo|Peter Berg,Michael Mann,120,Drama|Crime|Thriller,2004-08-04,810,6.7,2004,75038950,251396983,176358033,7
6985,1.823597,4000000,30039392,26039392,Shaun of the Dead,Simon Pegg|Nick Frost|Kate Ashfield|Lucy Davis|Dylan Moran,Edgar Wright,99,Horror|Comedy,2004-04-09,1413,7.4,2004,4617781,34678837,30061056,7
6986,1.792138,65000000,128905366,63905366,Blade: Trinity,Wesley Snipes|Kris Kristofferson|Dominic Purcell|Jessica Biel|Ryan Reynolds,David S. Goyer,123,Science Fiction|Action|Horror|Thriller|Adventure,2004-12-08,800,5.7,2004,75038950,148814206,73775256,6
6988,1.682492,60000000,219417255,159417255,The Terminal,Tom Hanks|Catherine Zeta-Jones|Stanley Tucci|Chi McBride|Diego Luna,Steven Spielberg,128,Comedy|Drama,2004-06-17,1131,7.0,2004,69266723,253305240,184038517,7
6989,1.665648,140000000,209073645,69073645,Lemony Snicket's A Series of Unfortunate Events,Jim Carrey|Meryl Streep|Jude Law|Emily Browning|Liam Aiken,Brad Silberling,108,Adventure|Fantasy|Comedy|Family,2004-12-16,747,6.5,2004,161622355,241364107,79741752,6
6990,1.648554,30000000,216763646,186763646,Million Dollar Baby,Clint Eastwood|Hilary Swank|Morgan Freeman|Jay Baruchel|Mike Colter,Clint Eastwood,132,Drama,2004-12-14,1355,7.6,2004,34633361,250241793,215608432,8
6991,1.648211,50000000,200804534,150804534,Garfield,Bill Murray|Breckin Meyer|Jennifer Love Hewitt|Stephen Tobolowsky|Evan Arnold,Peter Hewitt,80,Animation|Comedy|Family,2004-06-10,435,5.2,2004,57722269,231817870,174095601,5
6993,1.615629,75000000,367275019,292275019,Shark Tale,Will Smith|Robert De Niro|RenÃ©e Zellweger|Jack Black|Angelina Jolie,Bibo Bergeron|Vicky Jenson|Rob Letterman,90,Animation|Action|Comedy|Family,2004-09-20,852,5.8,2004,86583404,423998956,337415552,6
6994,1.590381,70000000,57958696,-12041304,Sky Captain and the World of Tomorrow,Jude Law|Gwyneth Paltrow|Giovanni Ribisi|Angelina Jolie|Bai Ling,Kerry Conran,107,Mystery|Action|Thriller|Science Fiction|Adventure,2004-09-17,249,5.7,2004,80811177,66910149,-13901028,6
6996,1.556897,30000000,140161792,110161792,The SpongeBob SquarePants Movie,Tom Kenny|Clancy Brown|Rodger Bumpass|Bill Fagerbakke|Carolyn Lawrence,Stephen Hillenburg,87,Animation|Comedy|Family,2004-11-14,348,6.6,2004,34633361,161809136,127175775,7
6998,1.539729,6500000,98410061,91910061,Crash,Sandra Bullock|Don Cheadle|Matt Dillon|Michael PeÃ±a|Jennifer Esposito,Paul Haggis,112,Drama,2004-05-28,675,7.1,2004,7503895,113609042,106105147,7
6999,1.527154,26000000,90574188,64574188,Anchorman: The Legend of Ron Burgundy,Will Ferrell|Christina Applegate|Paul Rudd|David Koechner|Steve Carell,Adam McKay,94,Comedy,2004-07-09,1002,6.7,2004,30015580,104562954,74547374,7
7000,1.497252,37000000,96455697,59455697,13 Going On 30,Jennifer Garner|Mark Ruffalo|Judy Greer|Andy Serkis|Kathy Baker,Gary Winick,98,Comedy|Fantasy|Romance,2004-04-13,662,6.1,2004,42714479,111352835,68638356,6
7001,1.473411,31000000,27388767,-3611233,Ella Enchanted,Anne Hathaway|Hugh Dancy|Cary Elwes|Aidan McArdle|Joanna Lumley,Tommy O'Haver,96,Fantasy|Comedy|Family|Romance,2004-04-09,238,5.7,2004,35787807,31618836,-4168971,6
7002,1.441361,25000000,30411183,5411183,The Girl Next Door,Emile Hirsch|Elisha Cuthbert|Timothy Olyphant|James Remar|Chris Marquette,Luke Greenfield,108,Comedy,2004-04-09,484,6.2,2004,28861134,35108050,6246916,6
7004,1.428313,25000000,116766556,91766556,Finding Neverland,Johnny Depp|Kate Winslet|Julie Christie|Dustin Hoffman|Freddie Highmore,Marc Forster,106,Drama,2004-10-17,695,7.1,2004,28861134,134800613,105939479,7
7005,1.408588,19000000,70067909,51067909,A Cinderella Story,Hilary Duff|Jennifer Coolidge|Chad Michael Murray|Dan Byrd|Regina King,Mark Rosman,95,Comedy,2004-07-10,379,5.9,2004,21934462,80889575,58955113,6
7006,1.348704,70000000,171183863,101183863,AVP: Alien vs. Predator,Sanaa Lathan|Raoul Bova|Ewen Bremner|Colin Salmon|Tommy Flanagan,Paul W.S. Anderson,101,Adventure|Science Fiction|Action,2004-08-12,696,5.5,2004,80811177,197622423,116811246,5
7007,1.338131,20000000,167722310,147722310,DodgeBall: A True Underdog Story,Vince Vaughn|Christine Taylor|Ben Stiller|Rip Torn|Justin Long,Rawson Marshall Thurber,92,Comedy,2004-06-18,551,6.2,2004,23088907,193626249,170537342,6
7008,1.327137,12000000,9584131,-2415869,Banlieue 13,David Belle|Cyril Raffaelli|Tony D'Amario|Dany Verissimo-Petit|Bibi Naceri,Pierre Morel,84,Action|Thriller|Science Fiction,2004-11-09,351,6.5,2004,13853344,11064355,-2788989,6
7009,1.319068,155000000,167298192,12298192,Alexander,Colin Farrell|Angelina Jolie|Val Kilmer|Jared Leto|Jonathan Rhys Meyers,Oliver Stone,175,War|History|Action|Adventure|Drama,2004-11-21,519,5.6,2004,178939036,193136628,14197592,6
7010,1.318761,9000000,23936908,14936908,Harold & Kumar Go to White Castle,John Cho|Kal Penn|Paula GarcÃ©s|Neil Patrick Harris|David Krumholtz,Danny Leiner,88,Comedy|Adventure,2004-05-30,414,6.4,2004,10390008,27633853,17243845,6
7011,1.309753,1200000,103911669,102711669,Saw,Cary Elwes|Danny Glover|Monica Potter|Michael Emerson|Ken Leung,James Wan,103,Horror|Mystery|Crime,2004-10-01,1135,7.1,2004,1385334,119960348,118575014,7
7012,1.304553,200000000,783766341,583766341,Spider-Man 2,Tobey Maguire|Kirsten Dunst|James Franco|Alfred Molina|Rosemary Harris,Sam Raimi,127,Action|Adventure|Fantasy,2004-06-25,2735,6.4,2004,230889079,904815446,673926367,6
7013,1.279087,25000000,20796847,-4203153,EuroTrip,Scott Mechlowicz|Jacob Pitts|Michelle Trachtenberg|Travis Wester|Vinnie Jones,Jeff Schaffer,93,Comedy,2004-02-20,376,6.4,2004,28861134,24008824,-4852310,6
7014,1.277711,70000000,130293714,60293714,Man on Fire,Denzel Washington|Dakota Fanning|Marc Anthony|Radha Mitchell|Christopher Walken,Tony Scott,146,Action|Drama|Thriller|Crime,2004-04-23,1002,7.3,2004,80811177,150416978,69605801,7
7015,1.23067,42000000,171963386,129963386,Along Came Polly,Ben Stiller|Jennifer Aniston|Philip Seymour Hoffman|Debra Messing|Alec Baldwin,John Hamburg,90,Comedy|Romance,2004-01-16,440,5.7,2004,48486706,198522339,150035633,6
7016,1.208837,27000000,115505027,88505027,Closer,Natalie Portman|Jude Law|Julia Roberts|Clive Owen|Colin Stinton,Mike Nichols,104,Drama|Romance,2004-12-01,427,6.6,2004,31170025,133344247,102174222,7
7017,1.131654,33000000,54700105,21700105,The Punisher,Thomas Jane|John Travolta|Will Patton|Roy Scheider|Laura Harring,Jonathan Hensleigh,124,Action|Crime|Drama,2004-04-15,402,6.0,2004,38096698,63148284,25051586,6
7018,1.129322,100000000,82102379,-17897621,Catwoman,Halle Berry|Benjamin Bratt|Sharon Stone|Lambert Wilson|Frances Conroy,Pitof,104,Action|Crime,2004-07-22,415,4.3,2004,115444539,94782713,-20661826,4
7020,1.1173,1000000,332323,-667677,9 Songs,Kieran O'Brien|Margo Stilley|The Dandy Warhols|Elbow|Franz Ferdinand,Michael Winterbottom,66,Drama|Music|Romance,2004-07-16,53,5.2,2004,1154445,383648,-770797,5
7021,1.107167,28000000,102356381,74356381,Dawn of the Dead,Sarah Polley|Ving Rhames|Jake Weber|Mekhi Phifer|Ty Burrell,Zack Snyder,101,Fantasy|Horror|Action,2004-03-19,546,6.7,2004,32324471,118164853,85840382,7
7023,1.06218,120000000,203567857,83567857,King Arthur,Clive Owen|Ioan Gruffudd|Keira Knightley|Mads Mikkelsen|Joel Edgerton,Antoine Fuqua,126,Adventure|War|History,2004-07-07,449,6.1,2004,138533447,235007976,96474529,6
7024,1.052176,105000000,115772733,10772733,The Chronicles of Riddick,Vin Diesel|Christina Cox|Colm Feore|Karl Urban|Judi Dench,David Twohy,119,Adventure|Action|Thriller|Science Fiction,2004-06-11,1118,6.2,2004,121216766,133653299,12436533,6
7025,1.042281,80000000,55041367,-24958633,Spanglish,Adam Sandler|TÃ©a Leoni|Paz Vega|Cloris Leachman|Shelbie Bruce,James L. Brooks,130,Comedy,2004-12-17,215,5.6,2004,92355631,63542252,-28813379,6
7026,1.03943,40000000,92913171,52913171,Secret Window,Johnny Depp|John Turturro|Timothy Hutton|Charles S. Dutton|Len Cariou,David Koepp,96,Thriller|Mystery,2004-03-12,513,6.3,2004,46177815,107263182,61085367,6
7027,1.035728,6500000,11850214,5350214,Layer Cake,Daniel Craig|Colm Meaney|George Harris|Sally Hawkins|Kenneth Cranham,Matthew Vaughn,105,Drama|Thriller|Crime,2004-09-30,308,7.0,2004,7503895,13680425,6176530,7
7028,0.986444,60000000,61347797,1347797,After the Sunset,Pierce Brosnan|Salma Hayek|Woody Harrelson|Troy Garity|Russell Hornsby,Brett Ratner,97,Action|Comedy|Crime|Drama,2004-11-12,139,6.0,2004,69266723,70822682,1555959,6
7029,0.976399,57000000,28283637,-28716363,Thunderbirds,Brady Corbet|Soren Fulton|Debora Weston|Lou Hirsch|Alex Barringer,Jonathan Frakes,95,Action|Adventure|Comedy|Family|Fantasy,2004-07-23,50,4.4,2004,65803387,32651914,-33151473,4
7030,0.961847,40000000,95149435,55149435,The Princess Diaries 2: Royal Engagement,Anne Hathaway|Julie Andrews|HÃ©ctor Elizondo|John Rhys-Davies|Heather Matarazzo,Garry Marshall,113,Comedy|Drama|Family|Romance,2004-08-06,386,5.9,2004,46177815,109844827,63667012,6
7031,0.94856,145000000,25819961,-119180039,The Alamo,Dennis Quaid|Billy Bob Thornton|Jason Patric|Patrick Wilson|Emilio EchevarrÃ­a,John Lee Hancock,137,Western|History|War,2004-04-07,60,5.9,2004,167394582,29807735,-137586847,6
7032,0.939705,2700000,15992615,13292615,Before Sunset,Ethan Hawke|Julie Delpy|Vernon Dobtcheff|Louise Lemoine TorrÃ¨s|Mariane Plasteig,Richard Linklater,80,Drama|Romance,2004-02-10,418,7.5,2004,3117002,18462600,15345598,7
7033,0.935831,10000000,183474602,173474602,The Grudge,Sarah Michelle Gellar|Jason Behr|William Mapother|Clea DuVall|KaDee Strickland,Takashi Shimizu,92,Horror|Thriller|Mystery,2004-10-22,462,5.8,2004,11544453,211811410,200266957,6
7034,0.935483,25000000,56422687,31422687,Cellular,Chris Evans|Kim Basinger|Jason Statham|Jessica Biel|William H. Macy,David R. Ellis,94,Action|Adventure|Crime|Thriller,2004-09-06,322,6.0,2004,28861134,65136911,36275777,6
7035,0.927088,80000000,96105964,16105964,The Manchurian Candidate,Denzel Washington|Meryl Streep|Liev Schreiber|Jon Voight|Kimberly Elise,Jonathan Demme,129,Drama|Thriller|Mystery,2004-07-30,181,6.1,2004,92355631,110949088,18593457,6
7036,0.925121,5000000,8203235,3203235,The Machinist,Christian Bale|Jennifer Jason Leigh|Aitana SÃ¡nchez-GijÃ³n|John Sharian|Michael Ironside,Brad Anderson,101,Thriller|Drama,2004-02-09,621,7.2,2004,5772226,9470186,3697960,7
7037,0.924363,12000000,24829644,12829644,Seed of Chucky,Brad Dourif|Jennifer Tilly|Billy Boyd|Redman|Hannah Spearritt,Don Mancini,87,Comedy|Drama|Horror,2004-11-11,140,4.9,2004,13853344,28664468,14811124,5
7038,0.922087,25000000,36609966,11609966,Taxi,Queen Latifah|Jimmy Fallon|Gisele BÃ¼ndchen|Henry Simmons|Jennifer Esposito,Tim Story,97,Thriller|Action|Comedy|Crime,2004-10-06,135,5.0,2004,28861134,42264206,13403072,5
7039,0.898601,60000000,13395939,-46604061,Alfie,Jude Law|Marisa Tomei|Omar Epps|Jane Krakowski|RenÃ©e Taylor,Charles Shyer,103,Comedy,2004-10-22,140,5.4,2004,69266723,15464880,-53801843,5
7041,0.87766,50000000,170128460,120128460,Shall We Dance?,Richard Gere|Jennifer Lopez|Susan Sarandon|Lisa Ann Walter|Stanley Tucci,Peter Chelsom,107,Drama|Romance|Comedy,2004-10-15,172,5.8,2004,57722269,196404018,138681749,6
7042,0.874937999999999,35000000,36098382,1098382,Jersey Girl,Ben Affleck|Raquel Castro|Liv Tyler|Jennifer Lopez|George Carlin,Kevin Smith,102,Comedy|Romance,2004-03-25,176,5.7,2004,40405588,41673611,1268023,6
7043,0.8676,90000000,102000000,12000000,The Stepford Wives,Nicole Kidman|Matthew Broderick|Bette Midler|Glenn Close|Christopher Walken,Frank Oz,93,Action|Comedy|Science Fiction,2004-06-10,183,5.4,2004,103900085,117753430,13853345,5
7044,0.856329,7000,424760,417760,Primer,Shane Carruth|David Sullivan|Casey Gooden|Anand Upadhyaya|Carrie Crawford,Shane Carruth,79,Science Fiction|Drama|Thriller,2004-10-08,341,6.9,2004,8081,490362,482281,7
7045,0.845493,10000000,1461989,-8538011,ã‚¢ãƒƒãƒ—ãƒ«ã‚·ãƒ¼ãƒ‰,Ai Kobayashi|JÅ«rÅta Kosugi|Yuki Matsuoka|Asumi Miwa|Mami Koyama,Shinji Aramaki,101,Animation|Action|Science Fiction,2004-04-17,77,6.7,2004,11544453,1687786,-9856667,7
7046,0.837905999999999,110000000,103951461,-6048539,Home on the Range,Randy Quaid|Steve Buscemi|Judi Dench|Cuba Gooding Jr.|G. W. Bailey,Will Finn|John Sanford,76,Western|Animation|Family|Comedy|Music,2004-04-02,210,5.8,2004,126988993,120006285,-6982708,6
7047,0.815044,100000000,108103450,8103450,Hidalgo,Viggo Mortensen|Zuleikha Robinson|Omar Sharif|Adam Alexi-Malle|Louise Lombard,Joe Johnston,136,Western|Adventure,2004-03-05,177,6.3,2004,115444539,124799530,9354991,6
7049,0.80542,6000000,119114517,113114517,Fahrenheit 9/11,Michael Moore|George W. Bush|Ben Affleck|Stevie Wonder|Al Gore,Michael Moore,122,Documentary,2004-06-25,198,6.6,2004,6926672,137511206,130584534,7
7050,0.804481,17000000,16980098,-19902,Win a Date with Tad Hamilton!,Josh Duhamel|Kate Bosworth|Topher Grace|Nathan Lane|Sean Hayes,Robert Luketic,95,Comedy|Romance,2004-01-23,78,5.3,2004,19625571,19602596,-22975,5
7051,0.802577,37000000,113086475,76086475,White Chicks,Shawn Wayans|Marlon Wayans|Jaime King|Frankie Faison|Maitland Ward,Keenen Ivory Wayans,109,Comedy,2004-06-23,370,6.4,2004,42714479,130552160,87837681,6
7052,0.787185,17500000,38000000,20500000,Hotel Rwanda,Don Cheadle|Sophie Okonedo|Nick Nolte|Fana Mokoena|Joaquin Phoenix,Terry George,121,Drama|History|War,2004-09-11,456,7.2,2004,20202794,43868925,23666131,7
7054,0.779837,56000000,57223890,1223890,Walking Tall,Dwayne Johnson|Johnny Knoxville|Neal McDonough|Kristen Wilson|Cobie Smulders,Kevin Bray,86,Adventure|Drama|Action|Thriller,2004-04-02,236,6.0,2004,64648942,66061856,1412914,6
7055,0.767869999999999,50000000,25195000,-24805000,Twisted,Ashley Judd|Samuel L. Jackson|Andy GarcÃ­a|David Strathairn|Russell Wong,Philip Kaufman,97,Action|Adventure|Crime|Drama|Thriller,2004-02-27,67,5.7,2004,57722269,29086251,-28636018,6
7057,0.762134,130000,54667954,54537954,Open Water,Blanchard Ryan|Daniel Travis|Saul Stein|Michael E. Williamson|Christina Zenato,Chris Kentis,79,Drama|Thriller,2004-08-06,171,5.3,2004,150077,63111168,62961091,5
7059,0.73712,32000000,50907422,18907422,Team America: World Police,Trey Parker|Matt Stone|Kristen Miller|Masasa Moyo|Daran Norris,Trey Parker,98,Music|Adventure|Animation|Action|Comedy,2004-10-11,391,6.5,2004,36942252,58769839,21827587,6
7065,0.702631999999999,16000000,109502303,93502303,Sideways,Paul Giamatti|Thomas Haden Church|Virginia Madsen|Sandra Oh|Marylouise Burke,Alexander Payne,126,Comedy|Drama|Romance,2004-10-22,238,6.6,2004,18471126,126414429,107943303,7
7066,0.696312,19000000,69631118,50631118,Without a Paddle,Seth Green|Matthew Lillard|Dax Shepard|Antony Starr|Andrew Hampton,Steven Brill,95,Action|Adventure|Comedy|Thriller,2004-08-20,109,5.2,2004,21934462,80385323,58450861,5
7068,0.679997,60000000,170268750,110268750,Starsky & Hutch,Ben Stiller|Owen Wilson|Snoop Dogg|Fred Williamson|Vince Vaughn,Todd Phillips,101,Comedy|Crime,2004-03-05,368,5.5,2004,69266723,196565975,127299252,5
7070,0.678708,15000000,29331068,14331068,Confessions of a Teenage Drama Queen,Lindsay Lohan|Adam Garcia|Glenne Headly|Alison Pill|Megan Fox,Sara Sugarman,89,Music|Comedy|Family|Romance,2004-02-17,134,5.1,2004,17316680,33861116,16544436,5
7071,0.677316,60000000,256697520,196697520,The Village,Bryce Dallas Howard|Joaquin Phoenix|Adrien Brody|William Hurt|Sigourney Weaver,M. Night Shyamalan,108,Drama|Mystery|Thriller,2004-07-30,514,6.0,2004,69266723,296343271,227076548,6
7072,0.674089,40000000,26155781,-13844219,The Whole Ten Yards,Bruce Willis|Matthew Perry|Amanda Peet|Kevin Pollak|Frank Collison,Howard Deutch,98,Comedy|Thriller|Crime,2004-04-07,161,5.5,2004,46177815,30195421,-15982394,5
7073,0.672946,30000000,611899420,581899420,The Passion of the Christ,Jim Caviezel|Maia Morgenstern|Christo Jivkov|Francesco De Vito|Monica Bellucci,Mel Gibson,127,Drama,2004-02-25,457,6.8,2004,34633361,706404470,671771109,7
7074,0.652366,20000000,70992898,50992898,Anacondas: The Hunt for the Blood Orchid,Johnny Messner|KaDee Strickland|Matthew Marsden|Nicholas Gonzalez|Eugene Byrd,Dwight H. Little,97,Adventure|Action|Horror|Science Fiction|Thriller,2004-08-26,109,5.0,2004,23088907,81957424,58868517,5
7075,0.648721,40000000,124731534,84731534,Ray,Jamie Foxx|Kerry Washington|Regina King|Harry Lennix|Clifton Powell,Taylor Hackford,152,Drama,2004-10-29,246,7.0,2004,46177815,143995745,97817930,7
7076,0.640232,25000000,27685016,2685016,Dirty Dancing: Havana Nights,Diego Luna|Romola Garai|Sela Ward|John Slattery|Jonathan Jackson,Guy Ferland,86,Drama|Romance,2004-02-27,76,5.8,2004,28861134,31960839,3099705,6
7080,0.614247999999999,31000000,41512007,10512007,Wimbledon,Kirsten Dunst|Paul Bettany|Sam Neill|James McAvoy|Bernard Hill,Richard Loncraine,98,Comedy|Romance,2004-09-13,168,5.7,2004,35787807,47923345,12135538,6
7081,0.611839999999999,45000000,65470529,20470529,Taking Lives,Angelina Jolie|Ethan Hawke|Kiefer Sutherland|Gena Rowlands|Olivier Martinez,D.J. Caruso,103,Action|Drama|Mystery|Thriller,2004-03-19,181,6.0,2004,51950042,75582151,23632109,6
7084,0.589983,70000000,154648887,84648887,The Phantom of the Opera,Gerard Butler|Emmy Rossum|Patrick Wilson|Miranda Richardson|Minnie Driver,Joel Schumacher,143,Thriller|Drama|Romance,2004-12-08,280,6.8,2004,80811177,178533696,97722519,7
7086,0.586936,2500000,26781723,24281723,Garden State,Zach Braff|Natalie Portman|Ian Holm|Peter Sarsgaard|Kenneth Graymez,Zach Braff,102,Comedy|Drama|Romance,2004-01-16,342,7.1,2004,2886113,30918036,28031923,7
7087,0.577759,400000,46118097,45718097,Napoleon Dynamite,Jon Heder|Aaron Ruell|Jon Gries|Efren Ramirez|Shondrella Avery,Jared Hess,95,Comedy,2004-06-11,290,6.6,2004,461778,53240824,52779046,7
7089,0.572018999999999,80000000,78000586,-1999414,Exorcist: The Beginning,Stellan SkarsgÃ¥rd|Izabella Scorupco|James D'Arcy|Julian Wadham|Remy Sweeney,Renny Harlin,114,Horror|Mystery|Thriller,2004-08-20,79,4.6,2004,92355631,90047417,-2308214,5
7091,0.545686,30000000,13001257,-16998743,Wicker Park,Josh Hartnett|Rose Byrne|Matthew Lillard|Diane Kruger|Christopher Cousins,Paul McGuigan,114,Drama|Mystery|Romance|Thriller,2004-09-03,83,6.6,2004,34633361,15009241,-19624120,7
7093,0.530799,50000000,34808403,-15191597,The Life Aquatic with Steve Zissou,Bill Murray|Anjelica Huston|Cate Blanchett|Willem Dafoe|Owen Wilson,Wes Anderson,119,Adventure|Comedy|Drama,2004-12-10,433,7.0,2004,57722269,40184400,-17537869,7
7094,0.521121,110000000,72178895,-37821105,Around the World in 80 Days,Jackie Chan|Steve Coogan|CÃ©cile De France|Robert Fyfe|Jim Broadbent,Frank Coraci,120,Action|Adventure|Comedy,2004-06-16,380,5.6,2004,126988993,83326593,-43662400,6
7095,0.520891,18000000,65070412,47070412,Barbershop 2:  Back in Business,Ice Cube|Cedric the Entertainer|Sean Patrick Thomas|Keke Palmer|Michael Ealy,Kevin Rodney Sullivan,106,Comedy|Drama,2004-01-20,35,5.7,2004,20780017,75120237,54340220,6
7102,0.49851,42000000,117575636,75575636,The Forgotten,Julianne Moore|Anthony Edwards|Jessica Hecht|Christopher Kovaleski|Dominic West,Joseph Ruben,91,Crime|Drama|Horror|Mystery|Science Fiction,2004-09-24,180,5.4,2004,48486706,135734652,87247946,5
7103,0.494197,45000000,14793624,-30206376,Surviving Christmas,Ben Affleck|James Gandolfini|Christina Applegate|Catherine O'Hara|Josh Zuckerman,Mike Mitchell,91,Comedy|Romance,2004-09-21,48,5.0,2004,51950042,17078431,-34871611,5
7114,0.439848,45000000,21009180,-23990820,Flight of the Phoenix,Dennis Quaid|Tyrese Gibson|Giovanni Ribisi|Miranda Otto|Hugh Laurie,John Moore,113,Action|Adventure|Drama|Thriller,2004-12-17,149,5.4,2004,51950042,24253951,-27696091,5
7116,0.433748,25000000,30114487,5114487,Godsend,Greg Kinnear|Rebecca Romijn|Robert De Niro|Cameron Bright|Zoie Palmer,Nick Hamm,102,Drama|Horror|Science Fiction|Thriller,2004-04-30,60,4.7,2004,28861134,34765530,5904396,5
7118,0.429419,2000000,120620,-1879380,It's All Gone Pete Tong,Paul Kaye|Kate Magowan|Neil Maskell|Beatriz Batarda|Pete Tong,Michael Dowse,90,Drama|Comedy|Music,2004-09-12,19,6.8,2004,2308890,139249,-2169641,7
7119,0.429157,30000000,61255921,31255921,Friday Night Lights,Billy Bob Thornton|Lucas Black|Garrett Hedlund|Derek Luke|Amber Heard,Peter Berg,118,Drama,2004-10-08,87,7.2,2004,34633361,70716616,36083255,7
7122,0.424376,50000000,49718611,-281389,Raising Helen,Kate Hudson|John Corbett|Joan Cusack|Hayden Panettiere|Spencer Breslin,Garry Marshall,119,Drama|Comedy|Romance,2004-05-27,111,5.9,2004,57722269,57397421,-324848,6
7125,0.422767,8000000,365134,-7634866,She Hate Me,Anthony Mackie|Kerry Washington|Ellen Barkin|Jim Brown|Jamel Debbouze,Spike Lee,138,Comedy|Drama,2004-07-30,13,5.2,2004,9235563,421527,-8814036,5
7126,0.41942,20000000,16605763,-3394237,Paparazzi,Cole Hauser|Robin Tunney|Dennis Farina|Daniel Baldwin,Paul Abascal,84,Action|Drama|Thriller,2004-09-03,28,5.9,2004,23088907,19170446,-3918461,6
7129,0.405459,15000000,14867514,-132486,Raise Your Voice,Hilary Duff|Oliver James|David Keith|Johnny Lewis|Rita Wilson,Sean McNamara,103,Music|Drama|Romance,2004-08-10,110,5.9,2004,17316680,17163733,-152947,6
7132,0.383044,23000000,16123851,-6876149,Vanity Fair,Reese Witherspoon|James Purefoy|Jonathan Rhys Meyers|Romola Garai|Gabriel Byrne,Mira Nair,141,Drama|Romance,2004-09-01,36,5.5,2004,26552244,18614105,-7938139,5
7135,0.372046,74500000,62172050,-12327950,Deux frÃ¨res,MaÃ¯ Anh Le|Guy Pearce|Oanh Nguyen|Jaran 'See Tao' Petcharoen|StÃ©phanie Lagarde,Jean-Jacques Annaud,109,Adventure|Drama|Family,2004-04-07,106,6.8,2004,86006182,71774237,-14231945,7
7142,0.344278,40000000,46546197,6546197,Torque,Martin Henderson|Ice Cube|Monet Mazur|Adam Scott|Matt Schulze,Joseph Kahn,84,Action,2004-01-16,69,4.8,2004,46177815,53735043,7557228,5
7143,0.751446,28000000,64445708,36445708,Miracle,Kurt Russell|Patricia Clarkson|Noah Emmerich|Sean McCann|Kenneth Welsh,Gavin O'Connor,135,Drama|History,2004-02-06,81,6.8,2004,32324471,74399051,42074580,7
7145,0.333555,27000000,21148829,-5851171,Mindhunters,"LL Cool J|Jonny Lee Miller|Kathryn Morris|Patricia VelÃ¡squez|Clifton Collins, Jr.",Renny Harlin,106,Mystery|Thriller|Crime,2004-05-07,173,6.3,2004,31170025,24415168,-6754857,6
7152,0.322152,16000000,14822346,-1177654,Soul Plane,Tom Arnold|Kevin Hart|Method Man|Snoop Dogg|K. D. Aubert,Jessy Terrero,86,Comedy,2004-05-28,66,4.8,2004,18471126,17111589,-1359537,5
7155,0.313479,8500000,5001655,-3498345,Club Dread,Kevin Heffernan|Jay Chandrasekhar|Paul Soter|Erik Stolhanske|Tanja Reichert,Jay Chandrasekhar,104,Comedy|Horror,2004-02-27,48,5.1,2004,9812785,5774137,-4038648,5
7158,0.420568,23000000,12,-22999988,Chasing Liberty,Mandy Moore|Stark Sands|Tony Jayawardena|Jeremy Piven|Annabella Sciorra,Andy Cadiff,111,Comedy|Romance,2004-01-09,86,6.2,2004,26552244,13,-26552231,6
7159,0.308525,27000000,13000000,-14000000,Suspect Zero,Carrie-Anne Moss|Aaron Eckhart|Ben Kingsley|Harry Lennix|Kevin Chamberlin,E. Elias Merhige,99,Crime|Thriller,2004-08-27,42,5.1,2004,31170025,15007790,-16162235,5
7161,0.302104,50000000,6808550,-43191450,The Big Bounce,Owen Wilson|Morgan Freeman|Gary Sinise|Sara Foster|Willie Nelson,George Armitage,88,Comedy|Crime,2004-01-30,40,4.9,2004,57722269,7860099,-49862170,5
7166,0.286541,74050,176153,102103,The Heart is Deceitful Above All Things,Asia Argento|Jimmy Bennett|Jeremy Renner|Winona Ryder|Ornella Muti,Asia Argento,98,Drama,2004-09-15,16,5.6,2004,85486,203359,117873,6
7167,0.286442,30000000,21800302,-8199698,Mr. 3000,Bernie Mac|Angela Bassett|Michael Rispoli|Brian J. White|Dondre Whitfield,Charles Stone III,104,Comedy|Drama,2004-06-15,33,5.1,2004,34633361,25167258,-9466103,5
7169,0.283606,20000000,11341016,-8658984,Connie and Carla,Nia Vardalos|Toni Collette|David Duchovny|Stephen Spinella|Alec Mapa,Michael Lembeck,98,Comedy,2004-04-16,16,6.8,2004,23088907,13092583,-9996324,7
7172,0.280074,19250000,8112712,-11137288,Spartan,Val Kilmer|Derek Luke|William H. Macy|Tia Texada|Ed O'Neill,David Mamet,102,Mystery|Action|Drama|Thriller|Crime,2004-03-12,44,6.2,2004,22223073,9365683,-12857390,6
7173,0.275919,26000000,28818995,2818995,Agent Cody Banks 2: Destination London,Frankie Muniz|Anthony Anderson|Hannah Spearritt|Alfie Allen|Cynthia Stevenson,Kevin Allen,100,Comedy,2004-12-03,80,5.3,2004,30015580,33269956,3254376,5
7174,0.269855,12000000,31179516,19179516,Johnson Family Vacation,Cedric the Entertainer|Vanessa Williams|Steve Harvey|Shari Headley|Shad Moss,Christopher Erskin,97,Comedy|Family,2004-04-07,16,5.3,2004,13853344,35995048,22141704,5
7178,0.263897,65000,28575078,28510078,Super Size Me,Morgan Spurlock|Daryl Isaacs|Lisa Ganjhu|Stephen Siegel|Bridget Bennett,Morgan Spurlock,100,Documentary|Comedy|Drama,2004-01-17,295,6.5,2004,75038,32988367,32913329,6
7179,0.369726,6500000,1548955,-4951045,A Home at the End of the World,Colin Farrell|Dallas Roberts|Robin Wright|Sissy Spacek|Ryan Donowho,Michael Mayer,96,Romance|Drama,2004-07-23,20,6.4,2004,7503895,1788183,-5715712,6
7180,0.252151,35000000,22034832,-12965168,Little Black Book,Brittany Murphy|Holly Hunter|Kathy Bates|Ron Livingston|Kevin Sussman,Nick Hurran,111,Comedy|Romance|Drama,2004-08-06,57,5.2,2004,40405588,25438010,-14967578,5
7183,0.250878,39000000,6614280,-32385720,Against the Ropes,Meg Ryan|Tony Shalhoub|Joe Cortese|Kerry Washington|Omar Epps,Charles S. Dutton,106,Romance|Drama,2004-02-20,16,4.8,2004,45023370,7635825,-37387545,5
7192,0.225831,15000000,1914166,-13085834,A Dirty Shame,Tracey Ullman|Johnny Knoxville|Selma Blair|Chris Isaak|Suzanne Shepherd,John Waters,89,Comedy,2004-09-12,27,5.5,2004,17316680,2209800,-15106880,5
7197,0.216459,60000000,74541707,14541707,Ladder 49,Joaquin Phoenix|John Travolta|Jacinda Barrett|Robert Patrick|Morris Chestnut,Jay Russell,115,Drama|Action|Thriller,2004-10-01,112,6.0,2004,69266723,86054330,16787607,6
7205,0.274886,18000000,16702864,-1297136,Catch That Kid,Kristen Stewart|Corbin Bleu|Max Thieriot|Jennifer Beals|Sam Robards,James Sbardellati|Peter Merwin|Bart Freundlich,92,Family|Action|Adventure,2004-02-06,45,5.2,2004,20780017,19282544,-1497473,5
7206,0.137751,2600000,1479042,-1120958,Il cartaio,Stefania Rocca|Liam Cunningham|Silvio Muccino|Cosimo Fusco|Fiore Argento,Dario Argento,103,Horror,2004-01-02,19,4.9,2004,3001558,1707473,-1294085,5
7221,0.156769,2600000,3166000,566000,Riding Giants,Jeff Clark|Darrick Doerner|Laird Hamilton|Dave Kalama|David H. Kalama Jr.,Stacy Peralta,105,Documentary,2004-07-09,13,6.9,2004,3001558,3654974,653416,7
7225,0.154421,500000,603943,103943,Mean Creek,Rory Culkin|Scott Mechlowicz|Trevor Morgan|Josh Peck|Ryan Kelley,Jacob Aaron Estes,90,Crime|Drama,2004-01-15,33,7.3,2004,577222,697219,119997,7
7228,0.145065,3000000,2037545,-962455,We Don't Live Here Anymore,Mark Ruffalo|Laura Dern|Peter Krause|Naomi Watts|Sam Charles,John Curran,101,Drama|Romance,2004-01-20,14,6.4,2004,3463336,2352234,-1111102,6
7234,0.135381,30000000,14000000,-16000000,Welcome to Mooseport,Ray Romano|Gene Hackman|Marcia Gay Harden|Maura Tierney|June Squibb,Donald Petrie,110,Comedy,2004-02-24,26,4.8,2004,34633361,16162235,-18471126,5
7244,0.109123,3000000,5923000,2923000,Never Die Alone,DMX|Michael Ealy|Drew Sidora|David Arquette|Antwon Tanner,Ernest R. Dickerson,88,Action|Adventure|Crime|Drama|Thriller,2004-03-26,19,6.1,2004,3463336,6837780,3374444,6
7250,0.082116,823258,823258,0,Narco,Guillaume Canet|Zabou Breitman|Guillaume Gallienne|FranÃ§ois BerlÃ©and|Jean-Pierre Cassel,Tristan Aurouet|Gilles Lellouche,105,Comedy,2004-12-01,26,5.8,2004,950406,950406,0,6
7268,0.001117,350000,3515061,3165061,Born into Brothels,Zana Briski|Avijit|Geeta Masi|Kochi|Mamuni,Zana Briski|Ross Kauffman,85,Documentary,2004-12-08,23,6.4,2004,404055,4057946,3653891,6
7269,5.738034,6000000,245066411,239066411,The Godfather,Marlon Brando|Al Pacino|James Caan|Richard S. Castellano|Robert Duvall,Francis Ford Coppola,175,Drama|Crime,1972-03-15,3970,8.3,1972,31287365,1277913732,1246626367,8
7270,0.949381,2000000,46122355,44122355,Deliverance,Jon Voight|Burt Reynolds|Ned Beatty|Ronny Cox|Ed Ramey,John Boorman,109,Drama|Adventure|Thriller,1972-07-30,209,7.0,1972,10429121,240507830,230078709,7
7271,0.881814,1800000,9700000,7900000,Conquest of the Planet of the Apes,Roddy McDowall|Don Murray|Joyce Haber|Ricardo Montalban|Natalie Trundy,J. Lee Thompson,88,Action|Science Fiction,1972-06-29,109,6.1,1972,9386209,50581241,41195032,6
7273,0.599109,3500000,12600000,9100000,Frenzy,Jon Finch|Alec McCowen|Barry Foster|Billie Whitelaw|Anna Massey,Alfred Hitchcock,116,Crime|Drama|Mystery|Thriller,1972-05-25,58,6.9,1972,18250963,65703467,47452504,7
7277,0.412913,12000,6000000,5988000,Pink Flamingos,Divine|David Lochary|Mary Vivian Pearce|Mink Stole|Danny Mills,John Waters,93,Comedy,1972-03-12,51,6.3,1972,62574,31287365,31224791,6
7278,0.400301,2000000,18016290,16016290,Everything You Always Wanted to Know About Sex *But Were Afraid to Ask,Woody Allen|John Carradine|Lou Jacobi|Louise Lasser|Anthony Quayle,Woody Allen,88,Comedy,1972-08-06,93,6.5,1972,10429121,93947041,83517920,6
7284,0.321141,5000000,84563118,79563118,The Poseidon Adventure,Gene Hackman|Ernest Borgnine|Red Buttons|Carol Lynley|Roddy McDowall,Ronald Neame|Irwin Allen,117,Action|Adventure,1972-12-01,144,7.7,1972,26072804,440959531,414886727,8
7288,0.260584,3352254,58831997,55479743,The Getaway,Steve McQueen|Ali MacGraw|Ben Johnson|Al Lettieri|Sally Struthers,Sam Peckinpah,118,Action|Crime|Thriller,1972-12-13,42,7.2,1972,17480532,306783033,289302501,7
7309,5.488441,18000000,538400000,520400000,The Empire Strikes Back,Mark Hamill|Harrison Ford|Carrie Fisher|Billy Dee Williams|Anthony Daniels,Irvin Kershner,124,Adventure|Action|Science Fiction,1980-01-01,3954,8.0,1980,47628661,1424626187,1376997526,8
7310,2.432001,19000000,44017374,25017374,The Shining,Jack Nicholson|Shelley Duvall|Danny Lloyd|Scatman Crothers|Barry Nelson,Stanley Kubrick,144,Horror|Thriller,1980-05-22,1894,7.9,1980,50274698,116471589,66196891,8
7311,1.636256,3500000,83453539,79953539,Airplane!,Robert Hays|Julie Hagerty|Kareem Abdul-Jabbar|Lloyd Bridges|Peter Graves,Jim Abrahams|David Zucker|Jerry Zucker,88,Comedy|Romance,1980-07-02,618,7.0,1980,9261128,220821131,211560003,7
7312,1.607219,27000000,115229890,88229890,The Blues Brothers,Dan Aykroyd|John Belushi|James Brown|Cab Calloway|Ray Charles,John Landis,133,Music|Comedy|Action|Crime,1980-06-17,614,7.3,1980,71442992,304902523,233459531,7
7313,1.392663,4500000,58853106,54353106,The Blue Lagoon,Brooke Shields|Christopher Atkins|Leo McKern|William Daniels|Jeffrey Kleiser,Randal Kleiser,104,Romance|Adventure|Drama,1980-07-05,172,5.8,1980,11907165,155727481,143820316,6
7314,1.328578,18000000,23000000,5000000,Raging Bull,Robert De Niro|Joe Pesci|Cathy Moriarty|Frank Vincent|Nicholas Colasanto,Martin Scorsese,129,Drama,1980-11-14,437,7.4,1980,47628661,60858845,13230184,7
7315,1.285924,54000000,108185706,54185706,Superman II,Gene Hackman|Christopher Reeve|Ned Beatty|Jackie Cooper|Sarah Douglas,Richard Lester,127,Action|Adventure|Fantasy|Science Fiction,1980-12-04,319,6.3,1980,142885984,286263354,143377370,6
7316,1.24642,550000,59754601,59204601,Friday the 13th,Betsy Palmer|Adrienne King|Harry Crosby|Laurie Bartram|Jeannine Taylor,Sean S. Cunningham,95,Horror,1980-05-09,282,6.4,1980,1455320,158112870,156657550,6
7318,0.915548,35000000,27107960,-7892040,Flash Gordon,Sam J. Jones|Melody Anderson|Max von Sydow|Chaim Topol|Ornella Muti,Mike Hodges,111,Science Fiction,1980-09-01,94,5.8,1980,92611286,71728658,-20882628,6
7319,0.814856999999999,5000000,26010864,21010864,The Elephant Man,Anthony Hopkins|John Hurt|Anne Bancroft|John Gielgud|Wendy Hiller,David Lynch,124,Drama|History,1980-10-03,329,7.6,1980,13230183,68825702,55595519,8
7324,0.659181999999999,1000000,21378361,20378361,The Fog,Adrienne Barbeau|Jamie Lee Curtis|Janet Leigh|John Houseman|Tom Atkins,John Carpenter,89,Horror,1980-02-08,128,6.2,1980,2646036,56567928,53921892,6
7326,0.642289999999999,6000000,39846344,33846344,Caddyshack,Chevy Chase|Rodney Dangerfield|Ted Knight|Michael O'Keefe|Bill Murray,Harold Ramis,98,Comedy,1980-07-25,192,6.5,1980,15876220,105434890,89558670,6
7327,0.590127,6500000,31899000,25399000,Dressed to Kill,Michael Caine|Angie Dickinson|Nancy Allen|Keith Gordon|Dennis Franz,Brian De Palma,105,Horror|Mystery|Thriller,1980-06-25,60,6.7,1980,17199238,84405926,67206688,7
7328,0.580747999999999,8000000,11715321,3715321,Used Cars,Kurt Russell|Jack Warden|Frank McRae|Gerrit Graham|Deborah Harmon,Robert Zemeckis,113,Action|Comedy,1980-07-11,26,5.8,1980,21168294,30999169,9830875,6
7332,0.41895,44000000,3484331,-40515669,Heaven's Gate,Kris Kristofferson|Christopher Walken|John Hurt|Isabelle Huppert|Sam Waterston,Michael Cimino,219,Action|Drama|History|Western,1980-11-19,18,6.0,1980,116425617,9219667,-107205950,6
7343,0.341183,15000000,19853892,4853892,Altered States,William Hurt|Blair Brown|Bob Balaban|Charles Haid|Thaao Penghlis,Ken Russell,102,Mystery|Drama|Fantasy|Science Fiction|Thriller,1980-12-25,57,6.0,1980,39690551,52534127,12843576,6
7348,0.283507,4800000,22743674,17943674,American Gigolo,Richard Gere|Lauren Hutton|Judith Ransdell|HÃ©ctor Elizondo|K Callan,Paul Schrader,117,Thriller|Drama|Crime|Romance,1980-02-08,53,5.8,1980,12700976,60180597,47479621,6
7352,0.248142,7200000,12729678,5529678,Atlantic City,Burt Lancaster|Susan Sarandon|Kate Reid|Michel Piccoli|Hollis McLaren,Louis Malle,104,Crime|Drama|Romance,1980-09-02,24,6.6,1980,19051464,33683195,14631731,7
7355,0.247924,10000000,10389003,389003,Stardust Memories,Woody Allen|Charlotte Rampling|Jessica Harper|Marie-Christine Barrault|Tony Roberts,Woody Allen,89,Comedy|Drama|Romance,1980-09-26,41,6.3,1980,26460367,27489683,1029316,6
7361,0.192608,1000000,14796236,13796236,Prom Night,Leslie Nielsen|Jamie Lee Curtis|Casey Stevens|Anne-Marie Martin|Antoinette Bower,Paul Lynch,92,Horror|Mystery|Thriller,1980-07-18,39,6.4,1980,2646036,39151384,36505348,6
7367,0.074325,2000000,11000000,9000000,Battle Beyond the Stars,Richard Thomas|Robert Vaughn|John Saxon|George Peppard|Darlanne Fluegel,Jimmy T. Murakami,104,Science Fiction,1980-09-08,12,6.0,1980,5292073,29106404,23814331,6
7370,0.130304,20000000,22471595,2471595,Xanadu,Olivia Newton-John|Gene Kelly|Michael Beck|James Sloyan|Katie Hanley,Robert Greenwald,96,Fantasy|Music|Romance,1980-08-08,30,5.3,1980,52920735,59460666,6539931,5
7371,0.128234,10000000,15795189,5795189,The Long Riders,David Carradine|Keith Carradine|Robert Carradine|James Keach|Stacy Keach,Walter Hill,99,Western|History,1980-05-12,17,6.0,1980,26460367,41794650,15334283,6
7387,4.965391,300000000,961000000,661000000,Pirates of the Caribbean: At World's End,Johnny Depp|Orlando Bloom|Keira Knightley|Geoffrey Rush|Bill Nighy,Gore Verbinski,169,Adventure|Fantasy|Action,2007-05-19,2626,6.8,2007,315500574,1010653507,695152933,7
7388,4.878162,150000000,938212738,788212738,Harry Potter and the Order of the Phoenix,Daniel Radcliffe|Rupert Grint|Emma Watson|Michael Gambon|Ralph Fiennes,David Yates,138,Adventure|Fantasy|Family|Mystery,2007-06-28,3382,7.2,2007,157750287,986688860,828938573,7
7389,2.764535,150000000,623722818,473722818,Ratatouille,Patton Oswalt|Ian Holm|Lou Romano|Brian Dennehy|Peter Sohn,Brad Bird|Jan Pinkava,111,Animation|Comedy|Family|Fantasy,2007-06-22,2434,7.3,2007,157750287,655949691,498199404,7
7390,2.755051,70000000,442824138,372824138,The Bourne Ultimatum,Matt Damon|Julia Stiles|David Strathairn|Scott Glenn|Paddy Considine,Paul Greengrass,115,Action|Drama|Mystery|Thriller,2007-08-03,2051,7.2,2007,73616800,465704233,392087433,7
7391,2.730114,25000000,171600000,146600000,No Country for Old Men,Tommy Lee Jones|Javier Bardem|Josh Brolin|Woody Harrelson|Kelly Macdonald,Joel Coen|Ethan Coen,122,Crime|Drama|Thriller,2007-11-08,1706,7.6,2007,26291714,180466328,154174614,8
7392,2.692916,150000000,585349010,435349010,I Am Legend,Will Smith|Alice Braga|Charlie Tahan|Salli Richardson-Whitfield|Willow Smith,Francis Lawrence,101,Drama|Horror|Action|Thriller|Science Fiction,2007-12-14,3013,6.8,2007,157750287,615593163,457842876,7
7393,2.523173,130000000,457363168,327363168,National Treasure: Book of Secrets,Nicolas Cage|Jon Voight|Harvey Keitel|Ed Harris|Diane Kruger,Jon Turteltaub,124,Action|Adventure|Mystery|Thriller,2007-12-13,1121,6.0,2007,136716915,480994474,344277559,6
7394,2.520912,258000000,890871626,632871626,Spider-Man 3,Tobey Maguire|Kirsten Dunst|James Franco|Thomas Haden Church|Topher Grace,Sam Raimi,139,Fantasy|Action|Adventure,2007-05-01,2083,5.8,2007,271330494,936901700,665571206,6
7395,2.510571,18000000,57096190,39096190,The Mist,Thomas Jane|Marcia Gay Harden|Laurie Holden|Toby Jones|Jeffrey DeMunn,Frank Darabont,126,Science Fiction|Horror|Thriller,2007-11-21,714,6.6,2007,18930034,60046269,41116235,7
7396,2.489611,70000000,135560026,65560026,Stardust,Claire Danes|Charlie Cox|Michelle Pfeiffer|Robert De Niro|Sienna Miller,Matthew Vaughn,127,Adventure|Fantasy|Romance|Family,2007-08-09,684,7.0,2007,73616800,142564220,68947420,7
7397,2.400727,25000000,25037897,37897,Death Proof,Kurt Russell|ZoÃ« Bell|Rosario Dawson|Vanessa Ferlito|Sydney Tamiia Poitier,Quentin Tarantino,113,Action|Thriller,2007-05-21,720,6.7,2007,26291714,26331569,39855,7
7398,2.227384,110000000,383531464,273531464,Live Free or Die Hard,Bruce Willis|Justin Long|Timothy Olyphant|Cliff Curtis|Maggie Q,Len Wiseman,128,Action|Thriller,2007-06-20,1393,6.3,2007,115683544,403347991,287664447,6
7399,2.213223,140000000,258022233,118022233,Rush Hour 3,Chris Tucker|Jackie Chan|Hiroyuki Sanada|Max von Sydow|Yvan Attal,Brett Ratner,91,Action|Comedy|Crime|Thriller,2007-08-08,479,6.2,2007,147233601,271353876,124120275,6
7400,2.194526,15000000,56255142,41255142,Into the Wild,Emile Hirsch|Marcia Gay Harden|William Hurt|Jena Malone|Brian H. Dierker,Sean Penn,148,Adventure|Drama,2007-09-11,1768,7.7,2007,15775028,59161765,43386737,8
7401,2.191408,65000000,422610419,357610419,300,Gerard Butler|Lena Headey|Dominic West|David Wenham|Vincent Regan,Zack Snyder,117,Action|Adventure|War,2007-03-07,3428,7.0,2007,68358457,444446100,376087643,7
7402,2.148427,110000000,228738393,118738393,Ghost Rider,Nicolas Cage|Eva Mendes|Wes Bentley|Donal Logue|Sam Elliott,Mark Steven Johnson,114,Thriller|Action|Fantasy|Horror,2007-02-16,986,5.2,2007,115683544,240556981,124873437,5
7403,2.148164,7500000,231411584,223911584,Juno,Ellen Page|Michael Cera|Jennifer Garner|Jason Bateman|Allison Janney,Jason Reitman,96,Comedy|Drama|Romance,2007-12-05,1329,6.9,2007,7887514,243368292,235480778,7
7404,2.089502,60000000,137587063,77587063,Bridge to Terabithia,Josh Hutcherson|AnnaSophia Robb|Zooey Deschanel|Kate Butler|Bailee Madison,GÃ¡bor CsupÃ³,96,Adventure|Drama|Family,2007-02-16,564,6.9,2007,63100114,144695991,81595877,7
7405,2.082325,61000000,95696996,34696996,Shooter,Mark Wahlberg|Michael PeÃ±a|Danny Glover|Kate Mara|Elias Koteas,Antoine Fuqua,124,Action|Drama|Mystery|Thriller|Crime,2007-03-22,937,6.9,2007,64151783,100641524,36489741,7
7406,2.066397,30000000,129266061,99266061,Atonement,Keira Knightley|James McAvoy|Romola Garai|Saoirse Ronan|Brenda Blethyn,Joe Wright,123,Drama|Romance,2007-08-29,590,7.2,2007,31550057,135945055,104394998,7
7407,2.04262,25000000,76181545,51181545,There Will Be Blood,Daniel Day-Lewis|Paul Dano|Dillon Freasier|CiarÃ¡n Hinds|Kevin J. O'Connor,Paul Thomas Anderson,158,Drama,2007-12-28,830,7.8,2007,26291714,80117737,53826023,8
7409,1.946073,100000000,266465037,166465037,American Gangster,Denzel Washington|Russell Crowe|Chiwetel Ejiofor|Josh Brolin|Lymari Nadal,Ridley Scott,157,Drama|Crime,2007-11-02,966,7.3,2007,105166858,280232907,175066049,7
7411,1.862295,160000000,798958165,638958165,Shrek the Third,Mike Myers|Eddie Murphy|Cameron Diaz|Julie Andrews|Antonio Banderas,Chris Miller|Raman Hui,93,Fantasy|Adventure|Animation|Comedy|Family,2007-05-17,1277,5.8,2007,168266973,840239200,671972227,6
7412,1.846602,50000000,152000000,102000000,Sweeney Todd: The Demon Barber of Fleet Street,Johnny Depp|Helena Bonham Carter|Alan Rickman|Timothy Spall|Sacha Baron Cohen,Tim Burton,116,Drama|Horror|Music,2007-12-20,971,6.8,2007,52583429,159853624,107270195,7
7413,1.776713,20000000,169860655,149860655,Superbad,Jonah Hill|Michael Cera|Christopher Mintz-Plasse|Bill Hader|Seth Rogen,Greg Mottola,113,Comedy,2007-08-17,1325,7.0,2007,21033371,178637114,157603743,7
7414,1.748315,60000000,361366633,301366633,Alvin and the Chipmunks,Jason Lee|David Cross|Cameron Richardson|Jane Lynch|Justin Long,Tim Hill,92,Comedy|Music|Family|Fantasy|Animation,2007-12-13,704,5.6,2007,63100114,380037934,316937820,6
7415,1.713611,150000000,287594577,137594577,Bee Movie,Jerry Seinfeld|RenÃ©e Zellweger|Matthew Broderick|Patrick Warburton|John Goodman,Steve Hickner|Simon J. Smith,91,Family|Animation|Adventure|Comedy,2007-10-28,723,5.6,2007,157750287,302454181,144703894,6
7416,1.672137,150000000,169332978,19332978,Meet the Robinsons,Tom Selleck|Laurie Metcalf|Angela Bassett|Nicole Sullivan|Harland Williams,Stephen J. Anderson,95,Animation|Comedy|Family,2007-03-23,488,6.7,2007,157750287,178082172,20331885,7
7417,1.64701699999999,30000000,156835339,126835339,P.S. I Love You,Hilary Swank|Gerard Butler|Lisa Kudrow|Harry Connick Jr.|Gina Gershon,Richard LaGravenese,126,Drama|Romance,2007-11-15,639,7.0,2007,31550057,164938798,133388741,7
7418,1.640237,30000000,219076518,189076518,Knocked Up,Seth Rogen|Katherine Heigl|Leslie Mann|Paul Rudd|Jason Segel,Judd Apatow,129,Comedy|Romance|Drama,2007-06-01,746,6.0,2007,31550057,230395891,198845834,6
7419,1.591827,30000000,77566815,47566815,The Number 23,Jim Carrey|Virginia Madsen|Logan Lerman|Danny Huston|Lynn Collins,Joel Schumacher,101,Thriller|Drama|Mystery,2007-02-23,569,6.2,2007,31550057,81574582,50024525,6
7421,1.552842,130000000,289047763,159047763,4: Rise of the Silver Surfer,Ioan Gruffudd|Jessica Alba|Chris Evans|Michael Chiklis|Julian McMahon,Tim Story,92,Adventure|Fantasy|Action|Thriller,2007-06-13,1611,5.4,2007,136716915,303982451,167265536,5
7422,1.488671,85000000,340487652,255487652,Enchanted,Patrick Dempsey|Amy Adams|James Marsden|Timothy Spall|Rachel Covey,Kevin Lima,107,Comedy|Family|Fantasy|Romance,2007-11-20,726,6.6,2007,89391829,358080166,268688337,7
7423,1.46455499999999,65000000,84785914,19785914,Zodiac,Jake Gyllenhaal|Robert Downey Jr.|Mark Ruffalo|Anthony Edwards|Brian Cox,David Fincher,157,Crime|Drama|Mystery|Thriller,2007-03-02,1042,7.1,2007,68358457,89166682,20808225,7
7425,1.41435,85000000,311312624,226312624,Ocean's Thirteen,George Clooney|Brad Pitt|Matt Damon|Al Pacino|Bernie Mac,Steven Soderbergh,122,Crime|Thriller,2007-06-07,1371,6.4,2007,89391829,327397706,238005877,6
7426,1.39090499999999,34000000,95608995,61608995,TMNT,Chris Evans|Sarah Michelle Gellar|Mako|Kevin Smith|Patrick Stewart,Kevin Munroe,90,Comedy|Adventure|Fantasy|Action|Science Fiction,2007-03-22,214,6.0,2007,35756731,100548976,64792245,6
7427,1.380432,75000000,527068851,452068851,The Simpsons Movie,Dan Castellaneta|Julie Kavner|Nancy Cartwright|Yeardley Smith|Hank Azaria,David Silverman,87,Animation|Comedy|Family,2007-07-25,1258,6.9,2007,78875143,554301751,475426608,7
7428,1.3747,75000000,119000410,44000410,Charlie Wilson's War,Tom Hanks|Philip Seymour Hoffman|Julia Roberts|Amy Adams|Om Puri,Mike Nichols,102,Comedy|Drama|History,2007-12-19,187,6.3,2007,78875143,125148992,46273849,6
7429,1.368087,15000000,64238440,49238440,28 Weeks Later,Imogen Poots|Robert Carlyle|Rose Byrne|Jeremy Renner|Harold Perrineau,Juan Carlos Fresnadillo,100,Horror|Thriller|Science Fiction,2007-04-26,702,6.3,2007,15775028,67557549,51782521,6
7430,1.352489,70000000,86658558,16658558,The Kingdom,Jamie Foxx|Jennifer Garner|Chris Cooper|Jason Bateman|Ali Suliman,Peter Berg,110,Thriller|Action|Drama,2007-08-22,307,6.4,2007,73616800,91136082,17519282,6
7431,1.323511,40000000,41797066,1797066,Aliens vs Predator: Requiem,Steven Pasquale|Reiko Aylesworth|John Ortiz|Ariel Gade|Sam Trammell,Colin Strause|Greg Strause,94,Fantasy|Action|Science Fiction|Thriller|Horror,2007-12-25,423,4.9,2007,42066743,43956661,1889918,5
7432,1.318019,50000000,32017803,-17982197,Sunshine,Cillian Murphy|Rose Byrne|Chris Evans|Michelle Yeoh|Cliff Curtis,Danny Boyle,107,Science Fiction|Thriller,2007-04-05,654,6.8,2007,52583429,33672117,-18911312,7
7433,1.31484,25000000,229736344,204736344,Mr. Bean's Holiday,Rowan Atkinson|Max Baldry|Emma de Caunes|Willem Dafoe|Karel Roden,Steve Bendelack,90,Family|Comedy,2007-03-22,368,6.1,2007,26291714,241606495,215314781,6
7434,1.30813,20000000,41637263,21637263,Mr. Brooks,Kevin Costner|Demi Moore|Dane Cook|William Hurt|Marg Helgenberger,Bruce A. Evans,120,Drama|Crime|Mystery|Thriller,2007-06-01,266,6.7,2007,21033371,43788601,22755230,7
7435,1.285301,30000000,75505973,45505973,30 Days of Night,Josh Hartnett|Melissa George|Ben Foster|Danny Huston|Mark Boone Junior,David Slade,113,Horror|Thriller,2007-10-17,382,6.1,2007,31550057,79407259,47857202,6
7436,1.269498,180000000,372234864,192234864,The Golden Compass,Nicole Kidman|Daniel Craig|Dakota Blue Richards|Eva Green|Sam Elliott,Chris Weitz,113,Adventure|Fantasy,2007-12-04,740,5.7,2007,189300344,391467711,202167367,6
7437,1.254438,160000,20710513,20550513,Once,Glen Hansard|MarkÃ©ta IrglovÃ¡|Hugh Walsh|Gerard Hendrick|Alaistair Foley,John Carney,85,Drama|Music|Romance,2007-03-23,305,7.3,2007,168266,21780595,21612329,7
7439,1.210966,30000000,16930884,-13069116,88 Minutes,Al Pacino|Alicia Witt|Leelee Sobieski|Amy Brenneman|William Forsythe,Jon Avnet,108,Crime|Mystery|Thriller,2007-02-14,164,5.6,2007,31550057,17805678,-13744379,6
7440,1.196636,70000000,69766619,-233381,The Brave One,Jodie Foster|Terrence Howard|Nicky Katt|Naveen Andrews|Mary Steenburgen,Neil Jordan,122,Crime|Drama|Thriller,2007-09-14,115,6.3,2007,73616800,73371361,-245439,6
7441,1.180341,20000000,117760134,97760134,Disturbia,Shia LaBeouf|Sarah Roemer|Carrie-Anne Moss|David Morse|Aaron Yoo,D.J. Caruso,105,Thriller|Drama|Mystery,2007-04-12,549,6.6,2007,21033371,123844633,102811262,7
7442,1.156092,35000000,63215872,28215872,Lions for Lambs,Robert Redford|Meryl Streep|Tom Cruise|Michael PeÃ±a|Andrew Garfield,Robert Redford,92,Action|Adventure|Drama|History,2007-10-22,119,5.7,2007,36808400,66482146,29673746,6
7443,1.150389,55000000,70016220,15016220,3:10 to Yuma,Russell Crowe|Christian Bale|Logan Lerman|Dallas Roberts|Peter Fonda,James Mangold,122,Western,2007-09-06,762,6.8,2007,57841772,73633858,15792086,7
7444,1.145815,25000000,66122026,41122026,August Rush,Freddie Highmore|Keri Russell|Jonathan Rhys Meyers|Terrence Howard|Robin Williams,Kirsten Sheridan,114,Drama,2007-11-21,495,6.9,2007,26291714,69538457,43246743,7
7445,1.142781,86000000,14373825,-71626175,Awake,Hayden Christensen|Jessica Alba|Terrence Howard|Lena Olin|Charlie Hewson,Joby Harold,84,Thriller|Crime|Mystery,2007-11-28,229,6.3,2007,90443498,15116500,-75326998,6
7446,1.13351,25000000,40452643,15452643,War,Jet Li|Jason Statham|John Lone|Devon Aoki|Luis GuzmÃ¡n,Philip G. Atwell,103,Action|Thriller|Crime,2007-08-24,251,5.9,2007,26291714,42542773,16251059,6
7447,1.120442,15000,193355800,193340800,Paranormal Activity,Katie Featherston|Micah Sloat|Mark Fredrichs|Amber Armstrong|Ashley Palmer,Oren Peli,86,Horror|Mystery,2007-09-14,714,6.1,2007,15775,203346220,203330445,6
7448,1.109374,175000000,173000000,-2000000,Evan Almighty,Steve Carell|Lauren Graham|John Goodman|Jimmy Bennett|John Michael Higgins,Tom Shadyac,96,Fantasy|Comedy|Family,2007-06-09,683,5.2,2007,184042001,181938664,-2103337,5
7449,1.09781,85000000,186072214,101072214,I Now Pronounce You Chuck & Larry,Adam Sandler|Kevin James|Jessica Biel|Dan Aykroyd|Ving Rhames,Dennis Dugan,115,Comedy|Romance,2007-07-12,368,5.9,2007,89391829,195686301,106294472,6
7450,1.068126,70000000,18211013,-51788987,Next,Nicolas Cage|Julianne Moore|Jessica Biel|Thomas Kretschmann|Tory Kittles,Lee Tamahori,96,Action|Science Fiction|Thriller,2007-04-24,499,5.9,2007,73616800,19151950,-54464850,6
7452,1.052831,20000000,84146832,64146832,Premonition,Sandra Bullock|Julian McMahon|Courtney Taylor Burness|Nia Long|Shyann McClure,Mennan Yapo,110,Fantasy|Drama|Mystery,2007-02-08,213,5.9,2007,21033371,88494579,67461208,6
7454,1.049862,10000000,139352633,129352633,Saw IV,Tobin Bell|Scott Patterson|Costas Mandylor|Betsy Russell|Lyriq Bent,Darren Lynn Bousman,93,Horror|Thriller|Crime,2007-10-25,469,5.8,2007,10516685,146552786,136036101,6
7455,1.031011,100000000,97838349,-2161651,Fred Claus,Vince Vaughn|Paul Giamatti|John Michael Higgins|Miranda Richardson|Rachel Weisz,David Dobkin,116,Action|Comedy|Drama,2007-11-03,115,5.5,2007,105166858,102893517,-2273341,5
7457,1.019152,50000000,90450008,40450008,Hairspray,John Travolta|Michelle Pfeiffer|Christopher Walken|Amanda Bynes|James Marsden,Adam Shankman,117,Comedy|Music|Romance,2007-07-13,395,6.4,2007,52583429,95123431,42540002,6
7460,0.993908,39000000,26820641,-12179359,Shoot 'Em Up,Clive Owen|Monica Bellucci|Paul Giamatti|Stephen McHattie|Greg Bryk,Michael Davis,86,Action|Thriller|Comedy|Crime,2007-07-26,322,6.2,2007,41015074,28206425,-12808649,6
7461,0.992072,51500000,55112356,3612356,Eastern Promises,Naomi Watts|Viggo Mortensen|Vincent Cassel|Armin Mueller-Stahl|SinÃ©ad Cusack,David Cronenberg,100,Thriller|Crime|Mystery,2007-09-14,423,7.0,2007,54160932,57959933,3799001,7
7462,0.969354,70000000,195735876,125735876,Beowulf,Ray Winstone|Angelina Jolie|Anthony Hopkins|Robin Wright|John Malkovich,Robert Zemeckis,115,Animation|Fantasy,2007-11-05,505,5.4,2007,73616800,205849271,132232471,5
7463,0.947353,28000000,92601050,64601050,No Reservations,Catherine Zeta-Jones|Aaron Eckhart|Abigail Breslin|Patricia Clarkson|Jenny Wade,Scott Hicks,104,Comedy,2007-07-25,202,6.0,2007,29446720,97385615,67938895,6
7465,0.924655,60000000,127766650,67766650,The Heartbreak Kid,Ben Stiller|Malin Ã…kerman|Michelle Monaghan|Jerry Stiller|Rob Corddry,Bobby Farrelly|Peter Farrelly,116,Comedy,2007-10-05,215,5.6,2007,63100114,134368171,71268057,6
7466,0.919967,85000000,149044513,64044513,Surf's Up,Shia LaBeouf|Jeff Bridges|Zooey Deschanel|Jon Heder|James Woods,Ash Brannon|Chris Buck,85,Animation|Comedy|Family,2007-06-08,374,5.9,2007,89391829,156745431,67353602,6
7467,0.917818,25000000,94679598,69679598,1408,John Cusack|Samuel L. Jackson|Mary McCormack|Jasmine Jessica Anthony|Tony Shalhoub,Mikael HÃ¥fstrÃ¶m,104,Horror|Thriller,2007-07-12,746,6.4,2007,26291714,99571558,73279844,6
7468,0.915514,24000000,99965753,75965753,Hitman,Timothy Olyphant|Dougray Scott|Olga Kurylenko|Robert Knepper|Ulrich Thomsen,Xavier Gens,89,Action|Crime|Drama|Thriller,2007-11-21,615,5.9,2007,25240045,105130841,79890796,6
7469,0.911592,22000000,147880543,125880543,The Game Plan,Dwayne Johnson|Madison Pettis|Kyra Sedgwick|Roselyn SÃ¡nchez|Morris Chestnut,Andy Fickman,110,Comedy|Family,2007-09-28,248,6.0,2007,23136708,155521321,132384613,6
7471,0.906938,67000000,25037897,-41962103,Grindhouse,Kurt Russell|ZoÃ« Bell|Rosario Dawson|Vanessa Ferlito|Sydney Tamiia Poitier,Robert Rodriguez|Eli Roth|Quentin Tarantino|Edgar Wright|Rob Zombie|Jason Eisener,191,Thriller|Action|Horror,2007-04-06,197,6.5,2007,70461795,26331569,-44130226,6
7472,0.906039,10000000,33000000,23000000,Run Fatboy Run,Simon Pegg|Thandie Newton|Hank Azaria|Dylan Moran|Harish Patel,David Schwimmer,100,Comedy|Romance,2007-09-06,117,6.2,2007,10516685,34705063,24188378,6
7473,0.890977,16000000,1109660,-14890340,The Messengers,Kristen Stewart|Dylan McDermott|Penelope Ann Miller|John Corbett|William B. Davis,Danny Pang|Oxide Pang Chun,90,Thriller|Drama|Horror,2007-02-02,114,5.6,2007,16826697,1166994,-15659703,6
7474,0.890556999999999,150000000,709709780,559709780,Transformers,Shia LaBeouf|Josh Duhamel|Megan Fox|Rachael Taylor|Tyrese Gibson,Michael Bay,144,Adventure|Science Fiction|Action,2007-06-27,2752,6.6,2007,157750287,746379478,588629191,7
7475,0.881034,45000000,175372502,130372502,The Bucket List,Jack Nicholson|Morgan Freeman|Sean Hayes|Beverly Todd|Rob Morrow,Rob Reiner,97,Comedy|Drama|Adventure,2007-12-25,679,6.9,2007,47325086,184433750,137108664,7
7476,0.874887,10200000,35619521,25419521,Hostel: Part II,Lauren German|Bijou Phillips|Heather Matarazzo|Richard Burgi|Roger Bart,Eli Roth,93,Horror,2007-06-08,203,5.6,2007,10727019,37459931,26732912,6
7479,0.827695,10000000,25399945,15399945,The Hitcher,Sean Bean|Sophia Bush|Zachary Knighton|Neal McDonough|Kyle Davis,Dave Meyers,84,Action|Horror|Crime,2007-01-19,124,5.4,2007,10516685,26712324,16195639,5
7482,0.811539,12000000,9620399,-2379601,I Know Who Killed Me,Lindsay Lohan|Julia Ormond|Neal McDonough|Brian Geraghty|Spencer Garrett,Chris Sivertson,105,Crime|Horror|Mystery|Thriller,2007-07-27,44,3.8,2007,12620022,10117471,-2502551,4
7483,0.809646,15000000,80253908,65253908,Halloween,Malcolm McDowell|Brad Dourif|Daeg Faerch|Tyler Mane|Scout Taylor-Compton,Rob Zombie,109,Horror,2007-08-31,241,5.8,2007,15775028,84400513,68625485,6
7484,0.7944,16500000,37311672,20811672,Becoming Jane,Anne Hathaway|James McAvoy|Julie Walters|James Cromwell|Maggie Smith,Julian Jarrold,120,Drama|Romance,2007-03-02,175,6.9,2007,17352531,39239513,21886982,7
7486,0.773934,15000000,7938872,-7061128,Funny Games,Naomi Watts|Tim Roth|Michael Pitt|Brady Corbet|Devon Gearhart,Michael Haneke,112,Horror|Thriller|Crime,2007-10-20,240,6.2,2007,15775028,8349062,-7425966,6
7488,0.756472,25000000,74237563,49237563,Elizabeth: The Golden Age,Cate Blanchett|Clive Owen|Geoffrey Rush|Laurence Fox|Tom Hollander,Shekhar Kapur,114,Drama|History|Romance,2007-09-09,149,6.4,2007,26291714,78073312,51781598,6
7491,0.726521,80000000,15071514,-64928486,The Invasion,Nicole Kidman|Daniel Craig|Jeremy Northam|Jeffrey Wright|Jackson Bond,Oliver Hirschbiegel|James McTeigue,99,Science Fiction|Thriller,2007-08-17,156,5.4,2007,84133486,15850237,-68283249,5
7494,0.682794,18000000,25005257,7005257,Before the Devil Knows You're Dead,Philip Seymour Hoffman|Ethan Hawke|Albert Finney|Marisa Tomei|Aleksa Palladino,Sidney Lumet,117,Crime|Drama|Thriller,2007-09-26,153,6.7,2007,18930034,26297243,7367209,7
7496,0.680581,6000000,18197398,12197398,Daddy Day Camp,Cuba Gooding Jr.|Tamala Jones|Paul Rae|Lochlyn Munro|Richard Gant,Fred Savage,89,Comedy|Family,2007-08-08,51,4.8,2007,6310011,19137631,12827620,5
7498,0.67455,2000000,22179430,20179430,Waitress,Keri Russell|Nathan Fillion|Andy Griffith|Cheryl Hines|Eddie Jemison,Adrienne Shelly,108,Comedy,2007-05-25,59,6.7,2007,2103337,23325409,21222072,7
7501,0.667454,8000000,7766240,-233760,P2,Wes Bentley|Rachel Nichols|Simon Reynolds|Philip Akin|Miranda Edwards,Franck Khalfoun,98,Horror|Thriller,2007-11-09,73,5.8,2007,8413348,8167510,-245838,6
7502,0.665367,45000000,147717833,102717833,Resident Evil: Extinction,Milla Jovovich|Oded Fehr|Ali Larter|Iain Glen|Mike Epps,Russell Mulcahy,94,Horror|Action|Science Fiction,2007-09-20,789,6.0,2007,47325086,155350204,108025118,6
7503,0.663818999999999,2000000,5364858,3364858,Diary of the Dead,Michelle Morgan|Joshua Close|Shawn Roberts|Amy Lalonde|Joe Dinicol,George A. Romero,95,Horror|Action|Science Fiction,2007-09-08,72,5.3,2007,2103337,5642052,3538715,5
7504,0.653746,30000000,14711793,-15288207,The Assassination of Jesse James by the Coward Robert Ford,Brad Pitt|Casey Affleck|Sam Shepard|Mary-Louise Parker|Paul Schneider,Andrew Dominik,160,Action|Drama|Western,2007-09-02,460,6.9,2007,31550057,15471930,-16078127,7
7505,0.643102,16000000,18928871,2928871,A Mighty Heart,Angelina Jolie|Dan Futterman|Irrfan Khan|Archie Panjabi|Denis O'Hare,Michael Winterbottom,100,Drama|Thriller,2007-01-01,54,6.7,2007,16826697,19906898,3080201,7
7506,0.642207,9000000,46,-8999954,Death at a Funeral,Matthew Macfadyen|Alan Tudyk|Peter Dinklage|Keeley Hawes|Andy Nyman,Frank Oz,90,Comedy|Drama,2007-02-09,262,6.7,2007,9465017,48,-9464969,7
7507,0.63935,40000000,62771059,22771059,The Reaping,Hilary Swank|David Morrissey|Idris Elba|AnnaSophia Robb|Stephen Rea,Stephen Hopkins,99,Horror,2007-04-05,100,5.4,2007,42066743,66014350,23947607,5
7509,0.614557999999999,60795000,73090611,12295611,Perfect Stranger,Halle Berry|Bruce Willis|Giovanni Ribisi|Richard Portnow|Gary Dourdan,James Foley,109,Crime|Drama|Mystery|Thriller,2007-04-12,128,5.3,2007,63936191,76867099,12930908,5
7510,0.611445,5200000,14723313,9523313,KatyÅ„,Artur Å»mijewski|Maja Ostaszewska|Andrzej Chyra|Danuta Stenka|Jan Englert,Andrzej Wajda,118,Drama|History|War,2007-09-21,29,6.0,2007,5468676,15484045,10015369,6
7512,0.607023,60000000,95673607,35673607,Norbit,Eddie Murphy|Thandie Newton|Terry Crews|Clifton Powell|Lester Speight,Brian Robbins,101,Comedy,2007-02-08,230,5.3,2007,63100114,100616926,37516812,5
7513,0.606428,40000000,145896422,105896422,Music and Lyrics,Drew Barrymore|Hugh Grant|Scott Porter|Brad Garrett|Haley Bennett,Marc Lawrence,96,Comedy|Music|Romance,2007-02-09,372,6.1,2007,42066743,153434683,111367940,6
7514,0.59846,27500000,24748670,-2751330,Rendition,Omar Metwally|Reese Witherspoon|Jake Gyllenhaal|Moa Khouas|Zineb Oukach,Gavin Hood,120,Drama|Thriller,2007-09-07,104,5.7,2007,28920886,26027398,-2893488,6
7515,0.59707,20000000,6819587,-13180413,Flawless,Demi Moore|Michael Caine|Lambert Wilson|Nathaniel Parker|Shaughan Seymour,Michael Radford,108,Crime|Drama|Thriller,2007-09-01,80,6.6,2007,21033371,7171945,-13861426,7
7521,0.578112,23000000,29541790,6541790,In the Valley of Elah,Tommy Lee Jones|Charlize Theron|Susan Sarandon|Frances Fisher|James Franco,Paul Haggis,124,History|Drama|Thriller|Crime|Mystery,2007-08-31,115,6.2,2007,24188377,31068172,6879795,6
7523,0.574488,25000000,59192128,34192128,Good Luck Chuck,Dane Cook|Jessica Alba|Dan Fogler|Ellia English|Lonny Ross,Mark Helfrich,101,Comedy|Drama|Romance,2007-09-21,272,5.5,2007,26291714,62250501,35958787,5
7526,0.57106,20000000,86865564,66865564,Epic Movie,Kal Penn|Adam Campbell|Jennifer Coolidge|Jayma Mays|Faune A. Chambers,Jason Friedberg|Aaron Seltzer,86,Action|Adventure|Comedy,2007-01-25,170,3.4,2007,21033371,91353784,70320413,3
7528,0.569416,10000000,17500000,7500000,In the Land of Women,Meg Ryan|Kristen Stewart|Adam Brody|JoBeth Williams|Olympia Dukakis,Jon Kasdan,97,Romance|Comedy|Drama,2007-04-16,82,6.0,2007,10516685,18404200,7887515,6
7531,0.564132,4000000,6101046,2101046,Battle for Terra,Evan Rachel Wood|Brian Cox|Luke Wilson|David Cross|Justin Long,Aristomenis Tsirbas,85,Science Fiction|Action|Adventure|Animation|Family,2007-09-06,63,6.0,2007,4206674,6416278,2209604,6
7532,0.551406,20000000,47738099,27738099,The Nanny Diaries,Scarlett Johansson|Laura Linney|Chris Evans|Paul Giamatti|Nicholas Art,Shari Springer Berman|Robert Pulcini,106,Comedy|Drama|Romance,2007-08-24,203,6.0,2007,21033371,50204658,29171287,6
7534,0.54498,15000000,30226144,15226144,The Great Debaters,Denzel Washington|Nate Parker|Forest Whitaker|Denzel Whitaker|Kimberly Elise,Denzel Washington,126,Drama,2007-12-27,74,6.6,2007,15775028,31787886,16012858,7
7538,0.54281,21000000,41170784,20170784,Freedom Writers,Hilary Swank|Scott Glenn|Imelda Staunton|Patrick Dempsey|Mario,Richard LaGravenese,123,Crime|Drama,2007-01-05,183,7.5,2007,22085040,43298020,21212980,7
7540,0.541086,30000000,26810113,-3189887,The Invisible,Justin Chatwin|Margarita Levieva|Marcia Gay Harden|Chris Marquette|Callum Keith Rennie,David S. Goyer,102,Action|Adventure|Crime|Drama|Fantasy,2007-04-27,70,5.9,2007,31550057,28195353,-3354704,6
7545,0.522454,3500000,54947,-3445053,La terza madre,Asia Argento|Cristian Solimeno|Adam James|Moran Atias|Valeria Cavalli,Dario Argento,102,Horror,2007-09-06,32,4.6,2007,3680840,57786,-3623054,5
7546,0.521559,21000000,54926886,33926886,We Own the Night,Joaquin Phoenix|Eva Mendes|Alex Veadov|Mark Wahlberg|Robert Duvall,James Gray,117,Drama|Crime|Thriller,2007-05-25,162,6.4,2007,22085040,57764880,35679840,6
7547,0.505809,20000000,73276047,53276047,The Kite Runner,Khalid Abdalla|Atossa Leoni|Shaun Toub|Zekeria Ebrahimi|Ahmad Khan Mahmoodzada,Marc Forster,128,Drama,2007-10-14,223,7.3,2007,21033371,77062116,56028745,7
7548,0.504782,19000000,35300645,16300645,Vacancy,Kate Beckinsale|Luke Wilson|Ethan Embry|Scott G. Anderson|Frank Whaley,NimrÃ³d Antal,80,Horror|Thriller,2007-04-20,181,5.9,2007,19981703,37124579,17142876,6
7549,0.501939,25000000,68377859,43377859,Dan in Real Life,Steve Carell|Juliette Binoche|Dane Cook|Dianne Wiest|John Mahoney,Peter Hedges,98,Comedy|Romance|Drama,2007-10-26,185,6.5,2007,26291714,71910846,45619132,6
7551,0.500174,16500000,13620075,-2879925,Sydney White,Amanda Bynes|Sara Paxton|Matt Long|Jeremy Howard|Danny Strong,Joe Nussbaum,108,Comedy,2007-09-21,112,5.9,2007,17352531,14323804,-3028727,6
7555,0.49765,17000000,2626800,-14373200,Captivity,Elisha Cuthbert|Daniel Gillies|Pruitt Taylor Vince|Laz Alonso|Chrysta Olson,Roland JoffÃ©,96,Crime|Horror|Thriller,2007-06-22,64,4.5,2007,17878365,2762523,-15115842,4
7557,0.492637,35000000,69307224,34307224,License to Wed,Robin Williams|Mandy Moore|John Krasinski|Eric Christian Olsen|Christine Taylor,Ken Kwapis,91,Comedy,2007-07-04,132,5.1,2007,36808400,72888230,36079830,5
7558,0.490256,24000000,9576495,-14423505,I Could Never Be Your Woman,Michelle Pfeiffer|Paul Rudd|Saoirse Ronan|Stacey Dash|Fred Willard,Amy Heckerling,97,Comedy|Drama|Romance,2007-05-11,44,5.3,2007,25240045,10071298,-15168747,5
7561,0.47599,25000000,92991835,67991835,Michael Clayton,George Clooney|Tom Wilkinson|Tilda Swinton|Sydney Pollack|Michael O'Keefe,Tony Gilroy,119,Drama|Mystery|Crime,2007-09-28,240,6.3,2007,26291714,97796591,71504877,6
7562,0.475818,12000000,11293663,-706337,Lars and the Real Girl,Ryan Gosling|Emily Mortimer|Paul Schneider|Kelli Garner|Lauren Ash,Craig Gillespie,106,Comedy|Romance|Drama,2007-10-12,280,7.0,2007,12620022,11877190,-742832,7
7565,0.471104,45000000,103071443,58071443,The Water Horse,Alexander Nathan Etel|Emily Watson|Ben Chaplin|David Morrissey|Priyanka Xi,Jay Russell,112,Fantasy|Adventure|Family,2007-12-25,164,6.2,2007,47325086,108396998,61071912,6
7566,0.470629,20000000,16974459,-3025541,Death Sentence,Kevin Bacon|Garrett Hedlund|Kelly Preston|Jordan Garrett|John Goodman,James Wan,105,Action|Crime|Drama|Thriller,2007-08-31,148,6.5,2007,21033371,17851505,-3181866,6
7567,0.470193,22000000,413454,-21586546,The Death and Life of Bobby Z,Paul Walker|Laurence Fishburne|Olivia Wilde|Jason Lewis|Michael Bowen,John Herzfeld,97,Drama|Action|Thriller|Crime,2007-07-23,61,5.6,2007,23136708,434816,-22701892,6
7576,0.451544,16000000,5367030,-10632970,The Lookout,Joseph Gordon-Levitt|Jeff Daniels|Matthew Goode|Isla Fisher|Carla Gugino,Scott Frank,99,Crime|Drama|Thriller,2007-03-09,93,6.7,2007,16826697,5644336,-11182361,7
7585,0.432926,9000000,24538513,15538513,Sicko,Michael Moore|George W. Bush|Bill Clinton|Hillary Clinton|Billy Crystal,Michael Moore,123,Documentary,2007-05-18,115,7.0,2007,9465017,25806383,16341366,7
7586,0.43151,45000000,30822861,-14177139,Pathfinder,Karl Urban|Moon Bloodgood|Russell Means|Clancy Brown|Jay Tavare,Marcus Nispel,99,Action,2007-01-11,92,5.4,2007,47325086,32415434,-14909652,5
7587,0.431266,19000000,34619699,15619699,Gone Baby Gone,Casey Affleck|Michelle Monaghan|Morgan Freeman|Ed Harris|John Ashton,Ben Affleck,113,Crime|Drama|Mystery,2007-10-19,559,7.0,2007,19981703,36408449,16426746,7
7595,0.419377,35000000,18317151,-16682849,Walk Hard: The Dewey Cox Story,John C. Reilly|Jenna Fischer|Tim Meadows|Kristen Wiig|Raymond J. Barry,Jake Kasdan,96,Comedy|Music,2007-12-21,93,6.5,2007,36808400,19263572,-17544828,6
7598,0.412761,5000000,346592,-4653408,Meet Bill,Aaron Eckhart|Jessica Alba|Elizabeth Banks|Timothy Olyphant|Logan Lerman,Bernie Goldmann|Melisa Wallack,97,Comedy|Drama|Romance,2007-09-07,50,5.9,2007,5258342,364499,-4893843,6
7601,0.408767,16000000,2849142,-13150858,Things We Lost in the Fire,Halle Berry|Benicio del Toro|David Duchovny|Alison Lohman|Sarah Dubrovsky,Susanne Bier,113,Drama,2007-09-26,40,6.5,2007,16826697,2996353,-13830344,6
7602,0.405537,20000000,3561,-19996439,Death Defying Acts,Catherine Zeta-Jones|Guy Pearce|Timothy Spall|Saoirse Ronan|Malcolm Shields,Gillian Armstrong,97,Drama|Romance,2007-09-13,31,5.4,2007,21033371,3744,-21029627,5
7612,0.390284,20000000,22222308,2222308,Reign Over Me,Adam Sandler|Don Cheadle|Jada Pinkett Smith|Liv Tyler|Saffron Burrows,Mike Binder,124,Drama,2007-03-23,180,7.0,2007,21033371,23370503,2337132,7
7613,0.38963,45000000,4607608,-40392392,Love in the Time of Cholera,Javier Bardem|Unax Ugalde|Benjamin Bratt|Catalina Sandino Moreno|HÃ©ctor Elizondo,Mike Newell,139,Drama|Romance,2007-10-04,40,6.6,2007,47325086,4845676,-42479410,7
7617,0.373385,20000000,4001121,-15998879,I'm Not There.,Cate Blanchett|Heath Ledger|Julianne Moore|Ben Whishaw|Charlotte Gainsbourg,Todd Haynes,135,Drama|Music,2007-10-01,96,6.5,2007,21033371,4207853,-16825518,6
7620,0.370331,9000000,2955039,-6044961,Gracie,Jesse Lee Soffer|Christopher Shand|Carly Schroeder|Karl Girolamo|Vasilios Mantagas,Davis Guggenheim,97,Drama|Family,2007-06-01,10,5.8,2007,9465017,3107721,-6357296,6
7630,0.35159,15000000,109000000,94000000,Earth,Patrick Stewart|Constantino Romero|James Earl Jones|Ken Watanabe|Ulrich Tukur,Alastair Fothergill|Mark Linfield,90,Documentary,2007-04-22,102,7.5,2007,15775028,114631875,98856847,7
7637,0.32337,15000000,20380,-14979620,The Good Night,PenÃ©lope Cruz|Martin Freeman|Gwyneth Paltrow|Simon Pegg|Danny DeVito,Jake Paltrow,93,Comedy|Drama|Romance|Fantasy|Music,2007-01-25,16,5.5,2007,15775028,21433,-15753595,5
7638,0.320907,67000000,25303038,-41696962,The Last Legion,Colin Firth|Ben Kingsley|Aishwarya Rai Bachchan|Peter Mullan|Kevin McKidd,Doug Lefler,102,Action|Adventure|Fantasy|War,2007-04-19,120,4.9,2007,70461795,26610410,-43851385,5
7643,0.324065,12000000,5285197,-6714803,Whisper,Blake Woodruff|Josh Holloway|Sarah Wayne Callies|Michael Rooker|Julian Christopher,Stewart Hendler,94,Crime|Drama|Horror|Thriller,2007-11-27,28,5.7,2007,12620022,5558275,-7061747,6
7653,0.291333,10000000,21786738,11786738,My Blueberry Nights,Norah Jones|Jude Law|David Strathairn|Rachel Weisz|Cat Power,Wong Kar-wai,111,Drama|Romance,2007-05-16,110,6.2,2007,10516685,22912427,12395742,6
7654,0.290794,4000000,2426851,-1573149,You Kill Me,Ben Kingsley|TÃ©a Leoni|Luke Wilson|Bill Pullman|Dennis Farina,John Dahl,90,Comedy|Crime|Thriller|Romance,2007-02-09,33,6.1,2007,4206674,2552242,-1654432,6
7665,0.267233,16000000,24377151,8377151,The Darjeeling Limited,Owen Wilson|Jason Schwartzman|Adrien Brody|Bill Murray|Anjelica Huston,Wes Anderson,91,Adventure|Drama|Comedy,2007-09-29,488,7.2,2007,16826697,25636683,8809986,7
7667,0.266045,13000000,75511123,62511123,Stomp the Yard,Columbus Short|Meagan Good|Ne-Yo|Darrin Henson|Jermaine Williams,Sylvain White,114,Drama|Music,2007-05-16,57,6.1,2007,13671691,79412675,65740984,6
7668,0.346282,38000000,5410749,-32589251,Virgin Territory,Ryan Cartwright|Hayden Christensen|Mischa Barton|Jay Villiers|Simone Spinazze,David Leland,93,Adventure|Action|Comedy|Romance,2007-12-17,45,4.5,2007,39963406,5690314,-34273092,4
7670,0.262103,8000000,60641,-7939359,Hallam Foe,Jamie Bell|Sophia Myles|CiarÃ¡n Hinds|Claire Forlani|Jamie Sives,David Mackenzie,95,Drama|Comedy|Thriller,2007-02-16,25,6.7,2007,8413348,63774,-8349574,7
7675,0.258046,20000000,22217407,2217407,Dead Silence,Ryan Kwanten|Donnie Wahlberg|Bob Gunton|Amber Valletta|Laura Regan,James Wan,89,Horror,2007-03-16,264,6.2,2007,21033371,23365348,2331977,6
7685,0.245902,50000,249905,199905,The Signal,Anessa Ramsey|Justin Welborn|AJ Bowen|Scott Poythress|Sahr Ngaujah,David Bruckner|Dan Bush|Jacob Gentry,103,Horror|Action|Thriller|Science Fiction,2007-02-22,28,5.9,2007,52583,262817,210234,6
7697,0.228459,8000000,908847,-7091153,Battle in Seattle,Martin Henderson|Michelle Rodriguez|Woody Harrelson|Charlize Theron|Jennifer Carpenter,Stuart Townsend,99,Action|Drama,2007-09-07,37,6.4,2007,8413348,955805,-7457543,6
7706,0.39628,500000,220151,-279849,Boy Culture,Jonathon Trent|Derek Magyar|George Jonson|Patrick Bauchau|Darryl Stephens,Q. Allan Brocka,88,Drama|Romance,2007-01-31,18,5.4,2007,525834,231525,-294309,5
7707,0.216599,4000000,6870249,2870249,Son of Rambow,Neil Dudgeon|Bill Milner|Jessica Hynes|Anna Wing|Will Poulter,Garth Jennings,96,Comedy,2007-01-22,62,6.7,2007,4206674,7225225,3018551,7
7708,0.216287,11000000,13196245,2196245,I Think I Love My Wife,Chris Rock|Kerry Washington|Gina Torres|Steve Buscemi|Edward Herrmann,Chris Rock,90,Comedy|Romance,2007-03-16,22,5.3,2007,11568354,13878076,2309722,5
7714,0.208459,4000000,46474,-3953526,December Boys,Daniel Radcliffe|Jack Thompson|Teresa Palmer|Sullivan Stapleton|Carole-Anne Fooks,Rod Hardy,105,Drama|Romance,2007-09-20,42,5.8,2007,4206674,48875,-4157799,6
7717,0.205036,50000000,82169884,32169884,Hannibal Rising,Gaspard Ulliel|Aaran Thomas|Gong Li|Dominic West|Rhys Ifans,Peter Webber,121,Crime|Drama|Thriller,2007-02-06,423,6.0,2007,52583429,86415485,33832056,6
7718,0.203044,1000000,274661,-725339,Taxi to the Dark Side,Brian Keith Allen|Moazzam Begg|Christopher Beiring|Alex Gibney,Alex Gibney,106,Documentary,2007-04-30,21,5.2,2007,1051668,288852,-762816,5
7733,0.172467,15000000,55184721,40184721,Why Did I Get Married?,Tyler Perry|Jill Scott|Janet Jackson|Michael Jai White|Malik Yoba,Tyler Perry,113,Comedy|Drama,2007-10-12,20,6.3,2007,15775028,58036037,42261009,6
7739,0.165385999999999,16000000,34786960,18786960,Ji jie hao,Hanyu Zhang|Ren Quan|Wang Baoqiang|Deng Chao|Yuan Wenkang,Feng Xiaogang,124,Action|History,2007-10-09,22,7.3,2007,16826697,36584352,19757655,7
7758,0.144185999999999,700000,31576,-668424,The Tracey Fragments,Ellen Page|Ari Cohen|Erin McMurtry|Maxwell McCabe-Lokos|Zie Souwand,Bruce McDonald,77,Drama,2007-09-12,17,5.9,2007,736168,33207,-702961,6
7761,0.138009,10000000,31609243,21609243,Daddy's Little Girls,"Gabrielle Union|Idris Elba|Louis Gossett, Jr.|Tasha Smith|Tracee Ellis Ross",Tyler Perry,100,Comedy|Drama|Romance,2007-02-14,13,6.7,2007,10516685,33242447,22725762,7
7776,0.422526,1500000,173066,-1326934,My Name Is Bruce,Bruce Campbell|Grace Thorsen|Ted Raimi|Adam Boyd|Mike Estes,Bruce Campbell,86,Comedy|Horror,2007-10-01,41,6.0,2007,1577502,182008,-1395494,6
7785,0.104735,10000000,20342161,10342161,Reno 911!: Miami,Lennie Loftin|Danny DeVito|Ben Garant|Carlos Alazraqui|Mary Birdsong,Ben Garant,84,Action|Adventure|Comedy|Crime,2007-02-23,34,5.8,2007,10516685,21393211,10876526,6
7797,0.080562,20000000,10337477,-9662523,Code Name: The Cleaner,Cedric the Entertainer|Lucy Liu|Nicollette Sheridan|Mark Dacascos|Callum Keith Rennie,Les Mayfield,84,Action|Comedy|Crime,2007-01-05,45,4.9,2007,21033371,10871599,-10161772,5
7808,0.063177,441892,1030375,588483,Partner,Salman Khan|Govinda|Lara Dutta|Katrina Kaif|Rajpal Yadav,David Dhawan,155,Comedy|Foreign|Romance,2007-01-01,10,6.2,2007,464723,1083613,618890,6
7819,0.019101,2000000,1431623,-568377,No End in Sight,Campbell Scott|Gerald Burke|Ali Fadhil|Robert Hutchings,Charles Ferguson,102,Documentary,2007-07-27,12,6.7,2007,2103337,1505592,-597745,7
7825,4.935897,11000000,104931801,93931801,Alien,Sigourney Weaver|Tom Skerritt|Veronica Cartwright|Harry Dean Stanton|John Hurt,Ridley Scott,117,Horror|Action|Thriller|Science Fiction,1979-05-25,2724,7.6,1979,33050094,315273262,282223168,8
7826,2.31952,31500000,83471511,51971511,Apocalypse Now,Martin Sheen|Marlon Brando|Robert Duvall|Laurence Fishburne|Sam Bottoms,Francis Ford Coppola,153,Drama|War,1979-08-15,1100,7.8,1979,94643451,250794662,156151211,8
7827,2.012021,400000,100000000,99600000,Mad Max,Mel Gibson|Joanne Samuel|Hugh Keays-Byrne|Steve Bisley|Tim Burns,George Miller,93,Adventure|Action|Thriller|Science Fiction,1979-04-12,667,6.5,1979,1201821,300455400,299253579,6
7828,1.823058,35000000,139000000,104000000,Star Trek: The Motion Picture,William Shatner|Leonard Nimoy|George Takei|James Doohan|Walter Koenig,Robert Wise,132,Science Fiction|Adventure|Mystery,1979-12-06,304,6.0,1979,105159390,417633006,312473616,6
7829,1.691143,34000000,210300000,176300000,Moonraker,Roger Moore|Lois Chiles|Michael Lonsdale|Corinne ClÃ©ry|Richard Kiel,Lewis Gilbert,126,Action|Adventure|Thriller|Science Fiction,1979-06-26,299,5.7,1979,102154836,631857706,529702870,6
7830,1.465088,4000000,20045115,16045115,Life of Brian,Graham Chapman|John Cleese|Terry Gilliam|Eric Idle|Terry Jones,Terry Jones,94,Comedy,1979-08-16,716,7.5,1979,12018216,60226630,48208414,7
7833,1.049233,7000000,200182160,193182160,Rocky II,Sylvester Stallone|Talia Shire|Burt Young|Carl Weathers|Burgess Meredith,Sylvester Stallone,119,Drama,1979-06-15,504,6.8,1979,21031878,601458110,580426232,7
7834,0.973049,17500000,23438120,5938120,Caligola,Malcolm McDowell|Teresa Ann Savoy|Helen Mirren|Peter O'Toole|John Gielgud,Tinto Brass,156,Drama|History|Romance,1979-01-21,65,5.3,1979,52579695,70421097,17841402,5
7836,0.794667,300000,11988469,11688469,Phantasm,Angus Scrimm|A. Michael Baldwin|Bill Thornbury|Reggie Bannister|Kathy Lester,Don Coscarelli,89,Horror|Science Fiction,1979-03-28,50,6.1,1979,901366,36020002,35118636,6
7839,0.567776,8000000,43000000,35000000,Escape from Alcatraz,Clint Eastwood|Patrick McGoohan|Roberts Blossom|Jack Thibeau|Fred Ward,Don Siegel,111,Crime|Drama,1979-06-22,273,7.1,1979,24036432,129195822,105159390,7
7842,0.516927,20000000,35841901,15841901,The Black Hole,Maximilian Schell|Anthony Perkins|Robert Forster|Joseph Bottoms|Ernest Borgnine,Gary Nelson,98,Adventure|Family|Science Fiction|Action,1979-12-18,54,5.8,1979,60091080,107688927,47597847,6
7847,0.426947,14000000,13015688,-984312,The Concorde... Airport '79,Alain Delon|Susan Blakely|Robert Wagner|Sylvia Kristel|George Kennedy,David Lowell Rich,123,Action|Drama|Thriller,1979-08-17,23,4.7,1979,42063756,39106337,-2957419,5
7848,0.416453,8000000,106260000,98260000,Kramer vs. Kramer,Dustin Hoffman|Meryl Streep|Jane Alexander|Justin Henry|Howard Duff,Robert Benton,105,Drama,1979-12-19,240,7.3,1979,24036432,319263908,295227476,7
7851,0.387797,35000000,31755742,-3244258,1941,Dan Aykroyd|Ned Beatty|John Belushi|Lorraine Gary|Murray Hamilton,Steven Spielberg,113,Action|Comedy,1979-12-14,62,5.4,1979,105159390,95411841,-9747549,5
7854,0.307429,2300000,20000000,17700000,Breaking Away,Dennis Quaid|Daniel Stern|Jackie Earle Haley|Dennis Christopher|Barbara Barrie,Peter Yates,100,Drama|Comedy,1979-05-24,34,7.2,1979,6910474,60091080,53180606,7
7860,0.159632,2700000,37799643,35099643,The Black Stallion,Kelly Reno|Mickey Rooney|Teri Garr|Clarence Muse|Hoyt Axton,Carroll Ballard,118,Adventure|Family,1979-10-17,28,6.8,1979,8112295,113571068,105458773,7
7882,4.831966,6400000,78371200,71971200,The Terminator,Arnold Schwarzenegger|Michael Biehn|Linda Hamilton|Paul Winfield|Lance Henriksen,James Cameron,108,Action|Thriller|Science Fiction,1984-10-26,2692,7.1,1984,13433869,164504443,151070574,7
7883,2.556799,28000000,333000000,305000000,Indiana Jones and the Temple of Doom,Harrison Ford|Kate Capshaw|Jonathan Ke Quan|Amrish Puri|Roshan Seth,Steven Spielberg,118,Adventure|Action,1984-05-23,1735,6.9,1984,58773177,698980999,640207822,7
7884,2.484654,30000000,295212467,265212467,Ghostbusters,Bill Murray|Dan Aykroyd|Sigourney Weaver|Harold Ramis|Rick Moranis,Ivan Reitman,107,Fantasy|Action|Comedy|Science Fiction|Family,1984-06-07,1383,7.2,1984,62971261,619663378,556692117,7
7885,2.464803,11000000,153083102,142083102,Gremlins,Zach Galligan|Phoebe Cates|Hoyt Axton|Polly Holliday|Dick Miller,Joe Dante,106,Fantasy|Horror|Comedy,1984-06-07,844,6.8,1984,23089462,321327866,298238404,7
7886,2.183891,27000000,20158808,-6841192,The Neverending Story,Barret Oliver|Gerald McRaney|Noah Hathaway|Drum Garrett|Darryl Cooksey,Wolfgang Petersen,102,Drama|Family|Fantasy|Adventure,1984-04-05,484,6.8,1984,56674135,42314185,-14359950,7
7887,2.108338,15000000,316360478,301360478,Beverly Hills Cop,Eddie Murphy|Judge Reinhold|John Ashton|Ronny Cox|Paul Reiser,Martin Brest,105,Action|Comedy|Crime,1984-11-30,535,6.5,1984,31485630,664053942,632568312,6
7889,1.682283,18000000,51973029,33973029,Amadeus,F. Murray Abraham|Tom Hulce|Elizabeth Berridge|Roy Dotrice|Simon Callow,MiloÅ¡ Forman,160,Drama|History|Music,1984-10-26,560,7.5,1984,37782756,109093572,71310816,7
7890,1.508112,8000000,90815558,82815558,The Karate Kid,Ralph Macchio|Pat Morita|William Zabka|Martin Kove|Chad McQueen,John G. Avildsen,126,Drama,1984-06-22,475,6.7,1984,16792336,190625674,173833338,7
7891,1.331432,1800000,25504513,23704513,A Nightmare on Elm Street,John Saxon|Ronee Blakley|Heather Langenkamp|Amanda Wyss|Jsu Garcia,Wes Craven,91,Horror,1984-11-15,625,7.1,1984,3778275,53535044,49756769,7
7892,1.247659,18000000,31042035,13042035,Conan the Destroyer,Arnold Schwarzenegger|Grace Jones|Wilt Chamberlain|Tracey Walter|Mako,Richard Fleischer,103,Adventure|Fantasy|Action,1984-06-29,193,5.9,1984,37782756,65158536,27375780,6
7893,1.077574,28000000,40400657,12400657,2010,Roy Scheider|John Lithgow|Helen Mirren|Bob Balaban|Keir Dullea,Peter Hyams,116,Thriller|Science Fiction,1984-12-06,156,6.4,1984,58773177,84802677,26029500,6
7894,1.020675,40000000,30925690,-9074310,Dune,Kyle MacLachlan|Francesca Annis|Leonardo Cimino|Brad Dourif|JosÃ© Ferrer,David Lynch,137,Action|Science Fiction|Adventure,1984-12-14,294,6.5,1984,83961681,64914323,-19047358,6
7895,0.991867,10000000,86572238,76572238,Romancing the Stone,Michael Douglas|Kathleen Turner|Danny DeVito|Alfonso ArÃ¡u|Manuel Ojeda,Robert Zemeckis,106,Action|Adventure|Comedy|Romance,1984-03-30,245,6.3,1984,20990420,181718766,160728346,6
7896,0.9739,4500000,81198894,76698894,Police Academy,Steve Guttenberg|Kim Cattrall|G. W. Bailey|Bubba Smith|Donovan Scott,Hugh Wilson,96,Comedy|Crime,1984-03-22,270,6.3,1984,9445689,170439892,160994203,6
7898,0.82288,18000000,87000000,69000000,Star Trek III: The Search for Spock,William Shatner|Leonard Nimoy|DeForest Kelley|James Doohan|George Takei,Leonard Nimoy,105,Science Fiction|Action|Adventure|Thriller,1984-05-31,239,6.1,1984,37782756,182616657,144833901,6
7900,0.791148,8200000,80035402,71835402,Footloose,Kevin Bacon|John Lithgow|Dianne Wiest|Chris Penn|Lori Singer,Herbert Ross,107,Drama|Family|Music|Romance,1984-02-17,282,6.0,1984,17212144,167997673,150785529,6
7902,0.742001,1500000,2300000,800000,Repo Man,Harry Dean Stanton|Emilio Estevez|Tracey Walter|Olivia Barash|Sy Richardson,Alex Cox,92,Comedy|Drama|Science Fiction,1984-02-20,54,6.3,1984,3148563,4827796,1679233,6
7906,0.637446,22000000,28744356,6744356,Starman,Jeff Bridges|Karen Allen|Charles Martin Smith|Richard Jaeckel|Robert Phalen,John Carpenter,115,Action|Adventure|Drama|Romance|Science Fiction,1984-12-14,91,6.3,1984,46178924,60335611,14156687,6
7907,0.633247,6000000,38435947,32435947,Bachelor Party,Tom Hanks|Tawny Kitaen|Adrian Zmed|George Grizzard|Tracy Smith,Neal Israel,105,Comedy,1984-06-29,67,5.9,1984,12594252,80678668,68084416,6
7911,0.606839,6500000,23686027,17186027,Sixteen Candles,Molly Ringwald|Justin Henry|Michael Schoeffling|Haviland Morris|Gedde Watanabe,John Hughes,93,Comedy|Romance,1984-05-04,223,6.7,1984,13643773,49717966,36074193,7
7912,0.603541,14400000,34700291,20300291,The Killing Fields,Sam Waterston|Haing S. Ngor|Craig T. Nelson|John Malkovich|Athol Fugard,Roland JoffÃ©,141,War|Drama|History,1984-11-02,78,7.2,1984,30226205,72837369,42611164,7
7913,0.590922,3000000,14418922,11418922,Night of the Comet,Catherine Mary Stewart|Robert Beltran|Kelli Maroney|Sharon Farrell|Mary Woronov,Thom Eberhardt,95,Action|Comedy|Horror|Science Fiction|Thriller,1984-11-16,36,5.7,1984,6297126,30265923,23968797,6
7916,0.550313,15000000,28733290,13733290,The Last Starfighter,Lance Guest|Dan O'Herlihy|Catherine Mary Stewart|Barbara Bosson|Norman Snow,Nick Castle,101,Adventure|Science Fiction|Action,1984-07-13,101,6.1,1984,31485630,60312383,28826753,6
7918,0.539505,25000000,5778353,-19221647,Sheena,Tanya Roberts|Ted Wass|Donovan Scott|Elizabeth of Toro|France Zobda,John Guillermin,117,Adventure|Fantasy|Action|Comedy|Science Fiction,1984-08-17,10,4.8,1984,52476050,12129005,-40347045,5
7920,0.524253,8000000,69821334,61821334,Splash,Tom Hanks|Daryl Hannah|Eugene Levy|John Candy|Dody Goodman,Ron Howard,111,Comedy|Fantasy|Romance,1984-03-09,147,6.1,1984,16792336,146557915,129765579,6
7921,0.518436,1746964,2181987,435023,"Paris, Texas",Harry Dean Stanton|Nastassja Kinski|Dean Stockwell|Hunter Carson|Aurore ClÃ©ment,Wim Wenders,147,Drama,1984-05-19,146,7.4,1984,3666950,4580082,913132,7
7922,0.517691,10000000,8801940,-1198060,Body Double,Craig Wasson|Melanie Griffith|Gregg Henry|Deborah Shelton|Guy Boyd,Brian De Palma,114,Mystery|Thriller,1984-10-26,58,6.1,1984,20990420,18475642,-2514778,6
7924,0.504848,25000000,38348988,13348988,City Heat,Clint Eastwood|Burt Reynolds|Jane Alexander|Madeline Kahn|Rip Torn,Richard Benjamin,93,Action|Comedy|Crime,1984-12-05,24,5.2,1984,52476050,80496137,28020087,5
7927,0.491888,58000000,25928721,-32071279,The Cotton Club,Richard Gere|Diane Lane|Bob Hoskins|James Remar|Nicolas Cage,Francis Ford Coppola,127,Music|Drama|Crime|Romance,1984-12-14,37,6.1,1984,121744438,54425475,-67318963,6
7930,0.44653,9000000,20458340,11458340,Top Secret!,Val Kilmer|Lucy Gutteridge|Peter Cushing|Jeremy Kemp|Christopher Villiers,Jim Abrahams|David Zucker|Jerry Zucker,90,Comedy,1984-06-08,117,6.8,1984,18891378,42942915,24051537,7
7936,0.367406,7200000,68392977,61192977,Purple Rain,Prince|Apollonia Kotero|Morris Day|Olga Karlatos|Clarence Williams III,Albert Magnoli,111,Drama|Music|Romance,1984-07-27,39,6.9,1984,15113102,143559733,128446631,7
7938,0.36224,2550000,22812411,20262411,Missing in Action,Chuck Norris|M. Emmet Walsh|David Tress|Lenore Kasdorf|James Hong,Joseph Zito,101,Action|Adventure|Thriller|War,1984-11-16,50,5.1,1984,5352557,47884209,42531652,5
7940,0.351379,28000000,47951979,19951979,The Natural,Robert Redford|Glenn Close|Kim Basinger|Wilford Brimley|Robert Duvall,Barry Levinson,137,Drama,1984-05-11,74,6.8,1984,58773177,100653219,41880042,7
7942,0.361782,800000,14000000,13200000,Children of the Corn,Peter Horton|Linda Hamilton|R. G. Armstrong|John Franklin|Courtney Gains,Fritz Kiersch,93,Drama|Fantasy|Horror|Thriller,1984-03-09,106,5.6,1984,1679233,29386588,27707355,6
7946,0.329484,8000000,27187653,19187653,A Passage to India,Judy Davis|Alec Guinness|Peggy Ashcroft|James Fox|Victor Banerjee,David Lean,163,Drama|Adventure|History,1984-12-14,23,6.7,1984,16792336,57068026,40275690,7
7947,0.297597,14500000,8089290,-6410710,Streets of Fire,Michael ParÃ©|Diane Lane|Rick Moranis|Amy Madigan|Willem Dafoe,Walter Hill,93,Action|Thriller|Music,1984-06-01,48,6.7,1984,30436109,16979759,-13456350,7
7948,0.283191,1200000,4978922,3778922,Stop Making Sense,David Byrne|Tina Weymouth|Chris Frantz|Jerry Harrison|Steven Scales,Jonathan Demme,88,Documentary|Music,1984-11-16,23,8.4,1984,2518850,10450966,7932116,8
7968,0.197425,1250000,3412497,2162497,C.H.U.D.,John Heard|Daniel Stern|Christopher Curry|Kim Greist|Laure Mattos,Douglas Cheek,88,Horror|Science Fiction,1984-08-31,22,4.5,1984,2623802,7162974,4539172,4
7969,0.177006,1000000,35000000,34000000,Ghoulies,Peter Liapis|Lisa Pelikan|Jack Nance|Mariska Hargitay|Michael Des Barres,Luca Bercovici,81,Comedy|Horror|Fantasy,1984-11-08,22,3.6,1984,2099042,73466471,71367429,4
7971,0.174241,18000000,19265302,1265302,Best Defense,Dudley Moore|Eddie Murphy|Kate Capshaw|George Dzundza|Helen Shaver,Willard Huyck,94,Action|Comedy,1984-07-20,10,3.8,1984,37782756,40438678,2655922,4
7975,0.140026,5500000,801000,-4699000,Razorback,Gregory Harrison|Arkie Whiteley|Bill Kerr|Chris Haywood|David Argue,Russell Mulcahy,95,Horror,1984-04-19,13,5.6,1984,11544731,1681332,-9863399,6
7978,0.13399,8000000,10600497,2600497,Broadway Danny Rose,Woody Allen|Mia Farrow|Nick Apollo Forte|Craig Vandenburgh|Herb Reynolds,Woody Allen,84,Comedy,1984-01-27,41,6.6,1984,16792336,22250888,5458552,7
7987,4.828854,32350000,572700000,540350000,Return of the Jedi,Mark Hamill|Harrison Ford|Carrie Fisher|Billy Dee Williams|Anthony Daniels,Richard Marquand,135,Adventure|Action|Science Fiction,1983-05-23,3101,7.8,1983,70824243,1253818981,1182994738,8
7988,3.178818,25000000,65884703,40884703,Scarface,Al Pacino|Steven Bauer|Michelle Pfeiffer|Mary Elizabeth Mastrantonio|Robert Loggia,Brian De Palma,170,Action|Crime|Drama|Thriller,1983-12-08,1741,7.8,1983,54732799,144242170,89509371,8
7989,1.774018,36000000,160000000,124000000,Never Say Never Again,Sean Connery|Kim Basinger|Klaus Maria Brandauer|Barbara Carrera|Max von Sydow,Irvin Kershner,134,Adventure|Action|Thriller,1983-10-07,183,5.8,1983,78815231,350289919,271474688,6
7990,1.575742,27500000,183700000,156200000,Octopussy,Roger Moore|Maud Adams|Louis Jourdan|Kristina Wayborn|Kabir Bedi,John Glen,131,Adventure|Action|Thriller,1983-06-05,289,5.9,1983,60206079,402176613,341970534,6
7992,1.263139,39000000,75800000,36800000,Superman III,Christopher Reeve|Richard Pryor|Jackie Cooper|Marc McClure|Annette O'Toole,Richard Lester,125,Comedy|Action|Adventure|Fantasy|Science Fiction,1983-06-17,239,4.7,1983,85383167,165949849,80566682,5
7993,1.115139,40600000,90400000,49800000,Trading Places,Eddie Murphy|Dan Aykroyd|Jamie Lee Curtis|Denholm Elliott|Ralph Bellamy,John Landis,116,Comedy|Drama,1983-06-07,353,6.9,1983,88886067,197913804,109027737,7
7994,1.106471,12000000,79567667,67567667,WarGames,Matthew Broderick|Dabney Coleman|Ally Sheedy|John Wood|Barry Corbin,John Badham,114,Thriller|Science Fiction,1983-06-03,257,6.8,1983,26271743,174198447,147926704,7
7995,1.0684,15000000,61399552,46399552,National Lampoon's Vacation,Chevy Chase|Beverly D'Angelo|Imogene Coca|Randy Quaid|Anthony Michael Hall,Harold Ramis,98,Comedy|Adventure|Romance,1983-07-28,201,6.9,1983,32839679,134422775,101583096,7
7996,1.065331,20500000,87987055,67487055,Jaws 3,"Dennis Quaid|Bess Armstrong|Simon MacCorkindale|Louis Gossett, Jr.|John Putch",Joe Alves,99,Horror,1983-03-16,124,4.2,1983,44880895,192631115,147750220,4
8000,0.771263,22000000,67642693,45642693,Sudden Impact,Clint Eastwood|Sondra Locke|Pat Hingle|Bradford Dillman|Paul Drake,Clint Eastwood,117,Action|Crime|Thriller,1983-12-08,78,6.6,1983,48164863,148090959,99926096,7
8001,0.699455,6200000,63541777,57341777,Risky Business,Tom Cruise|Rebecca De Mornay|Joe Pantoliano|Richard Masur|Curtis Armstrong,Paul Brickman,98,Comedy|Romance,1983-08-05,164,6.3,1983,13573734,139112774,125539040,6
8002,0.675752999999999,27000000,21500000,-5500000,The Right Stuff,Fred Ward|Dennis Quaid|Ed Harris|Scott Glenn|Sam Shepard,Philip Kaufman,193,Drama|History,1983-10-21,120,7.2,1983,59111423,47070207,-12041216,7
8005,0.592218999999999,3000000,21000000,18000000,Mickey's Christmas Carol,Alan Young|Wayne Allwine|Clarence Nash|Hal Smith|Will Ryan,Burny Mattinson,26,Family|Animation,1983-10-19,89,7.4,1983,6567935,45975551,39407616,7
8009,0.554917,10000000,25697647,15697647,The Outsiders,Matt Dillon|Ralph Macchio|C. Thomas Howell|Patrick Swayze|Rob Lowe,Francis Ford Coppola,91,Crime|Drama,1983-03-25,134,6.8,1983,21893119,56260166,34367047,7
8010,0.543688,6500000,33759266,27259266,Porky's II: The Next Day,Dan Monahan|Wyatt Knight|Mark Herrier|Roger Wilson|Cyril O'Reilly,Bob Clark,98,Comedy,1983-06-24,25,4.9,1983,14230527,73909566,59679039,5
8015,0.478476,12000000,30400000,18400000,Yentl,Barbra Streisand|Mandy Patinkin|Amy Irving|Nehemiah Persoff|Steven Hill,Barbra Streisand,132,Music|Drama|Romance,1983-11-18,28,6.2,1983,26271743,66555084,40283341,6
8016,0.465858,22000000,42313354,20313354,Blue Thunder,Roy Scheider|Warren Oates|Candy Clark|Daniel Stern|Paul Roebling,John Badham,109,Science Fiction|Action|Thriller|Crime|Drama,1983-02-05,50,5.8,1983,48164863,92637133,44472270,6
8017,0.449475,10000000,20766616,10766616,The Dead Zone,Christopher Walken|Brooke Adams|Tom Skerritt|Martin Sheen|Herbert Lom,David Cronenberg,103,Thriller|Horror|Science Fiction,1983-10-21,128,6.5,1983,21893119,45464601,23571482,6
8023,0.343668,4000000,92921203,88921203,Flashdance,Jennifer Beals|Michael Nouri|Lilia Skala|Kyle T. Heffner|Sunny Johnson,Adrian Lyne,95,Drama|Music|Romance,1983-04-14,149,6.1,1983,8757247,203433504,194676257,6
8028,0.323585,10000000,29450919,19450919,Twilight Zone: The Movie,Albert Brooks|Vic Morrow|John Larroquette|John Lithgow|Dan Aykroyd,John Landis|Steven Spielberg|George Miller|Joe Dante,101,Drama|Fantasy|Horror|Science Fiction|Thriller,1983-06-24,63,6.0,1983,21893119,64477250,42584131,6
8032,0.311401,10000000,2494480,-7505520,Rumble Fish,Matt Dillon|Mickey Rourke|Diane Lane|Dennis Hopper|Diana Scarwid,Francis Ford Coppola,94,Action|Adventure|Crime|Drama|Romance,1983-10-21,60,6.3,1983,21893119,5461194,-16431925,6
8033,0.307082,22000000,64892670,42892670,Staying Alive,John Travolta|Cynthia Rhodes|Finola Hughes|Steve Inwood|Julie Bovasso,Sylvester Stallone,93,Drama|Action|Music|Romance,1983-07-11,46,4.8,1983,48164863,142070300,93905437,5
8034,0.290596,5000000,12232628,7232628,Lone Wolf McQuade,Chuck Norris|David Carradine|Barbara Carrera|Leon Isaac Kennedy|Dana Kimmell,Steve Carver,107,Action|Thriller|Drama|Western|Crime,1983-04-14,27,5.2,1983,10946559,26781039,15834480,5
8036,0.277865,5000000,34725000,29725000,Psycho II,Anthony Perkins|Vera Miles|Meg Tilly|Robert Loggia|Dennis Franz,Richard Franklin,113,Horror|Mystery|Thriller,1983-06-03,43,6.0,1983,10946559,76023859,65077300,6
8039,0.252008,5952000,2120439,-3831561,Videodrome,James Woods|Sonja Smits|Deborah Harry|Peter Dvorsky|Jack Creley,David Cronenberg,87,Horror|Mystery|Science Fiction,1983-02-04,180,6.8,1983,13030785,4642302,-8388483,7
8046,0.196581,1200000,760883,-439117,Fire and Ice,Randy Norton|Cynthia Leake|Steve Sandor|Sean Hannon|Leo Gordon,Ralph Bakshi,81,Animation|Fantasy|Science Fiction,1983-03-25,20,6.1,1983,2627174,1665810,-961364,6
8050,0.254523,15000000,10219460,-4780540,Brainstorm,Christopher Walken|Natalie Wood|Louise Fletcher|Cliff Robertson|Jason Lively,Douglas Trumbull,106,Science Fiction|Thriller,1983-09-30,28,6.2,1983,32839679,22373586,-10466093,6
8054,0.148192,6000000,3661757,-2338243,The Keep,Scott Glenn|Alberta Watson|JÃ¼rgen Prochnow|Robert Prosky|Gabriel Byrne,Michael Mann,96,Drama|Foreign|Horror,1983-12-16,16,5.3,1983,13135871,8016728,-5119143,5
8058,0.194675,19000000,5656087,-13343913,Something Wicked This Way Comes,Jason Robards|Jonathan Pryce|Diane Ladd|Royal Dano|Vidal Peterson,Jack Clayton,95,Fantasy|Mystery|Thriller,1983-04-29,16,6.3,1983,41596927,12382939,-29213988,6
8061,0.089401,425000,10604986,10179986,The House on Sorority Row,Kate McNeil|Eileen Davidson|Janis Ward|Robin Meloy|Harley Jane Kozak,Mark Rosman,91,Horror|Mystery|Thriller,1983-01-21,11,5.5,1983,930457,23217623,22287166,5
8066,0.015727,15000000,16500000,1500000,Spacehunter: Adventures in the Forbidden Zone,Peter Strauss|Molly Ringwald|Michael Ironside|Ernie Hudson|Deborah Pratt,Lamont Johnson,90,Adventure|Science Fiction,1983-05-20,17,5.1,1983,32839679,36123647,3283968,5
8067,4.76535899999999,33000000,327311859,294311859,Se7en,Brad Pitt|Morgan Freeman|Gwyneth Paltrow|John C. McGinley|Kevin Spacey,David Fincher,127,Crime|Mystery|Thriller,1995-09-22,3535,7.9,1995,47221906,468372425,421150519,8
8068,4.282462,30000000,361958736,331958736,Toy Story,Tom Hanks|Tim Allen|Don Rickles|Jim Varney|Wallace Shawn,John Lasseter,81,Animation|Comedy|Family,1995-10-30,3141,7.5,1995,42929006,517950958,475021952,7
8069,3.440238,6000000,23341568,17341568,The Usual Suspects,Stephen Baldwin|Gabriel Byrne|Chazz Palminteri|Kevin Pollak|Pete Postlethwaite,Bryan Singer,106,Drama|Crime|Thriller,1995-07-19,1942,8.0,1995,8585801,33401010,24815209,8
8070,2.533323,72000000,210000000,138000000,Braveheart,Mel Gibson|Catherine McCormack|Sophie Marceau|Patrick McGoohan|Angus Macfadyen,Mel Gibson,177,Action|Drama|History|War,1995-05-24,2205,7.5,1995,103029614,300503042,197473428,7
8071,2.440099,58000000,352194034,294194034,GoldenEye,Pierce Brosnan|Sean Bean|Izabella Scorupco|Famke Janssen|Joe Don Baker,Martin Campbell,130,Adventure|Action|Thriller,1995-11-16,741,6.4,1995,82996078,503977993,420981915,6
8072,2.245837,65000000,262797249,197797249,Jumanji,Robin Williams|Jonathan Hyde|Kirsten Dunst|Bradley Pierce|Bonnie Hunt,Joe Johnston,104,Adventure|Fantasy|Family,1995-12-15,1105,6.6,1995,93012846,376054156,283041310,7
8073,2.230236,90000000,366101666,276101666,Die Hard: With a Vengeance,Bruce Willis|Jeremy Irons|Samuel L. Jackson|Graham Greene|Colleen Camp,John McTiernan,128,Action|Thriller,1995-05-19,1358,6.7,1995,128787018,523879354,395092336,7
8074,2.216699,35000000,113000000,78000000,Species,Natasha Henstridge|Ben Kingsley|Michael Madsen|Alfred Molina|Forest Whitaker,Roger Donaldson,108,Science Fiction|Horror|Action,1995-07-07,225,5.2,1995,50083840,161699255,111615415,5
8075,2.206907,29500000,168840000,139340000,Twelve Monkeys,Bruce Willis|Madeleine Stowe|Brad Pitt|Christopher Plummer|David Morse,Terry Gilliam,129,Science Fiction|Thriller|Mystery,1995-12-29,1439,7.2,1995,42213522,241604445,199390923,7
8076,2.191608,52000000,355237933,303237933,Apollo 13,Tom Hanks|Bill Paxton|Kevin Bacon|Gary Sinise|Ed Harris,Ron Howard,140,Drama,1995-06-30,1002,7.1,1995,74410277,508333712,433923435,7
8077,1.964673,19000000,141407024,122407024,Bad Boys,Will Smith|Martin Lawrence|TÃ©a Leoni|TchÃ©ky Karyo|Joe Pantoliano,Michael Bay,118,Adventure|Drama|Action|Comedy|Thriller,1995-04-07,1134,6.4,1995,27188370,202348766,175160396,6
8078,1.913274,55000000,346079773,291079773,Pocahontas,Irene Bedard|Mel Gibson|David Ogden Stiers|John Kassir|Russell Means,Mike Gabriel|Eric Goldberg,81,Adventure|Animation|Drama|Family,1995-06-14,795,6.6,1995,78703177,495228688,416525511,7
8079,1.847583,60000000,187436818,127436818,Heat,Al Pacino|Robert De Niro|Val Kilmer|Jon Voight|Tom Sizemore,Michael Mann,171,Action|Crime|Drama|Thriller,1995-12-15,1104,7.5,1995,85858012,268215876,182357864,7
8080,1.706784,2500000,5535405,3035405,Before Sunrise,Ethan Hawke|Julie Delpy|Andrea Eckert|Hanno PÃ¶schl|Karl Bruckschwaiger,Richard Linklater,105,Drama|Romance,1995-01-27,554,7.6,1995,3577417,7920981,4343564,8
8081,1.649077,90000000,113493481,23493481,Judge Dredd,Sylvester Stallone|Diane Lane|Armand Assante|Rob Schneider|JÃ¼rgen Prochnow,Danny Cannon,96,Science Fiction,1995-06-30,339,5.2,1995,128787018,162405410,33618392,5
8082,1.59374,100000000,336529144,236529144,Batman Forever,Val Kilmer|Tommy Lee Jones|Jim Carrey|Nicole Kidman|Chris O'Donnell,Joel Schumacher,121,Science Fiction|Fantasy|Action|Crime,1995-05-31,868,5.2,1995,143096686,481562054,338465368,5
8083,1.552666,52000000,116112375,64112375,Casino,Robert De Niro|Sharon Stone|Joe Pesci|James Woods|Don Rickles,Martin Scorsese,178,Drama|Crime,1995-11-22,699,7.6,1995,74410277,166152961,91742684,8
8085,1.357131,30000000,254134910,224134910,Babe,Christine Cavanaugh|Miriam Margolyes|Danny Mann|Hugo Weaving|Miriam Flynn,Chris Noonan,89,Fantasy|Drama|Comedy|Family,1995-07-18,387,5.9,1995,42929006,363658635,320729629,6
8086,1.27600499999999,50000000,287928194,237928194,Casper,Christina Ricci|Bill Pullman|Cathy Moriarty|Eric Idle|Joe Nipote,Brad Silberling,100,Fantasy|Comedy|Family,1995-05-26,561,5.9,1995,71548343,412015705,340467362,6
8088,1.23489,4000000,4300000,300000,Four Rooms,Tim Roth|Antonio Banderas|Jennifer Beals|Madonna|Marisa Tomei,Allison Anders|Alexandre Rockwell|Robert Rodriguez|Quentin Tarantino,98,Comedy,1995-12-25,293,6.4,1995,5723867,6153157,429290,6
8089,1.232098,175000000,264218220,89218220,Waterworld,Kevin Costner|Chaim Girafi|Rick Aviles|R. D. Call|Zitto Kazann,Kevin Reynolds,135,Adventure|Action,1995-07-28,557,5.8,1995,250419201,378087518,127668317,6
8091,1.173211,30000000,212385533,182385533,Ace Ventura: When Nature Calls,Jim Carrey|Ian McNeice|Simon Callow|Maynard Eziashi|Bob Gunton,Steve Oedekerk,90,Comedy,1995-11-10,583,6.0,1995,42929006,303916660,260987654,6
8092,1.173191,24000000,182016617,158016617,The Bridges of Madison County,Meryl Streep|Clint Eastwood|Annie Corley|Victor Slezak|Jim Haynie,Clint Eastwood,135,Drama|Romance,1995-05-28,189,6.9,1995,34343204,260459748,226116544,7
8093,1.162695,3600000,49800000,46200000,Leaving Las Vegas,Nicolas Cage|Elisabeth Shue|Julian Sands|Richard Lewis|Steven Weber,Mike Figgis,112,Drama|Romance,1995-10-27,184,6.9,1995,5151480,71262149,66110669,7
8094,1.13661,22000000,1106279658,1084279658,The Net,Sandra Bullock|Jeremy Northam|Dennis Miller|Wendy Gazelle|Ken Howard,Irwin Winkler,114,Crime|Drama|Mystery|Thriller|Action,1995-07-28,201,5.6,1995,31481271,1583049536,1551568265,6
8096,1.085209,26000000,19075720,-6924280,Johnny Mnemonic,Keanu Reeves|Dina Meyer|Takeshi Kitano|Ice-T|Dolph Lundgren,Robert Longo,97,Adventure|Action|Drama|Science Fiction|Thriller,1995-05-26,182,5.3,1995,37205138,27296723,-9908415,5
8097,1.077787,7000000,25405445,18405445,Desperado,Antonio Banderas|Salma Hayek|Joaquim de Almeida|Cheech Marin|Steve Buscemi,Robert Rodriguez,104,Thriller|Action|Crime,1995-08-25,536,6.7,1995,10016768,36354350,26337582,7
8098,1.068338,17000000,182057016,165057016,While You Were Sleeping,Sandra Bullock|Bill Pullman|Peter Gallagher|Peter Boyle|Jack Warden,Jon Turteltaub,103,Comedy|Drama|Romance,1995-04-21,169,6.2,1995,24326436,260517557,236191121,6
8100,1.016022,20000000,21284514,1284514,To Die For,Nicole Kidman|Matt Dillon|Joaquin Phoenix|Casey Affleck|Illeana Douglas,Gus Van Sant,106,Fantasy|Drama|Comedy|Thriller,1995-05-20,76,6.4,1995,28619337,30457434,1838097,6
8101,0.986266,60000000,104324083,44324083,Under Siege 2: Dark Territory,Steven Seagal|Eric Bogosian|Everett McGill|Katherine Heigl|Morris Chestnut,Geoff Murphy,100,Action|Thriller,1995-07-13,95,5.6,1995,85858012,149284306,63426294,6
8102,0.981049,98000000,18517322,-79482678,Cutthroat Island,Geena Davis|Matthew Modine|Frank Langella|Maury Chaykin|Patrick Malahide,Renny Harlin,119,Action|Adventure,1995-12-22,54,6.1,1995,140234752,26497674,-113737078,6
8103,0.958991,18000000,122195920,104195920,Mortal Kombat,Christopher Lambert|Robin Shou|Linden Ashby|Cary-Hiroyuki Tagawa|Bridgette Wilson,Paul W.S. Anderson,101,Action|Fantasy,1995-08-18,229,5.4,1995,25757403,174858312,149100909,5
8104,0.947883,16500000,135000000,118500000,Sense and Sensibility,Kate Winslet|Emma Thompson|Hugh Grant|Tom Wilkinson|Alan Rickman,Ang Lee,136,Drama|Romance,1995-12-13,185,7.1,1995,23610953,193180527,169569574,7
8105,0.938457,10000000,26488734,16488734,Billy Madison,Adam Sandler|Darren McGavin|Bridgette Wilson|Bradley Whitford|Josh Mostel,Tamra Davis,89,Comedy,1995-02-10,237,6.2,1995,14309668,37904500,23594832,6
8106,0.932073,15000000,66000000,51000000,Mighty Morphin Power Rangers: The Movie,Jason David Frank|Karan Ashley|Johnny Yong Bosch|Steve Cardenas|Amy Jo Johnson,Bryan Spicer,92,Action|Adventure|Science Fiction|Family|Fantasy,1995-06-30,78,5.3,1995,21464503,94443813,72979310,5
8107,0.90178,30250000,115101622,84851622,Get Shorty,John Travolta|Gene Hackman|Rene Russo|Danny DeVito|Dennis Farina,Barry Sonnenfeld,105,Comedy|Thriller|Crime,1995-10-20,139,6.1,1995,43286747,164706607,121419860,6
8108,0.888985,50000000,30303072,-19696928,Assassins,Sylvester Stallone|Antonio Banderas|Julianne Moore|Anatoli Davydov|Muse Watson,Richard Donner,132,Action|Adventure|Crime|Thriller,1995-10-06,204,5.8,1995,71548343,43362692,-28185651,6
8109,0.875995,32000000,18552460,-13447540,The Quick and the Dead,Sharon Stone|Gene Hackman|Russell Crowe|Leonardo DiCaprio|Tobin Bell,Sam Raimi,107,Action|Adventure|Drama|Thriller|Western,1995-02-09,221,6.2,1995,45790939,26547955,-19242984,6
8114,0.807589999999999,25000000,6600000,-18400000,Tank Girl,Lori Petty|Ice-T|Naomi Watts|Malcolm McDowell|Iggy Pop,Rachel Talalay,98,Action|Fantasy|Comedy|Science Fiction,1995-03-31,64,5.5,1995,35774171,9444381,-26329790,5
8115,0.805549,3500000,28215918,24715918,Friday,Ice Cube|Chris Tucker|Nia Long|Tommy 'Tiny' Lister|John Witherspoon,F. Gary Gray,91,Comedy|Drama,1995-04-26,294,7.0,1995,5008384,40376043,35367659,7
8116,0.804711,11000000,39363635,28363635,Dead Man Walking,Susan Sarandon|Sean Penn|Robert Prosky|Raymond J. Barry|R. Lee Ermey,Tim Robbins,122,Drama,1995-12-29,144,7.1,1995,15740635,56328057,40587422,7
8117,0.788698999999999,53000000,157387195,104387195,Crimson Tide,Denzel Washington|Gene Hackman|Matt Craven|George Dzundza|Viggo Mortensen,Tony Scott,116,Action|Thriller|Drama,1995-05-12,295,6.8,1995,75841243,225215861,149374618,7
8118,0.77385,45000000,20350754,-24649246,Showgirls,Elizabeth Berkley|Gina Gershon|Gina Ravera|Kyle MacLachlan|Glenn Plummer,Paul Verhoeven,128,Drama,1995-09-22,101,5.3,1995,64393509,29121254,-35272255,5
8119,0.773291,15000000,6700000,-8300000,Mighty Aphrodite,Woody Allen|Mira Sorvino|Helena Bonham Carter|F. Murray Abraham|Donald Symington,Woody Allen,95,Comedy|Romance,1995-09-13,61,6.5,1995,21464503,9587478,-11877025,6
8121,0.760076,20000000,50012507,30012507,A Walk in the Clouds,Keanu Reeves|Aitana SÃ¡nchez-GijÃ³n|Anthony Quinn|AngÃ©lica AragÃ³n|Evangelina Elizondo,Alfonso ArÃ¡u,103,Drama|Romance,1995-08-11,86,6.5,1995,28619337,71566240,42946903,6
8124,0.726743,30000000,24048000,-5952000,Virtuosity,Denzel Washington|Russell Crowe|Kelly Lynch|William Forsythe|Stephen Spinella,Brett Leonard,106,Action|Crime|Science Fiction|Thriller,1995-08-04,79,5.4,1995,42929006,34411891,-8517115,5
8125,0.705828,8,16,8,The Prophecy,Christopher Walken|Elias Koteas|Virginia Madsen|Eric Stoltz|Adam Goldberg,Gregory Widen,98,Fantasy|Horror|Thriller,1995-09-01,54,5.5,1995,11,22,11,5
8128,0.673425,60000000,35431113,-24568887,Money Train,Wesley Snipes|Woody Harrelson|Jennifer Lopez|Robert Blake|Chris Cooper,Joseph Ruben,103,Action|Comedy|Crime,1995-11-21,113,5.2,1995,85858012,50700748,-35157264,5
8130,0.640868999999999,28000000,31596911,3596911,Rob Roy,Liam Neeson|Jessica Lange|John Hurt|Tim Roth|Eric Stoltz,Michael Caton-Jones,139,Adventure,1995-04-13,72,6.2,1995,40067072,45214132,5147060,6
8132,0.623009,20000000,7563728,-12436272,Hackers,Jonny Lee Miller|Angelina Jolie|Jesse Bradford|Matthew Lillard|Renoly Santiago,Iain Softley,107,Action|Crime|Thriller|Drama,1995-09-14,238,6.4,1995,28619337,10823444,-17795893,6
8134,0.604331,44000000,13681765,-30318235,Nixon,Anthony Hopkins|Joan Allen|Powers Boothe|Ed Harris|Bob Hoskins,Oliver Stone,192,History|Drama,1995-12-22,30,6.3,1995,62962542,19578152,-43384390,6
8136,0.602056,55000000,127600435,72600435,First Knight,Sean Connery|Richard Gere|Julia Ormond|Ben Cross|Liam Cunningham,Jerry Zucker,134,Action|Adventure|Drama|Romance,1995-07-07,172,5.8,1995,78703177,182591994,103888817,6
8137,0.592518999999999,21000000,23450000,2450000,Boys on the Side,Whoopi Goldberg|Mary-Louise Parker|Drew Barrymore|Matthew McConaughey|James Remar,Herbert Ross,115,Comedy|Drama,1995-02-03,25,5.8,1995,30050304,33556173,3505869,6
8138,0.578548,5000000,15116634,10116634,Halloween: The Curse of Michael Myers,Donald Pleasence|Paul Rudd|Marianne Hagan|Mitchell Ryan|Kim Darby,Joe Chappelle,88,Horror|Thriller,1995-09-29,80,5.1,1995,7154834,21631402,14476568,5
8139,0.577143,50000000,11534477,-38465523,Fair Game,William Baldwin|Cindy Crawford|Steven Berkoff|Christopher McDonald|Miguel Sandoval,Andrew Sipes,91,Action|Thriller|Romance,1995-11-03,26,4.1,1995,71548343,16505454,-55042889,4
8142,0.552091,6000000,2,-5999998,Mallrats,Jason Lee|Jeremy London|Shannen Doherty|Claire Forlani|Ben Affleck,Kevin Smith,94,Romance|Comedy,1995-10-20,201,6.8,1995,8585801,2,-8585799,7
8144,0.551631,62000000,107879496,45879496,The American President,Michael Douglas|Annette Bening|Michael J. Fox|Martin Sheen|Anna Deavere Smith,Rob Reiner,106,Comedy|Drama|Romance,1995-11-17,104,6.6,1995,88719945,154371984,65652039,7
8146,0.538475,11000000,178104,-10821896,Canadian Bacon,John Candy|Alan Alda|Rhea Perlman|Kevin Pollak|Rip Torn,Michael Moore,91,Action|Comedy,1995-06-08,16,5.2,1995,15740635,254860,-15485775,5
8148,0.526485,42000000,7959291,-34040709,Strange Days,Ralph Fiennes|Angela Bassett|Tom Sizemore|Juliette Lewis|Vincent D'Onofrio,Kathryn Bigelow,145,Crime|Drama|Science Fiction|Thriller,1995-10-13,150,6.5,1995,60100608,11389481,-48711127,6
8149,0.525474,500000,1148752,648752,Living in Oblivion,Steve Buscemi|Catherine Keener|Dermot Mulroney|James Le Gros|Peter Dinklage,Tom DiCillo,89,Drama|Comedy,1995-01-20,23,6.9,1995,715483,1643826,928343,7
8152,0.508901,8169363,8175346,5983,Nick of Time,Johnny Depp|Courtney Chase|Charles S. Dutton|Christopher Walken|Roma Maffia,John Badham,90,Crime|Drama|Thriller,1995-11-22,91,6.0,1995,11690087,11698649,8562,6
8154,0.489975,7000000,8349430,1349430,Smoke,Harvey Keitel|William Hurt|Giancarlo Esposito|JosÃ© ZÃºÃ±iga|Stephen Gevedon,Wayne Wang|Paul Auster,112,Comedy|Drama,1995-06-09,41,6.8,1995,10016768,11947757,1930989,7
8160,0.460215,20000000,5781885,-14218115,Screamers,Peter Weller|Roy Dupuis|Jennifer Rubin|Andrew Lauer|Liliana Komorowska,Christian Duguay,108,Horror|Science Fiction,1995-09-08,63,5.9,1995,28619337,8273685,-20345652,6
8164,0.446622,1500000,7412216,5912216,Kids,Leo Fitzpatrick|Rosario Dawson|ChloÃ« Sevigny|Justin Pierce|Sajan Bhagat,Larry Clark,91,Drama|Crime,1995-07-28,141,6.7,1995,2146450,10606635,8460185,7
8165,0.443718,17000000,7603766,-9396234,Losing Isaiah,Jessica Lange|Halle Berry|David Strathairn|Samuel L. Jackson|Cuba Gooding Jr.,Stephen Gyllenhaal,106,Drama,1995-03-17,12,6.5,1995,24326436,10880737,-13445699,6
8170,0.407454,50000000,9851610,-40148390,Jade,David Caruso|Linda Fiorentino|Chazz Palminteri|Michael Biehn|Richard Crenna,William Friedkin,95,Action|Thriller|Mystery|Romance,1995-10-13,22,5.4,1995,71548343,14097327,-57451016,5
8178,0.378093,14000000,19800000,5800000,Vampire in Brooklyn,Eddie Murphy|Angela Bassett|Allen Payne|Kadeem Hardison|John Witherspoon,Wes Craven,100,Comedy|Horror|Romance,1995-10-27,45,4.5,1995,20033536,28333143,8299607,4
8179,0.376857,35000000,64350171,29350171,Sudden Death,Jean-Claude Van Damme|Powers Boothe|Dorian Harewood|Raymond J. Barry|Ross Malinger,Peter Hyams,106,Action|Adventure|Thriller,1995-12-22,85,5.4,1995,50083840,92082962,41999122,5
8181,0.360204,8000000,529766,-7470234,Things to Do in Denver When You're Dead,Andy GarcÃ­a|Christopher Lloyd|William Forsythe|Bill Nunn|Treat Williams,Gary Fleder,116,Drama|Crime,1995-12-01,26,6.3,1995,11447734,758077,-10689657,6
8188,0.327558,50000000,152000000,102000000,Congo,Laura Linney|Dylan Walsh|Ernie Hudson|Tim Curry|Grant Heslov,Frank Marshall,109,Action|Adventure|Drama|Mystery|Science Fiction,1995-06-09,100,4.8,1995,71548343,217506963,145958620,5
8198,0.307976,50000000,10382407,-39617593,The Scarlet Letter,Demi Moore|Gary Oldman|Robert Duvall|Robert Prosky|Edward Hardwicke,Roland JoffÃ©,135,Drama|History|Romance,1995-10-13,61,5.3,1995,71548343,14856880,-56691463,5
8199,0.298783,27000000,16140822,-10859178,Devil in a Blue Dress,Denzel Washington|Tom Sizemore|Jennifer Beals|Don Cheadle|Maury Chaykin,Carl Franklin,102,Drama|Mystery|Thriller,1995-09-15,43,6.1,1995,38636105,23096981,-15539124,6
8207,0.275609,12000000,27400000,15400000,Now and Then,Christina Ricci|Rosie O'Donnell|Thora Birch|Melanie Griffith|Gaby Hoffmann,Lesli Linka Glatter,100,Comedy|Drama|Family,1995-10-20,41,6.3,1995,17171602,39208492,22036890,6
8220,0.200906,16000000,81452156,65452156,Waiting to Exhale,Whitney Houston|Angela Bassett|Loretta Devine|Lela Rochon|Gregory Hines,Forest Whitaker,127,Comedy|Drama|Romance,1995-12-22,18,6.1,1995,22895469,116555336,93659867,6
8222,0.194078,35000000,15000000,-20000000,Le Hussard sur le toit,Juliette Binoche|Olivier Martinez|Pierre Arditi|FranÃ§ois Cluzet|GÃ©rard Depardieu,Jean-Paul Rappeneau,135,War|Adventure|Drama|Romance,1995-09-20,17,6.4,1995,50083840,21464503,-28619337,6
8224,0.189446,10000000,23574130,13574130,How To Make An American Quilt,Winona Ryder|Anne Bancroft|Ellen Burstyn|Kate Nelligan|Jean Simmons,Jocelyn Moorhouse,116,Drama|Romance,1995-10-06,16,6.6,1995,14309668,33733798,19424130,7
8225,0.18332,28000000,3983912,-24016088,The Pebble and the Penguin,Martin Short|Annie Golden|Jim Belushi|Tim Curry|Alissa King,Don Bluth|Gary Goldman,74,Animation|Adventure|Family,1995-04-11,11,4.8,1995,40067072,5700846,-34366226,5
8226,0.183034,6400000,6,-6399994,Never Talk to Strangers,Rebecca De Mornay|Antonio Banderas|Dennis Miller|Len Cariou|Martha Burns,Peter Hall,86,Thriller|Romance,1995-10-20,15,4.5,1995,9158187,8,-9158179,4
8229,0.141747,25000000,13071518,-11928482,Clockers,Harvey Keitel|John Turturro|Delroy Lindo|Mekhi Phifer|Isaiah Washington,Spike Lee,128,Mystery|Crime|Drama,1995-09-15,26,6.7,1995,35774171,18704909,-17069262,7
8235,0.105894,6,11,5,Tales from the Hood,Clarence Williams III|Corbin Bernsen|David Alan Grier|Wings Hauser|Duane Whitaker,Rusty Cundieff,98,Horror|Thriller,1995-05-24,13,5.1,1995,8,15,7,5
8241,0.018196,6000000,5093707,-906293,Top Dog,Chuck Norris|Michele Lamar Richards|Carmine Caridi|Clyde Kusatsu|Kai Wulff,Aaron Norris,86,Action|Adventure|Comedy|Family|Thriller,1995-04-28,10,4.7,1995,8585801,7288925,-1296876,5
8242,4.586426,1200000,14661007,13461007,Reservoir Dogs,Harvey Keitel|Tim Roth|Michael Madsen|Chris Penn|Steve Buscemi,Quentin Tarantino,99,Crime|Thriller,1992-06-25,2018,7.9,1992,1864829,22783560,20918731,8
8243,3.966538,28000000,504050219,476050219,Aladdin,Scott Weinger|Robin Williams|Linda Larkin|Jonathan Freeman|Frank Welker,Ron Clements|John Musker,90,Animation|Family|Comedy|Adventure|Fantasy,1992-11-25,2121,7.3,1992,43512679,783306265,739793586,7
8244,3.822939,18000000,358991681,340991681,Home Alone 2: Lost In New York,Macaulay Culkin|Joe Pesci|Catherine O'Hara|Daniel Stern|John Heard,Chris Columbus,120,Comedy|Family|Adventure|Crime,1992-11-19,1426,6.2,1992,27972436,557881779,529909343,6
8245,2.248239,80000000,280000000,200000000,Batman Returns,Michael Keaton|Danny DeVito|Michelle Pfeiffer|Christopher Walken|Michael Gough,Tim Burton,126,Action|Crime|Fantasy|Science Fiction|Thriller,1992-06-19,922,6.5,1992,124321940,435126791,310804851,6
8246,1.919148,50000000,159773545,109773545,AlienÂ³,Sigourney Weaver|Charles S. Dutton|Charles Dance|Pete Postlethwaite|Ralph Brown,David Fincher,114,Science Fiction|Action|Horror,1992-05-22,850,6.0,1992,77701212,248291964,170590752,6
8247,1.574949,35000000,321731527,286731527,Lethal Weapon 3,Mel Gibson|Danny Glover|Joe Pesci|Rene Russo|Stuart Wilson,Richard Donner,118,Adventure|Action|Comedy|Thriller|Crime,1992-05-15,468,6.1,1992,54390848,499978596,445587748,6
8248,1.432653,40000000,215862692,175862692,Dracula,Gary Oldman|Winona Ryder|Anthony Hopkins|Keanu Reeves|Richard E. Grant,Francis Ford Coppola,128,Romance|Horror,1992-11-13,545,6.8,1992,62160970,335455859,273294889,7
8250,1.283709,35000000,156563139,121563139,Under Siege,Steven Seagal|Tommy Lee Jones|Gary Busey|Erika Eleniak|Patrick O'Neal,Andrew Davis,103,Action|Thriller,1992-10-09,204,5.9,1992,54390848,243302915,188912067,6
8252,1.199355,40000000,243240178,203240178,A Few Good Men,Tom Cruise|Jack Nicholson|Demi Moore|Kevin Bacon|Kiefer Sutherland,Rob Reiner,138,Drama|Thriller,1992-12-11,502,6.9,1992,62160970,378001136,315840166,7
8253,1.16983,20000000,121697323,101697323,Wayne's World,Mike Myers|Dana Carvey|Rob Lowe|Tia Carrere|Lara Flynn Boyle,Penelope Spheeris,94,Comedy,1992-02-14,421,6.5,1992,31080485,189120591,158040106,6
8255,1.070577,49000000,352927224,303927224,Basic Instinct,Michael Douglas|Sharon Stone|George Dzundza|Jeanne Tripplehorn|Denis Arndt,Paul Verhoeven,127,Thriller|Mystery,1992-03-20,444,6.4,1992,76147188,548457466,472310278,6
8257,0.980566,12500000,10725228,-1774772,Glengarry Glen Ross,Al Pacino|Jack Lemmon|Alec Baldwin|Alan Arkin|Ed Harris,James Foley,100,Crime|Drama|Mystery,1992-09-15,148,7.2,1992,19425303,16667264,-2758039,7
8258,0.964004,40000000,58662452,18662452,Honey I Blew Up the Kid,Rick Moranis|Marcia Strassman|Robert Oliveri|Daniel Shalikar|Joshua Shalikar,Randal Kleiser,89,Adventure|Comedy|Family|Science Fiction,1992-07-16,131,4.8,1992,62160970,91162873,29001903,5
8260,0.851712,1000000,2019469,1019469,Bad Lieutenant,Harvey Keitel|Victor Argo|Frankie Thorn|Robin Burrows|Paul Calderon,Abel Ferrara,96,Crime|Drama,1992-09-16,63,6.3,1992,1554024,3138303,1584279,6
8261,0.841579999999999,14000000,159157447,145157447,Unforgiven,Clint Eastwood|Gene Hackman|Morgan Freeman|Richard Harris|Jaimz Woolvett,Clint Eastwood,131,Western,1992-08-07,602,7.5,1992,21756339,247334532,225578193,7
8262,0.834109,31000000,231605150,200605150,Sister Act,Whoopi Goldberg|Maggie Smith|Kathy Najimy|Wendy Makkena|Mary Wickes,Emile Ardolino,100,Music|Comedy,1992-05-28,320,6.2,1992,48174751,359920020,311745269,6
8264,0.782091,47000000,7191399,-39808601,1492: Conquest of Paradise,GÃ©rard Depardieu|Armand Assante|Sigourney Weaver|Loren Dean|Ãngela Molina,Ridley Scott,154,Action|Adventure|Drama|History,1992-10-09,81,6.1,1992,73039139,11175608,-61863531,6
8265,0.776089,8000000,17092453,9092453,Pet Sematary II,Edward Furlong|Anthony Edwards|Clancy Brown|Jared Rushton|Sarah Trigger,Mary Lambert,100,Horror,1992-08-28,50,5.0,1992,12432194,26562086,14129892,5
8266,0.775666,31000000,134095253,103095253,Scent of a Woman,Al Pacino|Chris O'Donnell|James Rebhorn|Gabrielle Anwar|Philip Seymour Hoffman,Martin Brest,157,Drama,1992-12-23,435,7.1,1992,48174751,208387275,160212524,7
8267,0.767389,15000000,44065653,29065653,Passenger 57,Wesley Snipes|Bruce Payne|Tom Sizemore|Alex Datcher|Bruce Greenwood,Kevin Hooks,84,Action|Adventure|Thriller,1992-11-05,138,5.4,1992,23310363,68479093,45168730,5
8268,0.766646,3000000,242623,-2757377,Braindead,Tim Balme|Diana PeÃ±alver|Elizabeth Moody|Ian Watkin|Brenda Kendall,Peter Jackson,104,Horror|Comedy,1992-08-13,166,7.4,1992,4662072,377042,-4285030,7
8269,0.751681,8000000,6739141,-1260859,Fortress,"Christopher Lambert|Kurtwood Smith|Loryn Locklin|Clifton Collins, Jr.|Jeffrey Combs",Stuart Gordon,95,Action|Thriller|Science Fiction,1992-09-30,78,5.4,1992,12432194,10472788,-1959406,5
8271,0.740663,25000000,411006740,386006740,The Bodyguard,Whitney Houston|Kevin Costner|Michele Lamar Richards|Ralph Waite|Gary Kemp,Mick Jackson,129,Thriller|Action|Drama|Music|Romance,1992-11-25,338,6.1,1992,38850606,638714442,599863836,6
8277,0.685325,45000000,178051587,133051587,Patriot Games,Harrison Ford|Anne Archer|Patrick Bergin|Thora Birch|James Fox,Phillip Noyce,117,Drama|Action|Thriller|Crime,1992-06-04,219,6.0,1992,69931091,276696484,206765393,6
8278,0.682353,10000000,50752337,40752337,The Mighty Ducks,Emilio Estevez|Joss Ackland|Lane Smith|Heidi Kling|Josef Sommer,Stephen Herek,101,Comedy|Family,1992-10-01,101,6.5,1992,15540242,78870362,63330120,6
8279,0.67938,10000000,4160851,-5839149,Twin Peaks: Fire Walk with Me,Sheryl Lee|Ray Wise|MÃ¤dchen Amick|Dana Ashbrook|Phoebe Augustine,David Lynch,125,Drama|Mystery,1992-05-01,140,6.8,1992,15540242,6466063,-9074179,7
8280,0.675696,8000000,21706101,13706101,The Player,Tim Robbins|Greta Scacchi|Fred Ward|Whoopi Goldberg|Peter Gallagher,Robert Altman,124,Comedy|Drama,1992-04-03,75,6.4,1992,12432194,33731807,21299613,6
8281,0.651726,5000000,12534961,7534961,Hellraiser III: Hell on Earth,Kevin Bernhardt|Terry Farrell|Ken Carpenter|Doug Bradley|Paula Marshall,Anthony Hickox,93,Horror|Thriller|War,1992-09-11,64,5.1,1992,7770121,19479633,11709512,5
8282,0.648937,34000000,48169908,14169908,Malcolm X,"Denzel Washington|Angela Bassett|Albert Hall|Al Freeman, Jr.|Delroy Lindo",Spike Lee,202,Drama|History,1992-11-18,201,7.0,1992,52836824,74857205,22020381,7
8287,0.566939,40000000,75505856,35505856,The Last of the Mohicans,Daniel Day-Lewis|Madeleine Stowe|Russell Means|Eric Schweig|Jodhi May,Michael Mann,112,Action|Adventure|Drama|History|Romance,1992-09-25,422,6.8,1992,62160970,117337931,55176961,7
8288,0.548647999999999,220000,2040920,1820920,El Mariachi,Carlos Gallardo|Jaime de Hoyos|Peter Marquardt|Reinol Martinez|Ramiro Gomez,Robert Rodriguez,81,Action|Crime|Thriller,1992-09-04,116,6.5,1992,341885,3171639,2829754,6
8289,0.539261,11700000,88036683,76336683,The Hand that Rocks the Cradle,Annabella Sciorra|Rebecca De Mornay|Matt McCoy|Ernie Hudson|Madeline Zima,Curtis Hanson,110,Drama|Thriller,1992-01-10,79,6.4,1992,18182083,136811140,118629057,6
8290,0.529727,5000000,1862805,-3137195,Bitter Moon,Hugh Grant|Kristin Scott Thomas|Emmanuelle Seigner|Peter Coyote|Victor Banerjee,Roman Polanski,139,Thriller|Drama|Romance,1992-09-02,52,6.9,1992,7770121,2894844,-4875277,7
8294,0.499566,27000000,14683921,-12316079,City of Joy,Patrick Swayze|Om Puri|Pauline Collins|Shabana Azmi|Ayesha Dharker,Roland JoffÃ©,132,Drama,1992-04-15,17,6.4,1992,41958654,22819169,-19139485,6
8299,0.467233,40000000,107458785,67458785,A League of Their Own,Tom Hanks|Geena Davis|Madonna|Lori Petty|Jon Lovitz,Penny Marshall,128,Comedy|Drama|Family,1992-07-01,185,6.6,1992,62160970,166993558,104832588,7
8302,0.440854,11000000,64088552,53088552,My Cousin Vinny,Joe Pesci|Ralph Macchio|Marisa Tomei|Mitchell Whitfield|Fred Gwynne,Jonathan Lynn,120,Comedy|Drama,1992-03-13,182,7.0,1992,17094266,99595164,82500898,7
8304,0.420957,3705538,62548947,58843409,The Crying Game,Stephen Rea|Jaye Davidson|Miranda Richardson|Forest Whitaker|Adrian Dunbar,Neil Jordan,112,Romance|Crime|Drama|Thriller,1992-09-02,67,6.7,1992,5758495,97202580,91444085,7
8306,0.410039,40000000,70100000,30100000,Boomerang,Eddie Murphy|Robin Givens|Halle Berry|David Alan Grier|Grace Jones,Reginald Hudlin,117,Drama|Comedy|Romance,1992-06-30,69,5.5,1992,62160970,108937100,46776130,5
8307,0.382463,10000000,32101000,22101000,The Lawnmower Man,Jeff Fahey|Pierce Brosnan|Jenny Wright|Mark Bringelson|Geoffrey Lewis,Brett Leonard,108,Horror|Thriller|Science Fiction,1992-03-05,82,5.2,1992,15540242,49885732,34345490,5
8308,0.397495,6000000,25792310,19792310,Candyman,Virginia Madsen|Tony Todd|Xander Berkeley|Kasi Lemmons|Vanessa Williams,Bernard Rose,99,Drama|Horror|Thriller,1992-10-16,111,6.0,1992,9324145,40081875,30757730,6
8313,0.367997,23000000,57138719,34138719,Unlawful Entry,Kurt Russell|Ray Liotta|Madeleine Stowe|Roger E. Mosley|Ken Lerner,Jonathan Kaplan,117,Crime|Thriller,1992-06-26,25,5.6,1992,35742557,88794955,53052398,6
8314,0.437072999999999,24000000,22518097,-1481903,Captain Ron,Kurt Russell|Martin Short|Mary Kay Place|Benjamin Salisbury|Meadow Sisto,Thom Eberhardt,100,Action|Adventure|Comedy|Family,1992-09-18,29,5.8,1992,37296582,34993668,-2302914,6
8315,0.354374,40000000,14358033,-25641967,Memoirs of an Invisible Man,Chevy Chase|Daryl Hannah|Sam Neill|Michael McKean|Stephen Tobolowsky,John Carpenter,99,Action|Comedy|Drama|Fantasy|Science Fiction,1992-02-28,58,5.3,1992,62160970,22312731,-39848239,5
8318,0.346362,10000000,14356479,4356479,Rapid Fire,Brandon Lee|Powers Boothe|Nick Mancuso|Raymond J. Barry|Kate Hodge,Dwight H. Little,95,Action|Thriller,1992-07-24,18,6.2,1992,15540242,22310316,6770074,6
8323,0.309976,60000000,137783840,77783840,Far and Away,Tom Cruise|Nicole Kidman|Thomas Gibson|Robert Prosky|Barbara Babcock,Ron Howard,140,Adventure|Drama|Romance|Western,1992-05-22,153,6.2,1992,93241455,214119429,120877974,6
8324,0.303912,35000000,4651977,-30348023,Radio Flyer,Elijah Wood|Lorraine Bracco|Adam Baldwin|John Heard|Joseph Mazzello,Richard Donner,114,Drama,1992-02-21,26,6.3,1992,54390848,7229285,-47161563,6
8325,0.296309,5000000,20146880,15146880,Juice,Omar Epps|Tupac Shakur|Khalil Kain|Jermaine 'Huggy' Hopkins|Samuel L. Jackson,Ernest R. Dickerson,96,Action|Crime|Drama|Thriller,1992-01-17,55,7.1,1992,7770121,31308740,23538619,7
8327,0.294331,10000000,8359717,-1640283,Seong lung wui,Jackie Chan|Maggie Cheung|Nina Li Chi|Teddy Robin Kwan|James Wong Jim,Ringo Lam|Tsui Hark,89,Action|Comedy|Foreign,1992-01-15,40,6.3,1992,15540242,12991202,-2549040,6
8330,0.278857,16000000,48017402,32017402,Single White Female,Bridget Fonda|Jennifer Jason Leigh|Steven Weber|Peter Friedman|Stephen Tobolowsky,Barbet Schroeder,107,Thriller,1992-08-14,60,6.0,1992,24864388,74620207,49755819,6
8342,0.220131,20000000,11390479,-8609521,Jennifer Eight,Andy GarcÃ­a|Lance Henriksen|Uma Thurman|Graham Beckel|Kathy Baker,Bruce Robinson,124,Crime|Drama|Mystery,1992-11-06,34,5.6,1992,31080485,17701080,-13379405,6
8350,0.089502,17000000,4836637,-12163363,Diggstown,"James Woods|Louis Gossett, Jr.|Bruce Dern|Oliver Platt|Heather Graham",Michael Ritchie,98,Action|Comedy|Drama,1992-08-14,11,6.3,1992,26418412,7516251,-18902161,6
8352,0.47175,12000000,37170057,25170057,Raising Cain,John Lithgow|Lolita Davidovich|Steven Bauer|Frances Sternhagen|Gregg Henry,Brian De Palma,91,Drama|Horror|Thriller|Crime,1992-08-07,16,5.5,1992,18648291,57763170,39114879,5
8367,0.063684,3000000,33946224,30946224,Strictly Ballroom,Paul Mercurio|Tara Morice|Bill Hunter|Barry Otto|Pat Thomson,Baz Luhrmann,94,Comedy|Drama|Romance,1992-08-20,33,6.3,1992,4662072,52753255,48091183,6
8375,4.5783,18000000,389925971,371925971,Raiders of the Lost Ark,Harrison Ford|Karen Allen|Paul Freeman|Ronald Lacey|John Rhys-Davies,Steven Spielberg,115,Adventure|Action,1981-06-12,2506,7.5,1981,43167434,935116878,891949444,7
8376,1.94717,2800000,26279000,23479000,Private Lessons,Sylvia Kristel|Howard Hesseman|Eric Brown|Meridith Baer|Pamela Jean Bryant,Alan Myerson,87,Romance|Comedy,1981-08-21,10,6.1,1981,6714934,63022056,56307122,6
8377,1.771093,28000000,195312802,167312802,For Your Eyes Only,Roger Moore|Carole Bouquet|Chaim Topol|Lynn-Holly Johnson|Julian Glover,John Glen,127,Adventure|Action|Thriller,1981-06-23,268,6.0,1981,67149342,468397365,401248023,6
8378,1.278646,12000000,29800000,17800000,The Fox and the Hound,Mickey Rooney|Kurt Russell|Pearl Bailey|Jack Albertson|Sandy Duncan,Ted Berman|Art Stevens|Richard Rich,82,Adventure|Animation|Drama|Family,1981-07-10,498,6.9,1981,28778289,71466085,42687796,7
8379,1.248748,2000000,24600832,22600832,Mad Max 2,Mel Gibson|Bruce Spence|Michael Preston|Max Phipps|Vernon Wells,George Miller,95,Adventure|Action|Thriller|Science Fiction,1981-12-23,501,7.1,1981,4796381,58997489,54201108,7
8380,1.114068,11000000,31672907,20672907,History of the World: Part I,Mel Brooks|Dom DeLuise|Madeline Kahn|Harvey Korman|Cloris Leachman,Mel Brooks,92,Comedy,1981-06-12,91,6.3,1981,26380098,75957674,49577576,6
8381,1.055415,10000000,31973249,21973249,An American Werewolf in London,David Naughton|Jenny Agutter|Griffin Dunne|John Woodvine|Lila Kaye,John Landis,97,Horror|Comedy,1981-08-21,284,7.0,1981,23981908,76677951,52696043,7
8383,1.021218,350000,29400000,29050000,The Evil Dead,Bruce Campbell|Ellen Sandweiss|Richard DeManincor|Betsy Baker|Theresa Tilly,Sam Raimi,85,Horror,1981-10-15,426,7.2,1981,839366,70506809,69667443,7
8384,1.003963,6000000,50000000,44000000,Escape from New York,Kurt Russell|Lee Van Cleef|Ernest Borgnine|Donald Pleasence|Isaac Hayes,John Carpenter,99,Science Fiction|Action,1981-05-22,336,6.5,1981,14389144,119909540,105520396,6
8387,0.6599,5500000,58972904,53472904,Chariots of Fire,Ben Cross|Ian Charleson|Cheryl Campbell|Alice Krige|Nigel Havers,Hugh Hudson,123,Drama|History,1981-05-15,93,6.6,1981,13190049,141428276,128238227,7
8388,0.61576,1250000,21722776,20472776,Friday the 13th Part 2,Amy Steel|John Furey|Adrienne King|Kirsten Baker|Betsy Palmer,Steve Miner,87,Horror|Thriller,1981-05-01,134,6.2,1981,2997738,52095361,49097623,6
8391,0.564939,2500000,25533818,23033818,Halloween II,Jamie Lee Curtis|Donald Pleasence|Charles Cyphers|Jeffrey Kramer|Lance Guest,Rick Rosenthal,92,Horror|Thriller,1981-10-30,162,6.4,1981,5995477,61234967,55239490,6
8393,0.514548999999999,7000000,95461682,88461682,Arthur,Dudley Moore|Liza Minnelli|John Gielgud|Geraldine Fitzgerald|Jill Eikenberry,Steve Gordon,97,Comedy|Drama|Romance,1981-07-17,45,6.4,1981,16787335,228935327,212147992,6
8394,0.510003,1750000,100000,-1650000,Road Games,Stacy Keach|Jamie Lee Curtis|Marion Edward|Grant Page|Thaddeus Smith,Richard Franklin,101,Thriller|Horror|Mystery,1981-06-26,12,5.8,1981,4196833,239819,-3957014,6
8396,0.473893,4000000,125728258,121728258,Porky's,Dan Monahan|Mark Herrier|Wyatt Knight|Cyril O'Reilly|Tony Ganios,Bob Clark,94,Comedy,1981-11-13,75,6.0,1981,9592763,301520352,291927589,6
8397,0.469885,32000000,40382659,8382659,Reds,Warren Beatty|Diane Keaton|Edward Herrmann|Jack Nicholson|Jerzy Kosinski,Warren Beatty,195,Drama|History,1981-12-25,25,6.5,1981,76742105,96845321,20103216,6
8398,0.439555,18000000,72179579,54179579,The Cannonball Run,Burt Reynolds|Roger Moore|Farrah Fawcett|Dean Martin|Dom DeLuise,Hal Needham,95,Comedy,1981-06-19,64,6.3,1981,43167434,173100402,129932968,6
8399,0.426376,12000000,40716963,28716963,Absence of Malice,Paul Newman|Sally Field|Bob Balaban|Melinda Dillon|Luther Adler,Sydney Pollack,116,Drama|Romance|Thriller,1981-12-18,16,6.8,1981,28778289,97647046,68868757,7
8400,0.41618,5000000,42365581,37365581,Time Bandits,John Cleese|Sean Connery|Shelley Duvall|Katherine Helmond|Ian Holm,Terry Gilliam,116,Family|Fantasy|Science Fiction|Adventure|Comedy,1981-07-13,112,6.1,1981,11990954,101600746,89609792,6
8401,0.390801,4100000,14225876,10125876,Scanners,Stephen Lack|Jennifer O'Neill|Michael Ironside|Patrick McGoohan|Lawrence Dane,David Cronenberg,103,Horror|Science Fiction|Thriller,1981-01-14,93,6.2,1981,9832582,34116365,24283783,6
8405,0.435412,10000000,85300000,75300000,Stripes,Bill Murray|Harold Ramis|Warren Oates|P.J. Soles|Sean Young,Ivan Reitman,106,Action|Comedy,1981-06-25,108,6.5,1981,23981908,204565675,180583767,6
8406,0.336233,16000000,17374595,1374595,Outland,Sean Connery|Peter Boyle|Frances Sternhagen|James Sikking|Kika Markham,Peter Hyams,112,Science Fiction,1981-05-22,62,5.7,1981,38371052,41667593,3296541,6
8409,0.312053,3000000,216166,-2783834,Dead & Buried,James Farentino|Melody Anderson|Jack Albertson|Nancy Locke|Robert Englund,Gary Sherman,94,Horror|Mystery,1981-05-29,18,5.9,1981,7194572,518407,-6676165,6
8410,0.308408,18000000,12000000,-6000000,Blow Out,John Travolta|Nancy Allen|John Lithgow|Dennis Franz|Peter Boyden,Brian De Palma,108,Drama|Mystery|Thriller,1981-07-24,90,7.4,1981,43167434,28778289,-14389145,7
8415,0.29368,18000000,6000000,-12000000,Dragonslayer,Peter MacNicol|Caitlin Clarke|Ralph Richardson|John Hallam|Peter Eyre,Matthew Robbins,108,Fantasy,1981-06-26,21,6.7,1981,43167434,14389144,-28778290,7
8418,0.265411,1000000,17985893,16985893,The Howling,Patrick Macnee|Dennis Dugan|Christopher Stone|Belinda Balaski|Kevin McCarthy,Joe Dante,91,Drama|Horror,1981-04-03,58,6.3,1981,2398190,43133603,40735413,6
8419,0.251658,5000000,19905359,14905359,Nighthawks,Sylvester Stallone|Rutger Hauer|Billy Dee Williams|Lindsay Wagner|Persis Khambatta,Bruce Malmuth,99,Action|Crime|Thriller,1981-03-17,42,6.6,1981,11990954,47736848,35745894,7
8421,0.237765,14000000,35856053,21856053,Taps,George C. Scott|Timothy Hutton|Ronny Cox|Sean Penn|Tom Cruise,Harold Becker,126,Drama,1981-12-20,35,6.3,1981,33574671,85989656,52414985,6
8425,0.20326,15000000,41092328,26092328,Clash of the Titans,Laurence Olivier|Claire Bloom|Maggie Smith|Jack Gwillim|Harry Hamlin,Desmond Davis,118,Adventure|Fantasy|Family,1981-03-15,96,6.7,1981,35972862,98547243,62574381,7
8444,0.049718,8500000,29916207,21416207,Neighbors,John Belushi|Kathryn Walker|Cathy Moriarty|Dan Aykroyd|Tim Kazurinsky,John G. Avildsen,94,Comedy,1981-12-18,14,4.4,1981,20384621,71744772,51360151,4
8457,4.480733,75000000,816969268,741969268,Independence Day,Will Smith|Bill Pullman|Jeff Goldblum|Mary McDonnell|Judd Hirsch,Roland Emmerich,145,Action|Adventure|Science Fiction,1996-06-25,2000,6.6,1996,104266255,1135764351,1031498096,7
8458,3.293387,80000000,457696359,377696359,Mission: Impossible,Tom Cruise|Jon Voight|Emmanuelle BÃ©art|Henry Czerny|Jean Reno,Brian De Palma,110,Adventure|Action|Thriller,1996-05-21,1754,6.5,1996,111217339,636297139,525079800,6
8459,2.94792,4000000,16491080,12491080,Trainspotting,Ewan McGregor|Ewen Bremner|Jonny Lee Miller|Robert Carlyle|Kelly Macdonald,Danny Boyle,93,Drama|Crime,1996-02-23,1163,7.6,1996,5560866,22926175,17365309,8
8460,2.775756,7000000,60611975,53611975,Fargo,William H. Macy|Frances McDormand|Steve Buscemi|Peter Stormare|Kristin RudrÃ¼d,Joel Coen,98,Crime|Drama|Thriller,1996-04-05,1093,7.6,1996,9731517,84263782,74532265,8
8461,2.055908,75000000,335062621,260062621,The Rock,Sean Connery|Nicolas Cage|Ed Harris|John Spencer|David Morse,Michael Bay,136,Action|Adventure|Thriller,1996-06-06,930,6.8,1996,104266255,465809664,361543409,7
8462,2.036325,70000000,101371017,31371017,Mars Attacks!,Jack Nicholson|Glenn Close|Annette Bening|Pierce Brosnan|Danny DeVito,Tim Burton,106,Comedy|Fantasy|Science Fiction,1996-12-12,806,5.9,1996,97315171,140927684,43612513,6
8463,1.920156,14500000,147298761,132798761,Romeo + Juliet,Leonardo DiCaprio|Claire Danes|John Leguizamo|Harold Perrineau|Pete Postlethwaite,Baz Luhrmann,120,Drama|Romance,1996-10-31,754,6.6,1996,20158142,204777203,184619061,7
8464,1.894423,100000000,100138851,138851,The Hunchback of Notre Dame,Tom Hulce|Demi Moore|Heidi Mollenhauer|Tony Jay|Kevin Kline,Gary Trousdale|Kirk Wise,91,Family|Fantasy|Animation,1996-06-21,605,6.6,1996,139021673,139214706,193033,7
8466,1.617244,80000000,230000000,150000000,Space Jam,Michael Jordan|Wayne Knight|Billy West|Dee Bradley Baker|Theresa Randle,Joe Pytka,88,Animation|Comedy|Drama|Family|Fantasy,1996-11-15,677,6.3,1996,111217339,319749849,208532510,6
8467,1.585785,100000000,242295562,142295562,Eraser,Arnold Schwarzenegger|James Caan|Vanessa Williams|James Coburn|Robert Pastorelli,Chuck Russell,115,Action|Drama|Mystery|Thriller,1996-06-21,306,5.5,1996,139021673,336843346,197821673,5
8468,1.419885,54000000,320689294,266689294,101 Dalmatians,Glenn Close|Jeff Daniels|Joely Richardson|Joan Plowright|Hugh Laurie,Stephen Herek,103,Comedy|Family,1996-11-17,367,5.5,1996,75071703,445827624,370755921,5
8469,1.392981,32000000,152036382,120036382,Phenomenon,John Travolta|Kyra Sedgwick|Forest Whitaker|Robert Duvall|Jeffrey DeMunn,Jon Turteltaub,123,Drama|Fantasy|Romance|Science Fiction,1996-07-05,164,6.0,1996,44486935,211363523,166876588,6
8470,1.353504,19000000,25836616,6836616,From Dusk Till Dawn,George Clooney|Quentin Tarantino|Harvey Keitel|Juliette Lewis|Ernest Liu,Robert Rodriguez,108,Horror|Action|Thriller|Crime,1996-01-19,863,6.9,1996,26414118,35918496,9504378,7
8471,1.325627,40000000,152266007,112266007,A Time to Kill,Matthew McConaughey|Sandra Bullock|Samuel L. Jackson|Kevin Spacey|Oliver Platt,Joel Schumacher,149,Crime|Drama|Thriller,1996-07-24,263,7.0,1996,55608669,211682751,156074082,7
8472,1.323991,46000000,150000000,104000000,Star Trek: First Contact,James Cromwell|Alfre Woodard|Alice Krige|Neal McDonough|Patrick Stewart,Jonathan Frakes,111,Science Fiction|Action|Adventure|Thriller,1996-11-21,426,6.8,1996,63949969,208532510,144582541,7
8473,1.303236,12000000,41205099,29205099,Happy Gilmore,Adam Sandler|Christopher McDonald|Julie Bowen|Frances Bay|Carl Weathers,Dennis Dugan,92,Comedy,1996-02-16,435,6.4,1996,16682600,57284018,40601418,6
8474,1.294658,60000000,129832389,69832389,Jingle All the Way,Arnold Schwarzenegger|Phil Hartman|Sinbad|Rita Wilson|Jake Lloyd,Brian Levant,89,Comedy|Family,1996-11-15,306,5.5,1996,83413004,180495160,97082156,5
8475,1.286189,14000000,173046663,159046663,Scream,David Arquette|Neve Campbell|Courteney Cox|Matthew Lillard|Rose McGowan,Wes Craven,111,Crime|Horror|Mystery,1996-12-19,779,6.9,1996,19463034,240572367,221109333,7
8476,1.255866,65000000,89456761,24456761,The Long Kiss Goodnight,Geena Davis|Samuel L. Jackson|Yvonne Zima|Craig Bierko|Tom Amandes,Renny Harlin,120,Action|Crime|Drama|Mystery|Thriller,1996-10-11,164,6.4,1996,90364088,124364286,34000198,6
8477,1.117552,50000000,273552592,223552592,Jerry Maguire,Tom Cruise|Cuba Gooding Jr.|RenÃ©e Zellweger|Kelly Preston|Alison Armitage,Cameron Crowe,139,Comedy|Drama|Romance,1996-12-06,561,6.5,1996,69510836,380297392,310786556,6
8478,1.108452,36000000,33459416,-2540584,Matilda,Mara Wilson|Danny DeVito|Embeth Davidtz|Rhea Perlman|Pam Ferris,Danny DeVito,98,Comedy|Family|Fantasy,1996-08-02,451,6.8,1996,50047802,46515840,-3531962,7
8479,1.108366,57000000,115267375,58267375,DragonHeart,Dennis Quaid|David Thewlis|Pete Postlethwaite|Dina Meyer|Julie Christie,Rob Cohen,103,Fantasy,1996-05-31,273,6.1,1996,79242354,160246634,81004280,6
8480,1.10451,54000000,128769345,74769345,The Nutty Professor,Eddie Murphy|Jada Pinkett Smith|James Coburn|Larry Miller|Dave Chappelle,Tom Shadyac,95,Fantasy|Comedy|Romance|Science Fiction,1996-06-26,334,5.4,1996,75071703,179017298,103945595,5
8481,1.056168,80000000,159212469,79212469,Daylight,Sylvester Stallone|Amy Brenneman|Viggo Mortensen|Dan Hedaya|Jay O. Sanders,Rob Cohen,115,Action|Adventure|Thriller,1996-12-06,189,5.6,1996,111217339,221339839,110122500,6
8482,1.049888,30000000,57400547,27400547,The Quest,Jean-Claude Van Damme|Roger Moore|James Remar|Jack McGee|Louis Mandylor,Jean-Claude Van Damme,95,Action|Adventure,1996-04-19,63,5.1,1996,41706502,79799201,38092699,5
8483,1.04502,50000000,60209334,10209334,Chain Reaction,Keanu Reeves|Morgan Freeman|Rachel Weisz|Fred Ward|Kevin Dunn,Andrew Davis,107,Adventure,1996-08-02,153,5.3,1996,69510836,83704023,14193187,5
8484,1.044304,27000000,231976425,204976425,The English Patient,Ralph Fiennes|Juliette Binoche|Willem Dafoe|Kristin Scott Thomas|Naveen Andrews,Anthony Minghella,162,Drama|Romance|War,1996-11-14,287,6.9,1996,37535851,322497509,284961658,7
8485,1.000489,55000000,121969216,66969216,Executive Decision,Kurt Russell|Steven Seagal|Halle Berry|John Leguizamo|Oliver Platt,Stuart Baird,133,Action|Adventure|Drama|Thriller,1996-03-15,128,5.5,1996,76461920,169563645,93101725,5
8486,0.975473,92000000,494471524,402471524,Twister,Helen Hunt|Bill Paxton|Cary Elwes|Jami Gertz|Philip Seymour Hoffman,Jan de Bont,113,Action|Adventure|Drama,1996-05-09,546,5.9,1996,127899939,687422589,559522650,6
8487,0.962736,80000000,309492681,229492681,Ransom,Mel Gibson|Gary Sinise|Delroy Lindo|Rene Russo|Lili Taylor,Ron Howard,117,Action|Thriller,1996-11-08,235,6.2,1996,111217339,430261905,319044566,6
8489,0.938162,47000000,102825796,55825796,The Cable Guy,Jim Carrey|Matthew Broderick|Leslie Mann|Jack Black|George Segal,Ben Stiller,96,Comedy|Drama|Thriller,1996-06-14,283,5.4,1996,65340186,142950142,77609956,5
8490,0.928256,44000000,165615285,121615285,Sleepers,Robert De Niro|Brad Pitt|Kevin Bacon|Jason Patric|Ron Eldard,Barry Levinson,147,Crime|Drama|Thriller,1996-10-18,371,7.2,1996,61169536,230241141,169071605,7
8491,0.923851,30000000,29359216,-640784,The Frighteners,Michael J. Fox|Jeffrey Combs|Jake Busey|Chi McBride|Trini Alvarado,Peter Jackson,110,Horror|Comedy,1996-07-18,184,6.5,1996,41706502,40815673,-890829,6
8492,0.902697,50000000,150270147,100270147,Broken Arrow,John Travolta|Christian Slater|Samantha Mathis|Delroy Lindo|Bob Gunton,John Woo,108,Action|Adventure|Drama|Thriller,1996-02-09,244,5.5,1996,69510836,208908073,139397237,5
8494,0.891371999999999,50000000,42277365,-7722635,Escape from L.A.,Kurt Russell|Stacy Keach|Steve Buscemi|Pam Grier|Cliff Robertson,John Carpenter,97,Action|Adventure|Science Fiction|Thriller,1996-08-09,189,5.4,1996,69510836,58774700,-10736136,5
8495,0.870461,36000000,20300385,-15699615,The People vs. Larry Flynt,Woody Harrelson|Courtney Love|Edward Norton|Brett Harrelson|Donna Hanover,MiloÅ¡ Forman,129,Drama,1996-10-13,122,6.5,1996,50047802,28221935,-21825867,6
8496,0.862046999999999,25000000,14048372,-10951628,The Arrival,Charlie Sheen|Lindsay Crouse|Richard Schiff|Ron Silver|Teri Polo,David Twohy,115,Action|Mystery|Science Fiction|Thriller,1996-05-31,82,5.7,1996,34755418,19530281,-15225137,6
8497,0.833267,4500000,7011317,2511317,Bound,Jennifer Tilly|Gina Gershon|Joe Pantoliano|John P. Ryan|Christopher Meloni,Lana Wachowski|Lilly Wachowski,108,Romance|Drama|Thriller|Crime,1996-09-13,100,6.5,1996,6255975,9747250,3491275,6
8498,0.802896,200000,4505922,4305922,Swingers,Jon Favreau|Vince Vaughn|Ron Livingston|Patrick Van Horn|Alex DÃ©sert,Doug Liman,94,Comedy|Romance,1996-10-18,129,6.9,1996,278043,6264208,5986165,7
8499,0.794822,50000000,113309743,63309743,Striptease,Demi Moore|Burt Reynolds|Armand Assante|Ving Rhames|Robert Patrick,Andrew Bergman,115,Drama|Thriller|Crime,1996-06-28,108,4.4,1996,69510836,157525101,88014265,4
8500,0.79243,55000000,18626419,-36373581,The Fan,Robert De Niro|Wesley Snipes|Ellen Barkin|John Leguizamo|Benicio del Toro,Tony Scott,116,Drama|Mystery|Thriller,1996-08-15,103,5.6,1996,76461920,25894759,-50567161,6
8501,0.779012,45000000,58620973,13620973,Jack,Robin Williams|Diane Lane|Brian Kerwin|Jennifer Lopez|Bill Cosby,Francis Ford Coppola,113,Comedy|Drama|Science Fiction,1996-08-09,171,5.8,1996,62559753,81495857,18936104,6
8502,0.759509,30000000,102616183,72616183,Primal Fear,Richard Gere|Edward Norton|Laura Linney|John Mahoney|Frances McDormand,Gregory Hoblit,129,Crime|Drama|Mystery|Thriller,1996-04-03,317,7.3,1996,41706502,142658735,100952233,7
8504,0.745574,46000000,100860818,54860818,Courage Under Fire,Denzel Washington|Meg Ryan|Lou Diamond Phillips|Matt Damon|Michael Moriarty,Edward Zwick,117,Drama|Thriller|Mystery|War,1996-07-04,134,6.1,1996,63949969,140218397,76268428,6
8510,0.693264,9000000,41590886,32590886,Set  It Off,Jada Pinkett Smith|Queen Latifah|Vivica A. Fox|Kimberly Elise|Blair Underwood,F. Gary Gray,118,Drama|Action|Crime,1996-11-06,37,7.0,1996,12511950,57820345,45308395,7
8512,0.690292,15000000,24769466,9769466,The Craft,Fairuza Balk|Neve Campbell|Robin Tunney|Rachel True|Skeet Ulrich,Andrew Fleming,101,Fantasy|Drama|Horror|Thriller,1996-05-03,184,6.2,1996,20853251,34434926,13581675,6
8515,0.670801,4000000,16675000,12675000,Hellraiser: Bloodline,Bruce Ramsay|Valentina Vargas|Charlotte Chatton|Adam Scott|Kim Myers,Kevin Yagher,86,Horror|Thriller|Science Fiction,1996-03-08,52,4.8,1996,5560866,23181864,17620998,5
8517,0.642274,27000000,25023434,-1976566,Kingpin,Woody Harrelson|Randy Quaid|Vanessa Angel|Bill Murray|Chris Elliott,Bobby Farrelly|Peter Farrelly,113,Comedy,1996-07-04,126,6.4,1996,37535851,34787996,-2747855,6
8518,0.635964,40000000,48093211,8093211,The Preacher's Wife,Denzel Washington|Whitney Houston|Courtney B. Vance|Gregory Hines|Jenifer Lewis,Penny Marshall,124,Fantasy|Drama|Comedy|Science Fiction|Romance,1996-12-13,33,5.5,1996,55608669,66859986,11251317,5
8521,0.618796,25000000,22611954,-2388046,Bulletproof,Damon Wayans|Adam Sandler|James Caan|Robert Swenson|James Farentino,Ernest R. Dickerson,84,Action|Adventure|Comedy|Thriller,1996-09-06,78,5.2,1996,34755418,31435516,-3319902,5
8523,0.578849,15000000,5,-14999995,Bordello of Blood,Dennis Miller|Erika Eleniak|Angie Everhart|John Kassir|Chris Sarandon,Gilbert Adler,87,Horror|Comedy,1996-08-16,27,4.9,1996,20853251,6,-20853245,5
8524,0.576743999999999,55000000,141047179,86047179,Evita,Madonna|Antonio Banderas|Jonathan Pryce|Jimmy Nail|Victoria Sus,Alan Parker,134,History|Drama|Music,1996-12-14,59,5.9,1996,76461920,196086149,119624229,6
8528,0.566517,7000000,14702438,7702438,Flirting with Disaster,Ben Stiller|Patricia Arquette|TÃ©a Leoni|Mary Tyler Moore|Alan Alda,David O. Russell,92,Comedy|Romance,1996-03-22,28,6.2,1996,9731517,20439575,10708058,6
8532,0.548582,2962051,3011195,49144,Basquiat,Jeffrey Wright|David Bowie|Dennis Hopper|Gary Oldman|Benicio del Toro,Julian Schnabel,108,Drama|History,1996-08-09,53,6.7,1996,4117892,4186213,68321,7
8535,0.537577,67000000,47267001,-19732999,Last Man Standing,Bruce Willis|Bruce Dern|William Sanderson|Christopher Walken|David Patrick Kelly,Walter Hill,101,Action|Crime|Drama|Thriller,1996-09-20,131,6.0,1996,93144521,65711375,-27433146,6
8536,0.537381,25000000,51702483,26702483,Maximum Risk,Jean-Claude Van Damme|Natasha Henstridge|Jean-Hugues Anglade|Zach Grenier|Paul Ben-Victor,Ringo Lam,100,Action|Adventure|Thriller,1996-09-13,52,5.1,1996,34755418,71877657,37122239,5
8537,0.529152,25000000,17193231,-7806769,Fled,Laurence Fishburne|Stephen Baldwin|Salma Hayek|Will Patton|Robert John Burke,Kevin Hooks,98,Action|Comedy|Thriller,1996-07-19,20,5.3,1996,34755418,23902317,-10853101,5
8540,0.519242,3500000,9482579,5982579,She's the One,Edward Burns|Michael McGlone|Cameron Diaz|Jennifer Aniston|John Mahoney,Edward Burns,96,Comedy|Romance,1996-08-26,42,5.7,1996,4865758,13182840,8317082,6
8544,0.491539,13000000,17917287,4917287,The Crow: City of Angels,Vincent PÃ©rez|Mia Kirshner|Iggy Pop|Thomas Jane|Richard Brooks,Tim Pope,84,Action|Fantasy|Thriller,1996-08-29,69,5.7,1996,18072817,24908912,6836095,6
8547,0.481121,7000000,560069,-6439931,Bottle Rocket,Luke Wilson|Owen Wilson|Lumi Cavazos|Andrew Wilson|Robert Musgrave,Wes Anderson,91,Comedy|Crime|Drama,1996-02-21,128,6.7,1996,9731517,778617,-8952900,7
8548,0.478051,38000000,28921264,-9078736,James and the Giant Peach,Miriam Margolyes|Joanna Lumley|Pete Postlethwaite|Susan Sarandon|Richard Dreyfuss,Henry Selick,79,Adventure|Animation|Family,1996-04-12,222,6.1,1996,52828236,40206825,-12621411,6
8550,0.477489,6000000,22231658,16231658,Emma,Gwyneth Paltrow|Toni Collette|Alan Cumming|Ewan McGregor|Jeremy Northam,Douglas McGrath,121,Comedy|Drama|Romance,1996-08-02,77,6.5,1996,8341300,30906823,22565523,6
8552,0.471398,45000000,53854588,8854588,Tin Cup,Kevin Costner|Don Johnson|Cheech Marin|George Perez|Rene Russo,Ron Shelton,135,Comedy|Drama|Romance,1996-08-16,64,5.6,1996,62559753,74869549,12309796,6
8554,0.468045,26000000,116400000,90400000,The First Wives Club,Bette Midler|Goldie Hawn|Diane Keaton|Maggie Smith|Dan Hedaya,Hugh Wilson,103,Comedy,1996-09-20,80,6.4,1996,36145635,161821228,125675593,6
8556,0.459939,3000000,4109095,1109095,Kama Sutra - A Tale of Love,Indira Varma|Sarita Choudhury|Ramon Tikaram|Naveen Andrews,Mira Nair,117,Drama|History|Romance,1996-09-11,20,6.1,1996,4170650,5712532,1541882,6
8557,0.455716,1000000,24475416,23475416,Sling Blade,Billy Bob Thornton|Dwight Yoakam|J. T. Walsh|John Ritter|Lucas Black,Billy Bob Thornton,135,Drama,1996-08-30,87,6.9,1996,1390216,34026133,32635917,7
8558,0.453398,4500000,13417292,8917292,Secrets & Lies,Timothy Spall|Phyllis Logan|Brenda Blethyn|Claire Rushbrook|Marianne Jean-Baptiste,Mike Leigh,142,Drama,1996-05-24,45,6.7,1996,6255975,18652943,12396968,7
8563,0.442104,47000000,12379402,-34620598,Mary Reilly,Julia Roberts|John Malkovich|George Cole|Michael Gambon|Glenn Close,Stephen Frears,104,Drama|Horror|Thriller|Romance,1996-02-23,26,5.4,1996,65340186,17210051,-48130135,5
8565,0.435293,50000000,75000000,25000000,The Ghost and the Darkness,Michael Douglas|Val Kilmer|Tom Wilkinson|John Kani|Emily Mortimer,Stephen Hopkins,109,Adventure,1996-10-11,104,6.3,1996,69510836,104266255,34755419,6
8572,0.401898,7000000,405000,-6595000,Jude,Kate Winslet|Christopher Eccleston|Liam Cunningham|Rachel Griffiths|June Whitfield,Michael Winterbottom,123,Drama|Romance,1996-02-06,20,6.7,1996,9731517,563037,-9168480,7
8575,0.397139,5000000,13269963,8269963,Lone Star,Chris Cooper|Matthew McConaughey|Elizabeth PeÃ±a|Kris Kristofferson|Joe Morton,John Sayles,135,Drama|Mystery|Romance,1996-06-21,27,6.6,1996,6951083,18448124,11497041,7
8576,0.340804,25530000,20080020,-5449980,Flipper,Elijah Wood|Paul Hogan|Jonathan Banks|Jason Fuchs|Robert Deacon,Alan Shapiro,95,Adventure|Family,1996-05-17,47,5.5,1996,35492233,27915579,-7576654,5
8586,0.366286,50000000,22540359,-27459641,The Chamber,Chris O'Donnell|Gene Hackman|Faye Dunaway|Robert Prosky|Lela Rochon,James Foley,113,Drama|Thriller,1996-10-11,26,6.0,1996,69510836,31335984,-38174852,6
8587,0.36509,38000000,10300000,-27700000,White Squall,Jeff Bridges|Caroline Goodall|John Savage|Scott Wolf|Jeremy Sisto,Ridley Scott,129,Action|Drama,1996-02-02,41,6.2,1996,52828236,14319232,-38509004,6
8593,0.347219,45000000,17300889,-27699111,The Phantom,Billy Zane|Kristy Swanson|Treat Williams|Catherine Zeta-Jones|James Remar,Simon Wincer,100,Adventure|Action,1996-06-06,69,4.9,1996,62559753,24051985,-38507768,5
8598,0.331074,38000000,17380126,-20619874,Extreme Measures,Hugh Grant|Gene Hackman|Sarah Jessica Parker|David Morse|Bill Nunn,Michael Apted,118,Drama|Thriller,1996-09-27,31,5.3,1996,52828236,24162142,-28666094,5
8602,0.317794,28000000,16900000,-11100000,Michael Collins,Liam Neeson|Aidan Quinn|Stephen Rea|Alan Rickman|Julia Roberts,Neil Jordan,132,Drama|Thriller,1996-10-25,47,6.1,1996,38926068,23494662,-15431406,6
8612,0.392776,3000000,222559,-2777441,Hard Eight,Philip Baker Hall|Gwyneth Paltrow|John C. Reilly|Samuel L. Jackson|F. William Parker,Paul Thomas Anderson,96,Drama|Thriller,1996-02-28,69,6.6,1996,4170650,309405,-3861245,7
8615,0.273628,5000000,42000000,37000000,Doctor Who,Paul McGann|Eric Roberts|Daphne Ashbrook|Sylvester McCoy|Yee Jee Tso,Geoffrey Sax,89,TV Movie|Adventure|Drama|Science Fiction,1996-05-14,35,5.6,1996,6951083,58389103,51438020,6
8621,0.243962,3000000,2503829,-496171,Ridicule,Charles Berling|Jean Rochefort|Fanny Ardant|Judith GodrÃ¨che|Bernard Giraudeau,Patrice Leconte,102,Comedy|Drama|Romance,1996-05-09,18,6.6,1996,4170650,3480864,-689786,7
8622,0.240968,40000000,49627779,9627779,The Island of Dr. Moreau,Marlon Brando|Val Kilmer|David Thewlis|Fairuza Balk|Daniel Rigney,Richard Stanley|John Frankenheimer,96,Fantasy|Horror|Science Fiction,1996-08-23,68,4.6,1996,55608669,68993369,13384700,5
8628,0.221598,15000000,76382,-14923618,Silent Trigger,Dolph Lundgren|Gina Bellman|Conrad Dunn|Christopher Heyerdahl,Russell Mulcahy,93,Drama|Action|Thriller,1996-06-26,11,4.6,1996,20853251,106187,-20747064,5
8634,0.211566,3000000,153155,-2846845,Citizen Ruth,Laura Dern|Swoosie Kurtz|Kurtwood Smith|Mary Kay Place|Kelly Preston,Alexander Payne,104,Drama|Comedy,1996-12-13,10,7.0,1996,4170650,212918,-3957732,7
8652,0.111375,13000000,4619014,-8380986,Joe's Apartment,Jerry O'Connell|Megan Ward|Billy West|Reginald Hudlin|Willi One Blood,John Payson,78,Fantasy|Comedy|Music,1996-07-26,43,4.8,1996,18072817,6421430,-11651387,5
8653,0.099873,7000000,1100000,-5900000,Bad Moon,Mariel Hemingway|Michael ParÃ©|Mason Gamble|Hrothgar Mathews|Ken Pogue,Eric Red,80,Horror,1996-11-01,12,6.0,1996,9731517,1529238,-8202279,6
8654,0.094017,25000000,10070000,-14930000,Mrs. Winterbourne,Shirley MacLaine|Ricki Lake|Brendan Fraser|Jane Krakowski|Loren Dean,Richard Benjamin,105,Comedy|Romance|Drama,1996-04-19,10,5.2,1996,34755418,13999482,-20755936,5
8661,4.271452,103000000,457640427,354640427,Gladiator,Russell Crowe|Joaquin Phoenix|Connie Nielsen|Oliver Reed|Richard Harris,Ridley Scott,155,Action|Drama|Adventure,2000-05-01,3531,7.7,2000,130428087,579506463,449078376,8
8662,3.095625,9000000,39723096,30723096,Memento,Guy Pearce|Carrie-Anne Moss|Joe Pantoliano|Mark Boone Junior|Russ Fega,Christopher Nolan,113,Mystery|Thriller,2000-10-11,2144,7.9,2000,11396629,50301043,38904414,8
8663,2.977558,123000000,345141403,222141403,How the Grinch Stole Christmas,Jim Carrey|Taylor Momsen|Jeffrey Tambor|Christine Baranski|Bill Irwin,Ron Howard,104,Family|Comedy|Fantasy,2000-11-17,733,6.1,2000,155753930,437049836,281295906,6
8664,2.197205,90000000,429632142,339632142,Cast Away,Tom Hanks|Helen Hunt|Chris Noth|Paul Sanchez|Lari White,Robert Zemeckis,143,Adventure|Drama,2000-12-22,1854,7.3,2000,113966290,544039793,430073503,7
8665,2.153361,10000000,83557872,73557872,Snatch,Jason Statham|Brad Pitt|Vinnie Jones|Dennis Farina|Benicio del Toro,Guy Ritchie,103,Thriller|Crime,2000-09-01,1943,7.5,2000,12662921,105808674,93145753,7
8666,1.956406,125000000,546388105,421388105,Mission: Impossible II,Tom Cruise|Dougray Scott|Thandie Newton|Ving Rhames|Richard Roxburgh,John Woo,123,Adventure|Action|Thriller,2000-05-23,1269,5.8,2000,158286514,691886948,533600434,6
8667,1.889388,48000000,90383208,42383208,Bedazzled,Elizabeth Hurley|Brendan Fraser|Frances O'Connor|Orlando Jones|Paul Adelstein,Harold Ramis,93,Fantasy|Comedy|Romance,2000-10-19,302,5.3,2000,60782021,114451543,53669522,5
8668,1.815244,19000000,278019771,259019771,Scary Movie,Carmen Electra|Dave Sheridan|Anna Faris|Jon Abrahams|Regina Hall,Keenen Ivory Wayans,88,Comedy,2000-07-07,681,5.9,2000,24059550,352054243,327994693,6
8669,1.768463,100000000,169327687,69327687,The Emperor's New Groove,David Spade|John Goodman|Eartha Kitt|Patrick Warburton|Wendie Malick,Mark Dindal,78,Adventure|Animation|Comedy|Family|Fantasy,2000-12-09,832,6.9,2000,126629211,214418314,87789103,7
8670,1.767681,70000000,374111707,304111707,What Women Want,Helen Hunt|Mel Gibson|Marisa Tomei|Lauren Holly|Mark Feuerstein,Nancy Meyers,127,Comedy|Romance,2000-12-14,576,6.0,2000,88640448,473734704,385094256,6
8671,1.60246,127500000,354248063,226748063,Dinosaur,D. B. Sweeney|Alfre Woodard|Ossie Davis|Max Casella|Hayden Panettiere,Ralph Zondag|Eric Leighton,82,Animation|Family,2000-05-19,320,6.1,2000,161452244,448581528,287129284,6
8672,1.562652,92000000,264105545,172105545,Charlie's Angels,Cameron Diaz|Lucy Liu|Drew Barrymore|Bill Murray|John Forsythe,McG,98,Action|Adventure|Comedy|Crime|Thriller,2000-11-02,709,5.5,2000,116498874,334434768,217935894,5
8673,1.525559,45000000,224834564,179834564,Chicken Run,Mel Gibson|Miranda Richardson|Timothy Spall|Imelda Staunton|Jane Horrocks,Peter Lord|Nick Park,84,Animation|Comedy|Family,2000-06-21,663,6.3,2000,56983145,284706235,227723090,6
8674,1.513108,110000000,215294342,105294342,The Patriot,Mel Gibson|Heath Ledger|Joely Richardson|Jason Isaacs|TchÃ©ky Karyo,Roland Emmerich,165,Drama|History|War|Action,2000-06-28,651,6.7,2000,139292132,272625527,133333395,7
8675,1.303223,23000000,53302314,30302314,Final Destination,Devon Sawa|Ali Larter|Kerr Smith|Tony Todd|Seann William Scott,James Wong,98,Horror,2000-03-16,693,6.2,2000,29124718,67496299,38371581,6
8676,1.240519,45000000,113916474,68916474,Coyote Ugly,Piper Perabo|Adam Garcia|John Goodman|Izabella Miko|Tyra Banks,David McNally,100,Comedy,2000-07-30,328,6.0,2000,56983145,144251532,87268387,6
8677,1.235745,25000000,91036760,66036760,Romeo Must Die,Jet Li|Aaliyah|Isaiah Washington|Russell Wong|DMX,Andrzej Bartkowiak,115,Action|Crime|Thriller,2000-03-20,193,5.8,2000,31657302,115279131,83621829,6
8678,1.22950499999999,62000000,127666415,65666415,U-571,Matthew McConaughey|Bill Paxton|Harvey Keitel|Jon Bon Jovi|David Keith,Jonathan Mostow,116,Action|Drama|Thriller|War,2000-04-20,205,6.1,2000,78510111,161662974,83152863,6
8679,1.211626,5000000,110000000,105000000,Billy Elliot,Jamie Bell|Julie Walters|Jean Heywood|Jamie Draven|Gary Lewis,Stephen Daldry,110,Drama|Comedy|Music,2000-05-18,359,7.1,2000,6331460,139292132,132960672,7
8680,1.209516,90000000,237202299,147202299,Gone In Sixty Seconds,Nicolas Cage|Angelina Jolie|Giovanni Ribisi|Delroy Lindo|Will Patton,Dominic Sena,118,Action|Crime|Thriller,2000-06-09,994,6.0,2000,113966290,300367400,186401110,6
8681,1.208034,52000000,256271286,204271286,Erin Brockovich,Julia Roberts|Albert Finney|Aaron Eckhart|Marg Helgenberger|Cherry Jones,Steven Soderbergh,131,Drama,2000-03-13,406,6.9,2000,65847189,324514308,258667119,7
8682,1.207663,55000000,330444045,275444045,Meet the Parents,Ben Stiller|Robert De Niro|Teri Polo|Blythe Danner|Owen Wilson,Jay Roach,108,Comedy|Romance,2000-10-05,957,6.5,2000,69646066,418438688,348792622,6
8683,1.161107,26000000,71000000,45000000,"O Brother, Where Art Thou?",George Clooney|John Turturro|Tim Blake Nelson|John Goodman|Holly Hunter,Joel Coen,106,Action|Adventure|Comedy,2000-08-30,662,7.2,2000,32923594,89906740,56983146,7
8684,1.144594,23000000,53187659,30187659,Pitch Black,Vin Diesel|Radha Mitchell|Cole Hauser|Rhiana Griffith|Lewis Fitz-Gerald,David Twohy,109,Thriller|Science Fiction|Action,2000-02-18,1245,6.6,2000,29124718,67351113,38226395,7
8685,1.104427,26000000,28780255,2780255,Boiler Room,Giovanni Ribisi|Vin Diesel|Nia Long|Tom Everett Scott|Ben Affleck,Ben Younger,118,Crime|Drama|Thriller,2000-02-18,102,6.5,2000,32923594,36444209,3520615,6
8686,1.085408,95000000,76432727,-18567273,The Road to El Dorado,Kenneth Branagh|Kevin Kline|Rosie Perez|Armand Assante|Edward James Olmos,Don Michael Paul|Bibo Bergeron,89,Adventure|Animation|Comedy|Family,2000-03-31,462,6.8,2000,120297750,96786159,-23511591,7
8687,1.073638,45000000,212000000,167000000,Miss Congeniality,Sandra Bullock|Benjamin Bratt|Michael Caine|Candice Bergen|William Shatner,Donald Petrie,111,Comedy|Crime|Action,2000-12-14,563,6.1,2000,56983145,268453928,211470783,6
8688,1.060212,31000000,68106245,37106245,Frequency,Dennis Quaid|Jim Caviezel|Andre Braugher|Elizabeth Mitchell|Noah Emmerich,Gregory Hoblit,118,Crime|Drama|Science Fiction|Thriller,2000-04-28,215,6.8,2000,39255055,86242400,46987345,7
8689,1.050687,4500000,7390108,2890108,Requiem for a Dream,Ellen Burstyn|Jared Leto|Jennifer Connelly|Marlon Wayans|Christopher McDonald,Darren Aronofsky,102,Drama,2000-10-27,1316,7.7,2000,5698314,9358035,3659721,8
8690,1.042311,40000000,55707411,15707411,Pay It Forward,Kevin Spacey|Helen Hunt|Haley Joel Osment|Jay Mohr|Jim Caviezel,Mimi Leder,122,Drama|Romance,2000-10-12,230,6.8,2000,50651684,70541855,19890171,7
8692,1.006654,95000000,190213455,95213455,Hollow Man,Elisabeth Shue|Kevin Bacon|Josh Brolin|Kim Dickens|Rhona Mitra,Paul Verhoeven,112,Action|Science Fiction|Thriller,2000-08-04,309,5.3,2000,120297750,240865798,120568048,5
8693,1.001503,30000000,173959438,143959438,Big Momma's House,Martin Lawrence|Nia Long|Paul Giamatti|Jascha Washington|Terrence Howard,Raja Gosnell,98,Crime|Comedy,2000-05-31,279,5.7,2000,37988763,220283464,182294701,6
8694,0.981767,7000000,34266564,27266564,American Psycho,Christian Bale|Willem Dafoe|Jared Leto|Josh Lucas|Samantha Mathis,Mary Harron,102,Thriller|Drama|Crime,2000-04-13,1069,7.1,2000,8864044,43391479,34527435,7
8695,0.97741,12800000,40031879,27231879,Dancer in the Dark,BjÃ¶rk|Catherine Deneuve|David Morse|Peter Stormare|Joel Grey,Lars von Trier,140,Drama|Crime|Music,2000-05-17,190,7.4,2000,16208539,50692052,34483513,7
8696,0.976664,16000000,119754278,103754278,Road Trip,Breckin Meyer|Seann William Scott|Amy Smart|Paulo Costanzo|DJ Qualls,Todd Phillips,93,Comedy|Adventure,2000-05-19,299,5.7,2000,20260673,151643897,131383224,6
8697,0.972719,30000000,136706683,106706683,Remember the Titans,Denzel Washington|Will Patton|Ryan Hurst|Wood Harris|Hayden Panettiere,Boaz Yakin,113,Drama,2000-09-29,535,7.3,2000,37988763,173110594,135121831,7
8698,0.968941,10000000,12008642,2008642,The Gift,Cate Blanchett|Giovanni Ribisi|Keanu Reeves|Katie Holmes|Greg Kinnear,Sam Raimi,111,Horror|Drama|Thriller|Mystery,2000-12-22,128,6.2,2000,12662921,15206448,2543527,6
8699,0.923632,80000000,39459427,-40540573,The Legend of Bagger Vance,Matt Damon|Bruce McGill|Charlize Theron|Will Smith|Joel Gretsch,Robert Redford,126,Fantasy|Drama,2000-11-02,146,6.2,2000,101303369,49967161,-51336208,6
8700,0.918262,48000000,207515725,159515725,Traffic,Michael Douglas|Benicio del Toro|Jacob Vargas|TomÃ¡s MiliÃ¡n|Russell G. Jones,Steven Soderbergh,148,Drama,2000-12-27,286,6.6,2000,60782021,262775526,201993505,7
8701,0.91232,13000000,73180723,60180723,"Dude, Whereâ€™s My Car?",Ashton Kutcher|Seann William Scott|Kristy Swanson|Jennifer Garner|Marla Sokoloff,Danny Leiner,83,Comedy,2000-12-15,287,5.1,2000,16461797,92668172,76206375,5
8702,0.911808,60000000,124745083,64745083,The Family Man,Nicolas Cage|TÃ©a Leoni|Don Cheadle|Saul Rubinek|Amber Valletta,Brett Ratner,125,Comedy|Drama|Romance|Fantasy,2000-12-12,301,6.4,2000,75977526,157963714,81986188,6
8704,0.886238,82000000,96085477,14085477,The 6th Day,Arnold Schwarzenegger|Michael Rapaport|Tony Goldwyn|Michael Rooker|Sarah Wynter,Roger Spottiswoode,123,Action|Mystery|Science Fiction|Thriller,2000-11-17,318,5.5,2000,103835953,121672281,17836328,5
8705,0.848261,15000000,35007180,20007180,The Skulls,Joshua Jackson|Paul Walker|Hill Harper|Leslie Bibb|Christopher McDonald,Rob Cohen,106,Crime|Drama|Thriller,2000-03-31,88,5.9,2000,18994381,44329315,25334934,6
8707,0.78353,51000000,149270999,98270999,"Me, Myself & Irene",Jim Carrey|RenÃ©e Zellweger|Anthony Anderson|Robert Forster|Richard Jenkins,Peter Farrelly|Bobby Farrelly,116,Comedy,2000-06-22,521,5.9,2000,64580897,189020688,124439791,6
8708,0.770457,55000000,56932305,1932305,Shanghai Noon,Jackie Chan|Owen Wilson|Lucy Liu|Xander Berkeley|Roger Yuan,Tom Dey,110,Adventure|Action|Comedy|Western,2000-05-26,411,6.1,2000,69646066,72092928,2446862,6
8709,0.768576,75000000,248118121,173118121,Unbreakable,Bruce Willis|Samuel L. Jackson|Robin Wright|Spencer Treat Clark|John Patrick Amedori,M. Night Shyamalan,106,Action|Fantasy|Thriller,2000-11-13,948,6.7,2000,94971908,314190020,219218112,7
8710,0.743732,65000000,128884132,63884132,Space Cowboys,Clint Eastwood|Tommy Lee Jones|Donald Sutherland|James Garner|James Cromwell,Clint Eastwood,130,Action|Adventure|Thriller,2000-07-31,211,6.2,2000,82308987,163204960,80895973,6
8711,0.74231,41300000,106371651,65071651,The Whole Nine Yards,Bruce Willis|Matthew Perry|Rosanna Arquette|Michael Clarke Duncan|Kevin Pollak,Jonathan Lynn,98,Comedy|Crime,2000-02-18,313,6.0,2000,52297864,134697582,82399718,6
8712,0.736561999999999,60000000,47383689,-12616311,Almost Famous,Kate Hudson|Billy Crudup|Frances McDormand|Jason Lee|Patrick Fugit,Cameron Crowe,122,Drama|Music,2000-09-15,454,7.3,2000,75977526,60001591,-15975935,7
8713,0.736173,28000000,90449929,62449929,Bring It On,Kirsten Dunst|Jesse Bradford|Huntley Ritter|Eliza Dushku|Gabrielle Union,Peyton Reed,98,Comedy,2000-08-25,409,5.7,2000,35456179,114536031,79079852,6
8714,0.733654,25000000,152500343,127500343,Chocolat,Juliette Binoche|Alfred Molina|Johnny Depp|Carrie-Anne Moss|Judi Dench,Lasse HallstrÃ¶m,121,Comedy|Drama|Romance,2000-12-14,527,6.6,2000,31657302,193109981,161452679,7
8715,0.697768,30000000,47126295,17126295,High Fidelity,John Cusack|Iben Hjejle|Todd Louiso|Jack Black|Lisa Bonet,Stephen Frears,113,Comedy|Drama|Romance|Music,2000-03-17,379,7.0,2000,37988763,59675655,21686892,7
8716,0.697146,80000000,33463969,-46536031,Red Planet,Val Kilmer|Carrie-Anne Moss|Benjamin Bratt|Tom Sizemore|Simon Baker,Antony Hoffman,106,Thriller|Action|Science Fiction,2000-11-10,132,5.3,2000,101303369,42375160,-58928209,5
8717,0.689638,90000000,60874615,-29125385,Mission to Mars,Gary Sinise|Tim Robbins|Don Cheadle|Connie Nielsen|Jerry O'Connell,Brian De Palma,114,Science Fiction,2000-03-10,181,5.6,2000,113966290,77085044,-36881246,6
8718,0.687905,33000000,104155843,71155843,The Cell,Jennifer Lopez|Vincent D'Onofrio|Vince Vaughn|Marianne Jean-Baptiste|Catherine Sutherland,Tarsem Singh,107,Horror|Science Fiction|Thriller,2000-08-17,216,5.7,2000,41787639,131891722,90104083,6
8719,0.664636,46000000,107196498,61196498,Shaft,Samuel L. Jackson|Jeffrey Wright|Christian Bale|Busta Rhymes|Dan Hedaya,John Singleton,99,Action|Adventure|Crime|Thriller,2000-06-15,182,5.3,2000,58249437,135742080,77492643,5
8721,0.66065,63600000,19412993,-44187007,Get Carter,Sylvester Stallone|Miranda Richardson|Rachael Leigh Cook|Mickey Rourke|Johnny Strong,Stephen T. Kay,102,Action|Drama|Thriller|Crime,2000-10-06,77,5.3,2000,80536178,24582519,-55953659,5
8724,0.632783,83000000,59468275,-23531725,The Flintstones in Viva Rock Vegas,Mark Addy|Stephen Baldwin|Kristen Johnston|Jane Krakowski|Joan Collins,Brian Levant,90,Science Fiction|Comedy|Family|Romance,2000-04-28,55,4.4,2000,105102245,75304207,-29798038,4
8726,0.627609,80000000,34566746,-45433254,Thirteen Days,Kevin Costner|Bruce Greenwood|Steven Culp|Dylan Baker|Shawn Driscoll,Roger Donaldson,145,Drama|Thriller,2000-12-24,94,6.6,2000,101303369,43771597,-57531772,7
8727,0.626782,40000000,144056873,104056873,The Beach,Leonardo DiCaprio|Guillaume Canet|Tilda Swinton|Virginie Ledoyen|Staffan Kihlbom,Danny Boyle,119,Drama|Adventure|Romance|Thriller,2000-02-11,683,6.2,2000,50651684,182418082,131766398,6
8730,0.58332,120000000,325756637,205756637,The Perfect Storm,George Clooney|Mark Wahlberg|Diane Lane|John C. Reilly|William Fichtner,Wolfgang Petersen,130,Drama,2000-03-15,315,5.9,2000,151955053,412503060,260548007,6
8734,0.54656,75000000,36754634,-38245366,Titan A.E.,Matt Damon|Bill Pullman|Drew Barrymore|John Leguizamo|Nathan Lane,Don Bluth|Gary Goldman,94,Animation|Action|Science Fiction|Family|Adventure,2000-06-16,184,6.1,2000,94971908,46542103,-48429805,6
8736,0.542611,40000000,161834276,121834276,Scream 3,David Arquette|Neve Campbell|Courteney Cox|Patrick Dempsey|Scott Foley,Wes Craven,116,Horror|Mystery,2000-02-03,390,5.6,2000,50651684,204929467,154277783,6
8738,0.530739,75000000,215663859,140663859,Vertical Limit,Chris O'Donnell|Robin Tunney|Bill Paxton|Scott Glenn|Izabella Scorupco,Martin Campbell,124,Action|Adventure|Thriller,2000-12-08,151,6.0,2000,94971908,273093444,178121536,6
8739,0.525341,42000000,32168970,-9831030,Reindeer Games,Ben Affleck|Gary Sinise|Charlize Theron|Dennis Farina|Donal Logue,John Frankenheimer,124,Thriller,2000-02-25,86,5.2,2000,53184268,40735313,-12448955,5
8743,0.495241,30000000,45554533,15554533,The Tigger Movie,Jim Cummings|Nikita Hopkins|Ken Sansom|John Fiedler|Peter Cullen,Jun Falkenstein,77,Animation|Family,2000-02-11,88,6.5,2000,37988763,57685345,19696582,6
8744,0.49295,11000000,59827328,48827328,Next Friday,Ice Cube|Mike Epps|Justin Pierce|John Witherspoon|Don Curry,Steve Carr,98,Comedy,2000-01-12,70,6.6,2000,13929213,75758873,61829660,7
8745,0.481089,28000000,33000337,5000337,Dracula 2000,Gerard Butler|Christopher Plummer|Jonny Lee Miller|Justine Waddell|Jennifer Esposito,Patrick Lussier,99,Horror|Thriller,2000-12-22,73,4.7,2000,35456179,41788066,6331887,5
8746,0.47571,16000000,109130,-15890870,The Weight of Water,Sean Penn|Catherine McCormack|Elizabeth Hurley|Sarah Polley|Josh Lucas,Kathryn Bigelow,113,Crime|Drama|Mystery,2000-09-25,14,5.1,2000,20260673,138190,-20122483,5
8749,0.468129,14000000,38574362,24574362,Urban Legends: Final Cut,Jennifer Morrison|Matthew Davis|Loretta Devine|Hart Bochner|Anthony Anderson,John Ottman,97,Horror,2000-09-19,48,4.3,2000,17728089,48846410,31118321,4
8750,0.465293,32000000,48814909,16814909,Men of Honor,Robert De Niro|Cuba Gooding Jr.|Charlize Theron|Aunjanue Ellis|Hal Holbrook,"George Tillman, Jr.",129,Drama,2000-09-13,341,7.0,2000,40521347,61813934,21292587,7
8751,0.464139,100000000,155464351,55464351,What Lies Beneath,Harrison Ford|Michelle Pfeiffer|Diana Scarwid|James Remar|Miranda Otto,Robert Zemeckis,130,Drama|Horror|Mystery|Thriller,2000-07-21,234,6.1,2000,126629211,196863281,70234070,6
8752,0.458778,60000000,71000000,11000000,Rules of Engagement,Tommy Lee Jones|Samuel L. Jackson|Guy Pearce|Ben Kingsley|Bruce Greenwood,William Friedkin,128,Action|Adventure|Drama|History|War,2000-04-07,90,5.8,2000,75977526,89906740,13929214,6
8753,0.449041,43000000,80049764,37049764,Finding Forrester,Sean Connery|Rob Brown|F. Murray Abraham|Anna Paquin|Busta Rhymes,Gus Van Sant,136,Drama,2000-12-21,161,6.9,2000,54450560,101366384,46915824,7
8757,0.417675,16000000,20627372,4627372,Boys and Girls,Freddie Prinze Jr.|Claire Forlani|Jason Biggs|Amanda Detmer,Robert Iscove,94,Comedy|Drama|Romance,2000-06-16,53,5.3,2000,20260673,26120278,5859605,5
8759,0.410235,85000000,183611771,98611771,102 Dalmatians,Glenn Close|Ioan Gruffudd|Alice Evans|Tim McInnerny|GÃ©rard Depardieu,Kevin Lima,100,Comedy|Family,2000-10-07,150,5.0,2000,107634829,232506137,124871308,5
8760,1.616724,84000000,123307945,39307945,Nutty Professor II: The Klumps,Eddie Murphy|Janet Jackson|Larry Miller|John Ales|Richard Gant,Peter Segal,106,Fantasy|Comedy|Romance|Science Fiction,2000-07-27,168,4.8,2000,106368537,156143878,49775341,5
8762,0.623706,30000000,37036004,7036004,Keeping the Faith,Ben Stiller|Edward Norton|Jenna Elfman|Anne Bancroft|Eli Wallach,Edward Norton,127,Comedy,2000-04-14,79,5.7,2000,37988763,46898399,8909636,6
8765,0.38535,90000000,14828081,-75171919,Supernova,James Spader|Angela Bassett|Robert Forster|Lou Diamond Phillips|Peter Facinelli,Walter Hill|Jack Sholder,91,Science Fiction,2000-01-14,42,4.7,2000,113966290,18776682,-95189608,5
8769,0.372923,35000000,36779296,1779296,Bounce,Ben Affleck|Gwyneth Paltrow|Joe Morton|Natasha Henstridge|Tony Goldwyn,Don Roos,106,Drama|Romance,2000-11-15,62,5.2,2000,44320224,46573332,2253108,5
8775,0.339608,40000000,30199105,-9800895,The Art of War,Wesley Snipes|Donald Sutherland|Maury Chaykin|Anne Archer|Michael Biehn,Christian Duguay,117,Action|Adventure|Thriller,2000-08-23,67,5.7,2000,50651684,38240888,-12410796,6
8776,0.350814,15000000,9902115,-5097885,Whatever It Takes,Jodi Lyn O'Keefe|Shane West|Marla Sokoloff|James Franco|Aaron Paul,David Raynr,94,Drama|Comedy|Romance,2000-03-31,22,5.0,2000,18994381,12538970,-6455411,5
8778,0.349034,65000000,69700000,4700000,The Kid,Bruce Willis|Spencer Breslin|Emily Mortimer|Lily Tomlin|Chi McBride,Jon Turteltaub,104,Fantasy|Comedy|Family,2000-07-07,141,5.9,2000,82308987,88260560,5951573,6
8781,0.332267,25000000,15843608,-9156392,Highlander: Endgame,Christopher Lambert|Bruce Payne|Adrian Paul|Donnie Yen|Lisa Barbuscia,Douglas Aarniokoski,87,Action|Fantasy|Science Fiction,2000-09-01,49,4.3,2000,31657302,20062635,-11594667,4
8782,0.324003,20000000,27728118,7728118,Love & Basketball,"Chris Warren, Jr.|Kyla Pratt|Sanaa Lathan|Omar Epps|Alfre Woodard",Gina Prince-Bythewood,124,Action|Comedy|Drama|Romance,2000-04-21,54,7.3,2000,25325842,35111897,9786055,7
8788,0.310295,14000000,5108820,-8891180,Gossip,Joshua Jackson|James Marsden|Kate Hudson|Lena Headey|Norman Reedus,Davis Guggenheim,90,Drama|Mystery|Thriller,2000-04-21,34,5.3,2000,17728089,6469258,-11258831,5
8789,0.309754,13500000,7060876,-6439124,Quills,Geoffrey Rush|Kate Winslet|Joaquin Phoenix|Michael Caine|Billie Whitelaw,Philip Kaufman,124,Drama,2000-11-22,52,6.4,2000,17094943,8941131,-8153812,6
8791,0.285304,25000000,24362772,-637228,The Next Best Thing,Madonna|Rupert Everett|Benjamin Bratt|Malcolm Stumpf|Josef Sommer,John Schlesinger,108,Comedy|Drama,2000-03-03,17,3.6,2000,31657302,30850386,-806916,4
8793,0.284476,35000000,15185241,-19814759,Dungeons & Dragons,Justin Whalin|Jeremy Irons|Thora Birch|Bruce Payne|Zoe McLellan,Courtney Solomon,107,Action|Adventure|Fantasy|Science Fiction,2000-12-08,86,3.9,2000,44320224,19228950,-25091274,4
8795,0.279624,24000000,13700000,-10300000,The Ladies Man,Tim Meadows|Karyn Parsons|Billy Dee Williams|John Witherspoon|Jill Talley,Reginald Hudlin,84,Comedy,2000-10-13,14,5.4,2000,30391010,17348201,-13042809,5
8797,0.277798,2000000,1568749,-431251,Hamlet,Ethan Hawke|Kyle MacLachlan|Diane Venora|Sam Shepard|Julia Stiles,Michael Almereyda,112,Drama,2000-05-12,18,5.0,2000,2532584,1986494,-546090,5
8798,0.471019,25000000,260562,-24739438,Under Suspicion,Gene Hackman|Morgan Freeman|Thomas Jane|Monica Bellucci|Nydia Caro,Stephen Hopkins,110,Mystery|Thriller,2000-09-24,49,6.0,2000,31657302,329947,-31327355,6
8799,0.196668,24000000,12372410,-11627590,Ready to Rumble,David Arquette|Scott Caan|Oliver Platt|Rose McGowan|Bill Goldberg,Brian Robbins,107,Action|Comedy|Drama,2000-04-07,16,4.4,2000,30391010,15667085,-14723925,4
8801,0.253319,18000000,17200925,-799075,Center Stage,Amanda Schull|Zoe Saldana|Susan May Pratt|Peter Gallagher|Scottie Thompson,Nicholas Hytner,115,Drama|Music,2000-05-12,49,7.0,2000,22793258,21781395,-1011863,7
8804,0.249219,24000000,36609995,12609995,Return to Me,David Duchovny|Minnie Driver|Carroll O'Connor|Robert Loggia|Jim Belushi,Bonnie Hunt,115,Romance|Comedy|Drama,2000-04-07,32,5.5,2000,30391010,46358947,15967937,5
8808,0.223263,10000000,26330482,16330482,Saving Grace,Brenda Blethyn|Craig Ferguson|Martin Clunes|TchÃ©ky Karyo|Jamie Foreman,Nigel Cole,93,Crime|Comedy,2000-01-24,61,6.2,2000,12662921,33342081,20679160,6
8809,0.222291,1000000,1744858,744858,The Broken Hearts Club: A Romantic Comedy,Ben Weber|Timothy Olyphant|Matt McGrath|Zach Braff|Dean Cain,Greg Berlanti,94,Comedy|Drama|Romance,2000-02-01,10,5.8,2000,1266292,2209499,943207,6
8815,0.207785,16000000,15427192,-572808,Drowning Mona,Danny DeVito|Bette Midler|Neve Campbell|Jamie Lee Curtis|Casey Affleck,Nick Gomez,96,Comedy|Crime|Mystery,2000-03-03,21,4.5,2000,20260673,19535331,-725342,4
8817,0.203554,10000000,1631839,-8368161,Gun Shy,Sandra Bullock|Liam Neeson|Oliver Platt|JosÃ© ZÃºÃ±iga|Michael DeLorenzo,Eric Blakeney,101,Action|Comedy|Romance|Thriller,2000-02-04,10,5.1,2000,12662921,2066384,-10596537,5
8826,0.182246,75000000,157299717,82299717,X-Men,Patrick Stewart|Hugh Jackman|Ian McKellen|Halle Berry|Famke Janssen,Bryan Singer,104,Adventure|Action|Science Fiction,2000-07-13,2766,6.6,2000,94971908,199187391,104215483,7
8860,0.12392,22000000,13555988,-8444012,The Little Vampire,Richard E. Grant|Jonathan Lipnicki|Jim Carter|Alice Krige|Pamela Gidley,Uli Edel,95,Horror|Family|Foreign,2000-10-27,42,6.4,2000,27858426,17165840,-10692586,6
8862,0.119214,8000000,8279017,279017,Shadow of the Vampire,John Malkovich|Willem Dafoe|Udo Kier|Cary Elwes|Catherine McCormack,E. Elias Merhige,92,Drama|Horror,2000-05-15,55,5.9,2000,10130336,10483653,353317,6
8866,0.104908,76000000,35134820,-40865180,The Adventures of Rocky & Bullwinkle,Rene Russo|Jason Alexander|Piper Perabo|Randy Quaid|Robert De Niro,Des McAnuff,88,Adventure|Animation|Action|Comedy|Family,2000-06-30,35,4.0,2000,96238200,44490945,-51747255,4
8868,0.091492,7000000,3728888,-3271112,The Big Kahuna,Kevin Spacey|Danny DeVito|Peter Facinelli|Paul Dawson|Christopher Donahue,John Swanbeck,90,Comedy|Drama,2000-04-28,37,6.5,2000,8864044,4721861,-4142183,6
8881,0.031018,40000000,36037909,-3962091,Hanging Up,Meg Ryan|Diane Keaton|Lisa Kudrow|Walter Matthau|Adam Arkin,Diane Keaton,94,Comedy|Drama,2000-02-16,21,5.2,2000,50651684,45634519,-5017165,5
8883,0.015997,15000000,5217498,-9782502,The In Crowd,Susan Ward|Lori Heuring|Matthew Settle|Nathan Bexton|Tess Harper,Mary Lambert,105,Thriller,2000-07-19,12,5.2,2000,18994381,6606876,-12387505,5
8888,4.215642,28000000,32768670,4768670,Blade Runner,Harrison Ford|Rutger Hauer|Sean Young|Edward James Olmos|Joe Turkel,Ridley Scott,117,Science Fiction|Drama|Thriller,1982-06-25,2110,7.7,1982,63269987,74045476,10775489,8
8889,2.900556,10500000,792910554,782410554,E.T. the Extra-Terrestrial,Henry Thomas|Drew Barrymore|Robert MacNaughton|Dee Wallace|Peter Coyote,Steven Spielberg,115,Science Fiction|Adventure|Family|Fantasy,1982-04-03,1830,7.2,1982,23726245,1791694309,1767968064,7
8890,2.355353,10000000,13782838,3782838,The Thing,Kurt Russell|Keith David|Wilford Brimley|Donald Moffat|Richard Dysart,John Carpenter,109,Horror|Science Fiction|Mystery|Thriller,1982-06-25,797,7.5,1982,22596424,31144285,8547861,7
8891,1.928258,15000000,125212904,110212904,First Blood,Sylvester Stallone|Richard Crenna|Brian Dennehy|Bill McKinney|Jack Starrett,Ted Kotcheff,93,Action|Adventure|Thriller|War,1982-10-22,838,7.0,1982,33894636,282936387,249041751,7
8893,1.336612,17000000,33000000,16000000,Tron,Jeff Bridges|Bruce Boxleitner|David Warner|Cindy Morgan|Barnard Hughes,Steven Lisberger,96,Science Fiction|Action|Adventure,1982-07-09,432,6.6,1982,38413920,74568199,36154279,7
8894,1.241425,17000000,124000000,107000000,Rocky III,Sylvester Stallone|Talia Shire|Burt Young|Carl Weathers|Burgess Meredith,Sylvester Stallone,99,Drama,1982-05-28,482,6.5,1982,38413920,280195657,241781737,6
8895,1.193916,10700000,122200000,111500000,Poltergeist,JoBeth Williams|Craig T. Nelson|Beatrice Straight|Heather O'Rourke|Dominique Dunne,Tobe Hooper,114,Horror,1982-06-04,425,6.8,1982,24178173,276128301,251950128,7
8896,1.176922,20000000,68851475,48851475,Conan the Barbarian,Arnold Schwarzenegger|James Earl Jones|Max von Sydow|Sandahl Bergman|Cassandra Gava,John Milius,129,Adventure|Fantasy|Action,1982-04-02,356,6.5,1982,45192848,155579712,110386864,6
8897,1.161942,1000000,78868508,77868508,48 Hrs.,Nick Nolte|Eddie Murphy|Annette O'Toole|Frank McRae|James Remar,Walter Hill,96,Thriller|Action|Comedy|Crime|Drama,1982-12-07,171,6.1,1982,2259642,178214624,175954982,6
8898,0.946056,12000000,96800000,84800000,Star Trek II: The Wrath of Khan,William Shatner|Leonard Nimoy|DeForest Kelley|James Doohan|George Takei,Nicholas Meyer,113,Science Fiction|Action|Adventure|Drama|Thriller,1982-06-03,406,7.0,1982,27115708,218733384,191617676,7
8899,0.925383,4500000,27092880,22592880,Fast Times at Ridgemont High,Sean Penn|Jennifer Jason Leigh|Judge Reinhold|Phoebe Cates|Brian Backer,Amy Heckerling,90,Comedy,1982-08-13,157,6.9,1982,10168390,61220220,51051830,7
8901,0.884844,15000000,40577001,25577001,The Dark Crystal,Jim Henson|Kathryn Mullen|Frank Oz|Dave Goelz|Steve Whitmire,Jim Henson|Frank Oz,93,Fantasy,1982-12-17,123,7.3,1982,33894636,91689512,57794876,7
8903,0.786388,22000000,77737889,55737889,Gandhi,Ben Kingsley|Rohini Hattangadi|Candice Bergen|Roshan Seth|Om Puri,Richard Attenborough,191,Drama|History,1982-11-30,412,7.1,1982,49712132,175659830,125947698,7
8904,0.689094,21000000,177200000,156200000,Tootsie,Dustin Hoffman|Jessica Lange|Teri Garr|Dabney Coleman|Charles Durning,Sydney Pollack,116,Comedy|Romance,1982-12-16,176,6.7,1982,47452490,400408633,352956143,7
8911,0.555585,7000000,14665733,7665733,The Secret of NIMH,Derek Jacobi|Elizabeth Hartman|Arthur Malet|Dom DeLuise|Hermione Baddeley,Don Bluth,82,Fantasy|Animation|Drama|Family,1982-06-17,80,7.3,1982,15817496,33139312,17321816,7
8916,0.483395,12000000,30036000,18036000,Sophie's Choice,Meryl Streep|Kevin Kline|Peter MacNicol|Rita Karin|Stephen D. Newman,Alan J. Pakula,151,Drama|Romance,1982-12-08,74,7.1,1982,27115708,67870619,40754911,7
8918,0.475775,13200000,15171476,1971476,Grease 2,Maxwell Caulfield|Michelle Pfeiffer|Lorna Luft|Maureen Teefy|Pamela Adlon,Patricia Birch,115,Comedy|Drama|Family|Music|Romance,1982-06-11,92,5.3,1982,29827279,34282110,4454831,5
8919,0.441852,8000000,21028755,13028755,Creepshow,Leslie Nielsen|Ed Harris|Hal Holbrook|Ted Danson|Stephen King,George A. Romero,120,Horror|Comedy|Fantasy,1982-11-12,90,6.7,1982,18077139,47517466,29440327,7
8920,0.421748,50000000,57059003,7059003,Annie,Aileen Quinn|Albert Finney|Carol Burnett|Ann Reinking|Tim Curry,John Huston,127,Comedy|Drama|Family|Music,1982-06-18,99,6.2,1982,112982120,128932942,15950822,6
8928,0.358107,6000000,10278575,4278575,The Year of Living Dangerously,Mel Gibson|Sigourney Weaver|Linda Hunt|Michael Murphy|Bill Kerr,Peter Weir,115,War|Drama|Romance,1982-12-17,31,6.7,1982,13557854,23225903,9668049,7
8930,0.336314,4000000,36690067,32690067,Friday the 13th Part III,Dana Kimmell|Paul Kratka|Tracie Savage|Jeffrey Rogers|Catherine Parks,Steve Miner,95,Horror|Thriller,1982-08-13,107,5.7,1982,9038569,82906431,73867862,6
8932,0.310497,2500000,14400000,11900000,Halloween III: Season of the Witch,Tom Atkins|Stacey Nelkin|Dan O'Herlihy|Michael Currie|Ralph Strait,Tommy Lee Wallace,96,Horror|Mystery|Science Fiction,1982-10-22,90,4.7,1982,5649106,32538850,26889744,5
8933,0.304359,16000000,53977250,37977250,The Verdict,Paul Newman|Charlotte Rampling|Jack Warden|James Mason|Milo O'Shea,Sidney Lumet,129,Drama,1982-12-08,47,7.0,1982,36154278,121969282,85815004,7
8936,0.647107,18000000,70687344,52687344,Firefox,Clint Eastwood|Freddie Jones|David Huffman|Warren Clarke|Ronald Lacey,Clint Eastwood,136,Science Fiction|Action|Adventure|Thriller,1982-06-13,60,5.1,1982,40673563,159728119,119054556,5
8944,0.464188,2,16,14,Death Wish 2,Charles Bronson|Jill Ireland|Vincent Gardenia|J. D. Cannon|Robin Sherwood,Michael Winner,88,Action|Crime|Thriller,1982-02-20,27,5.6,1982,4,36,32,6
8950,0.138161999999999,3500000,20659423,17159423,The Man from Snowy River,Tom Burlinson|Terence Donovan|Kirk Douglas|Tommy Dysart|Bruce Kerr,George T. Miller,104,Drama|Action|Western|Romance,1982-03-02,19,6.2,1982,7908748,46682908,38774160,6
8969,4.18054,60000000,264118201,204118201,The Truman Show,Jim Carrey|Laura Linney|Noah Emmerich|Natascha McElhone|Ed Harris,Peter Weir,103,Comedy|Drama,1998-06-04,2392,7.6,1998,80261728,353309720,273047992,8
8970,2.993102,140000000,553799566,413799566,Armageddon,Bruce Willis|Billy Bob Thornton|Ben Affleck|Liv Tyler|Will Patton,Michael Bay,151,Action|Thriller|Science Fiction|Adventure,1998-07-01,1559,6.4,1998,187277365,740815170,553537805,6
8971,2.770692,90000000,304320254,214320254,Mulan,Ming-Na Wen|Lea Salonga|June Foray|Soon-Tek Oh|Freda Foh Shen,Tony Bancroft|Barry Cook,88,Animation|Family|Adventure,1998-06-18,1066,7.3,1998,120392592,407087824,286695232,7
8972,2.729745,45000000,131183530,86183530,Blade,Wesley Snipes|Stephen Dorff|Kris Kristofferson|N'Bushe Wright|Donal Logue,Stephen Norrington,120,Horror|Action,1998-08-21,1263,6.3,1998,60196296,175483613,115287317,6
8973,2.556082,15000000,27739163,12739163,The Big Lebowski,Jeff Bridges|John Goodman|Steve Buscemi|Julianne Moore|David Huddleston,Joel Coen,117,Comedy|Crime,1998-02-15,1696,7.6,1998,20065432,37106552,17041120,8
8974,2.170136,70000000,481840909,411840909,Saving Private Ryan,Tom Hanks|Tom Sizemore|Dennis Farina|Max Martini|Joerg Stadler,Steven Spielberg,169,Drama|History|War,1998-07-24,3396,7.7,1998,93638682,644556400,550917718,8
8976,2.045755,33000000,244386864,211386864,Rush Hour,Jackie Chan|Chris Tucker|Ken Leung|Tom Wilkinson|Tzi Ma,Brett Ratner,98,Action|Comedy|Crime|Thriller,1998-09-18,727,6.8,1998,44143950,326915200,282771250,7
8977,2.005566,120000000,363398565,243398565,A Bug's Life,Kevin Spacey|Julia Louis-Dreyfus|Hayden Panettiere|Phyllis Diller|Bonnie Hunt,John Lasseter|Andrew Stanton,95,Family|Animation,1998-11-25,1159,6.6,1998,160523456,486116613,325593157,7
8978,1.855981,70000000,218613188,148613188,The Prince of Egypt,Val Kilmer|Ralph Fiennes|Patrick Stewart|Michelle Pfeiffer|Sandra Bullock,Brenda Chapman|Steve Hickner|Simon Wells,99,Adventure|Animation|Drama|Family|Music,1998-12-15,432,6.7,1998,93638682,292437871,198799189,7
8979,1.80704,60000000,171757863,111757863,Antz,Woody Allen|Dan Aykroyd|Anne Bancroft|Danny Glover|Gene Hackman,Eric Darnell|Tim Johnson,83,Adventure|Animation|Comedy|Family,1998-10-02,714,6.0,1998,80261728,229759715,149497987,6
8981,1.46043,55000000,41610884,-13389116,Ronin,Robert De Niro|Jean Reno|Natascha McElhone|Stellan SkarsgÃ¥rd|Sean Bean,John Frankenheimer,122,Action|Thriller|Crime|Adventure,1998-09-12,363,6.6,1998,73573250,55662690,-17910560,7
8982,1.422685,27000000,27200316,200316,Dark City,Rufus Sewell|William Hurt|Kiefer Sutherland|Jennifer Connelly|Richard O'Brien,Alex Proyas,100,Mystery|Science Fiction,1998-02-27,466,7.0,1998,36117777,36385739,267962,7
8984,1.408985,20000000,67200000,47200000,Wild Things,Matt Dillon|Kevin Bacon|Denise Richards|Neve Campbell|Theresa Russell,John McNaughton,108,Crime|Drama|Mystery,1998-03-20,231,6.1,1998,26753909,89893135,63139226,6
8985,1.379837,23000000,369884651,346884651,There's Something About Mary,Cameron Diaz|Ben Stiller|Matt Dillon|Lee Evans|Chris Elliott,Bobby Farrelly|Peter Farrelly,119,Romance|Comedy,1998-07-15,980,6.5,1998,30766995,494793021,464026026,6
8986,1.339249,66000000,189198313,123198313,The X Files,David Duchovny|Gillian Anderson|Mitch Pileggi|William B. Davis|John Neville,Rob Bowman,121,Mystery|Science Fiction|Thriller,1998-06-19,244,6.3,1998,88287900,253089726,164801826,6
8987,1.333006,20000000,23875127,3875127,American History X,Edward Norton|Edward Furlong|Beverly D'Angelo|Avery Brooks|Jennifer Lien,Tony Kaye,119,Drama,1998-10-30,1563,8.0,1998,26753909,31937649,5183740,8
8988,1.316855,85000000,71485043,-13514957,What Dreams May Come,Robin Williams|Cuba Gooding Jr.|Annabella Sciorra|Max von Sydow|Jessica Brooks Grant,Vincent Ward,113,Drama|Fantasy|Romance,1998-10-02,328,6.7,1998,113704114,95625218,-18078896,7
8989,1.303667,90000000,250649836,160649836,Enemy of the State,Will Smith|Gene Hackman|Jon Voight|Lisa Bonet|Regina King,Tony Scott,132,Action|Drama|Thriller,1998-11-20,815,6.5,1998,120392592,335293149,214900557,6
8991,1.283006,75000000,140464664,65464664,Deep Impact,Robert Duvall|TÃ©a Leoni|Elijah Wood|Vanessa Redgrave|Morgan Freeman,Mimi Leder,120,Action|Adventure|Drama|Romance|Science Fiction,1998-05-07,490,5.6,1998,100327160,187898944,87571784,6
8992,1.282567,80000000,136159423,56159423,Lost in Space,Gary Oldman|William Hurt|Matt LeBlanc|Mimi Rogers|Heather Graham,Stephen Hopkins,130,Adventure|Family|Science Fiction,1998-04-03,207,4.9,1998,107015637,182139843,75124206,5
8993,1.242498,50000000,44547681,-5452319,The Negotiator,Samuel L. Jackson|Kevin Spacey|David Morse|Ron Rifkin|John Spencer,F. Gary Gray,140,Action|Adventure|Crime|Drama|Mystery,1998-07-29,337,6.7,1998,66884773,59591231,-7293542,7
8994,1.22669,90000000,142940100,52940100,Meet Joe Black,Brad Pitt|Anthony Hopkins|Claire Forlani|Jeffrey Tambor|Marcia Gay Harden,Martin Brest,178,Fantasy|Drama|Mystery,1998-11-12,673,6.8,1998,120392592,191210324,70817732,7
8995,1.206274,140000000,285444603,145444603,Lethal Weapon 4,Mel Gibson|Danny Glover|Joe Pesci|Rene Russo|Jet Li,Richard Donner,127,Action|Adventure|Comedy|Crime|Drama,1998-07-10,438,6.1,1998,187277365,381837952,194560587,6
8996,1.175952,65000000,40002112,-24997888,I Still Know What You Did Last Summer,Jennifer Love Hewitt|Freddie Prinze Jr.|Mekhi Phifer|Brandy Norwood|Muse Watson,Danny Cannon,100,Horror|Mystery|Thriller,1998-11-13,198,4.9,1998,86950205,53510643,-33439562,5
8997,1.170499,130000000,379014294,249014294,Godzilla,Matthew Broderick|Jean Reno|Maria Pitillo|Hank Azaria|Kevin Dunn,Roland Emmerich,139,Science Fiction|Action|Thriller,1998-05-19,582,5.1,1998,173900410,507005703,333105293,5
8998,1.164656,75000000,46683377,-28316623,Practical Magic,Sandra Bullock|Nicole Kidman|Evan Rachel Wood|Goran Visnjic|Stockard Channing,Griffin Dunne,104,Drama|Fantasy|Comedy,1998-10-16,185,6.2,1998,100327160,62448141,-37879019,6
8999,1.152417,75000000,13100000,-61900000,Sphere,Dustin Hoffman|Sharon Stone|Samuel L. Jackson|Peter Coyote|Liev Schreiber,Barry Levinson,134,Science Fiction,1998-02-13,238,5.6,1998,100327160,17523810,-82803350,6
9000,1.095887,70000000,164000000,94000000,Six Days Seven Nights,Harrison Ford|Anne Heche|David Schwimmer|Jacqueline Obradors|Temuera Morrison,Ivan Reitman,98,Action|Adventure|Comedy|Romance,1998-06-12,176,5.6,1998,93638682,219382056,125743374,6
9001,1.090942,18500000,10680275,-7819725,Fear and Loathing in Las Vegas,Johnny Depp|Benicio del Toro|Tobey Maguire|Christina Ricci|Ellen Barkin,Terry Gilliam,118,Adventure|Drama|Comedy,1998-05-22,714,7.1,1998,24747366,14286955,-10460411,7
9002,1.059234,25000000,289317794,264317794,Shakespeare in Love,Joseph Fiennes|Gwyneth Paltrow|Geoffrey Rush|Tom Wilkinson|Judi Dench,John Madden,122,History,1998-12-11,399,6.7,1998,33442386,387019102,353576716,7
9003,1.057585,95000000,250288523,155288523,The Mask of Zorro,Antonio Banderas|Anthony Hopkins|Catherine Zeta-Jones|Stuart Wilson|Diego Sieres,Martin Campbell,136,Adventure|Comedy|Western|Romance|Thriller,1998-07-16,734,6.1,1998,127081069,334809823,207728754,6
9004,1.053252,23000000,185991646,162991646,The Waterboy,Adam Sandler|Kathy Bates|Fairuza Balk|Henry Winkler|Jerry Reed,Frank Coraci,90,Comedy,1998-11-06,292,5.8,1998,30766995,248800182,218033187,6
9005,1.041331,60000000,128038368,68038368,A Perfect Murder,Michael Douglas|Gwyneth Paltrow|Viggo Mortensen|Sarita Choudhury|Constance Towers,Andrew Davis,107,Crime|Thriller|Drama,1998-06-04,158,6.3,1998,80261728,171276344,91014616,6
9006,1.011829,60000,3221152,3161152,Pi,Sean Gullette|Mark Margolis|Ben Shenkman|Pamela Hart|Stephen Pearlman,Darren Aronofsky,84,Mystery|Drama|Thriller,1998-07-10,286,6.9,1998,80261,4308920,4228659,7
9007,1.001818,55000000,198685114,143685114,City of Angels,Nicolas Cage|Meg Ryan|Andre Braugher|Dennis Franz|Colm Feore,Brad Silberling,114,Drama|Fantasy|Romance,1998-04-10,323,6.4,1998,73573250,265780176,192206926,6
9009,0.992143,52000000,98126565,46126565,The Thin Red Line,Sean Penn|Adrien Brody|Jim Caviezel|Ben Chaplin|George Clooney,Terrence Malick,170,Drama|History|War,1998-12-25,413,6.8,1998,69560164,131263461,61703297,7
9011,0.968861,40000000,54682547,14682547,Small Soldiers,Gregory Smith|Kirsten Dunst|Denis Leary|Phil Hartman|David Cross,Joe Dante,110,Comedy|Adventure|Fantasy|Science Fiction|Action,1998-07-10,271,6.1,1998,53507818,73148595,19640777,6
9012,0.962802,71000000,294456605,223456605,Doctor Dolittle,Eddie Murphy|Ossie Davis|Oliver Platt|Peter Boyle|Richard Schiff,Betty Thomas,85,Comedy|Family|Fantasy,1998-06-22,353,5.3,1998,94976378,393893266,298916888,5
9013,0.931643,70000000,118000000,48000000,Star Trek: Insurrection,Patrick Stewart|Jonathan Frakes|Brent Spiner|LeVar Burton|Gates McFadden,Jonathan Frakes,103,Science Fiction|Action|Adventure|Thriller,1998-12-10,230,6.2,1998,93638682,157848065,64209383,6
9014,0.922354,65000000,250821495,185821495,You've Got Mail,Tom Hanks|Meg Ryan|Katie Sagona|Greg Kinnear|Parker Posey,Nora Ephron,119,Comedy|Romance,1998-12-17,498,6.2,1998,86950205,335522777,248572572,6
9015,0.904602,60000000,102367405,42367405,U.S. Marshals,Tommy Lee Jones|Wesley Snipes|Robert Downey Jr.|Joe Pantoliano|Daniel Roebuck,Stuart Baird,131,Thriller|Crime|Action,1998-03-05,194,6.1,1998,80261728,136936413,56674685,6
9016,0.893937,30000000,82150642,52150642,Elizabeth,Cate Blanchett|Geoffrey Rush|Christopher Eccleston|Joseph Fiennes|Richard Attenborough,Shekhar Kapur,124,Drama|History,1998-09-13,173,6.8,1998,40130864,109892541,69761677,7
9017,0.884735,48000000,77745568,29745568,Out of Sight,George Clooney|Jennifer Lopez|Michael Keaton|Samuel L. Jackson|Dennis Farina,Steven Soderbergh,123,Romance|Comedy|Crime,1998-06-26,181,6.3,1998,64209382,103999894,39790512,6
9018,0.878645,18000000,123306987,105306987,The Wedding Singer,Adam Sandler|Drew Barrymore|Christine Taylor|Allen Covert|Jon Lovitz,Frank Coraci,95,Romance|Comedy,1998-02-13,375,6.4,1998,24078518,164947197,140868679,6
9020,0.823963999999999,26000000,65705772,39705772,EverAfter,Drew Barrymore|Dougray Scott|Anjelica Huston|Megan Dodds|Melanie Lynskey,Andy Tennant,121,Drama|Romance|Comedy,1998-07-31,224,6.8,1998,34780082,87894313,53114231,7
9021,0.792566,50000000,202292902,152292902,Patch Adams,Robin Williams|Philip Seymour Hoffman|Bob Gunton|Peter Coyote|Michael Jeter,Tom Shadyac,115,Comedy|Drama,1998-12-25,483,6.9,1998,66884773,270606298,203721525,7
9023,0.783938,14000000,72527595,58527595,Urban Legend,Alicia Witt|Jared Leto|Rebecca Gayheart|Michael Rosenbaum|Loretta Devine,Jamie Blanks,99,Horror|Thriller,1998-09-25,144,5.4,1998,18727736,97019835,78292099,5
9025,0.760447,12000000,22921898,10921898,Rounders,Matt Damon|John Turturro|Gretchen Mol|Goran Visnjic|Edward Norton,John Dahl,121,Drama|Crime,1998-09-11,213,6.6,1998,16052345,30662519,14610174,7
9027,0.722411999999999,15000000,17507368,2507368,Disturbing Behavior,James Marsden|Katie Holmes|Nick Stahl|Steve Railsback|Bruce Greenwood,David Nutter,82,Horror|Thriller|Science Fiction,1998-07-24,45,5.6,1998,20065432,23419526,3354094,6
9028,0.718275,90000000,69131860,-20868140,Babe: Pig in the City,James Cromwell|Mary Stein|Mickey Rooney|Magda Szubanski|E.G. Daily,George Miller,92,Adventure|Comedy|Drama|Family|Fantasy,1998-11-25,176,5.1,1998,120392592,92477375,-27915217,5
9030,0.699006999999999,1350000,3897569,2547569,"Lock, Stock and Two Smoking Barrels",Jason Flemyng|Dexter Fletcher|Nick Moran|Jason Statham|Vinnie Jones,Guy Ritchie,105,Comedy|Crime,1998-03-05,1167,7.3,1998,1805888,5213760,3407872,7
9034,0.669113,17000000,30331165,13331165,A Night at the Roxbury,Will Ferrell|Chris Kattan|Jennifer Coolidge|Michael Clarke Duncan|Eva Mendes,John Fortenberry,81,Comedy,1998-10-01,96,6.2,1998,22740822,40573861,17833039,6
9035,0.653163,60000000,186883563,126883563,The Horse Whisperer,Robert Redford|Kristin Scott Thomas|Sam Neill|Scarlett Johansson|Dianne Wiest,Robert Redford,170,Drama|Romance,1998-05-14,164,7.0,1998,80261728,249993295,169731567,7
9038,0.640933,25000000,50671850,25671850,Bride of Chucky,Ed Gale|Jennifer Tilly|Brad Dourif|Katherine Heigl|Nick Stabile,Ronny Yu,89,Comedy|Horror,1998-10-16,162,5.4,1998,33442386,67783504,34341118,5
9040,0.616116,13000000,16757163,3757163,54,Ryan Phillippe|Salma Hayek|Mike Myers|Neve Campbell|Sherry Stringfield,Mark Christopher,93,Music|Drama,1998-08-28,71,5.5,1998,17390041,22415981,5025940,5
9041,0.607687,25000000,55494066,30494066,Great Expectations,Gwyneth Paltrow|Ethan Hawke|Chris Cooper|Anne Bancroft|Robert De Niro,Alfonso CuarÃ³n,111,Comedy|Drama|Romance,1998-01-19,74,6.5,1998,33442386,74234160,40791774,6
9043,0.577192,70000000,116672912,46672912,The Siege,Denzel Washington|Annette Bening|Bruce Willis|Tony Shalhoub|Sami Bouajila,Edward Zwick,116,Drama|Action|Thriller|Crime,1998-11-05,196,6.0,1998,93638682,156072825,62434143,6
9044,0.576681999999999,73000000,103891409,30891409,Snake Eyes,Nicolas Cage|Gary Sinise|John Heard|Carla Gugino|Tamara Tunie,Brian De Palma,98,Crime|Mystery,1998-08-07,152,5.6,1998,97651769,138975067,41323298,6
9047,0.562005,6000000,58000000,52000000,Sliding Doors,Gwyneth Paltrow|John Hannah|John Lynch|Jeanne Tripplehorn,Peter Howitt,99,Comedy|Drama|Fantasy|Romance,1998-04-23,196,6.4,1998,8026172,77586337,69560165,6
9051,0.539133,60000000,48522832,-11477168,The Avengers,Ralph Fiennes|Uma Thurman|Sean Connery|Patrick Macnee|Jim Broadbent,Jeremiah S. Chechik,89,Thriller,1998-08-13,121,4.6,1998,80261728,64908772,-15352956,5
9054,0.53388,20000000,18253415,-1746585,Simon Birch,Jim Carrey|Ashley Judd|Ian Michael Smith|Joseph Mazzello|Oliver Platt,Mark Steven Johnson,114,Comedy|Drama|Family,1998-09-11,24,6.9,1998,26753909,24417510,-2336399,7
9055,0.521096,13000000,27007143,14007143,The Big Hit,"Mark Wahlberg|Lou Diamond Phillips|Christina Applegate|Avery Brooks|Antonio SabÃ to, Jr.",Kirk Wong,91,Action|Adventure|Comedy|Thriller,1998-04-24,59,6.1,1998,17390041,36127332,18737291,6
9057,0.497373,28000000,14051384,-13948616,Blues Brothers 2000,Dan Aykroyd|John Goodman|Joe Morton|J. Evan Bonifant|B.B. King,John Landis,123,Music|Action|Comedy|Crime,1998-02-05,72,5.6,1998,37455473,18796472,-18659001,6
9058,0.496059,25000000,21567853,-3432147,He Got Game,Denzel Washington|Ray Allen|Milla Jovovich|Rosario Dawson|Hill Harper,Spike Lee,136,Drama,1998-05-01,79,6.6,1998,33442386,28851219,-4591167,7
9059,0.492559,70000000,19870567,-50129433,Hard Rain,Morgan Freeman|Christian Slater|Randy Quaid|Minnie Driver|Ed Asner,Mikael Salomon,97,Thriller,1998-01-16,74,5.4,1998,93638682,26580767,-67057915,5
9060,0.488243,70000000,56702901,-13297099,A Civil Action,John Travolta|Robert Duvall|Tony Shalhoub|William H. Macy|Zeljko Ivanek,Steven Zaillian,115,Drama,1998-03-05,48,6.0,1998,93638682,75851213,-17787469,6
9063,0.477036,3000000,2807390,-192610,Happiness,Jane Adams|Jon Lovitz|Philip Seymour Hoffman|Dylan Baker|Evan Silverberg,Todd Solondz,139,Comedy|Drama,1998-10-16,75,6.9,1998,4013086,3755432,-257654,7
9064,0.469693,30000000,19204929,-10795071,The Replacement Killers,Chow Yun-fat|Mira Sorvino|Michael Rooker|Kenneth Tsang|JÃ¼rgen Prochnow,Antoine Fuqua,87,Drama|Action|Crime|Thriller,1998-02-06,62,6.2,1998,40130864,25690346,-14440518,6
9072,0.433845,15000000,40283321,25283321,The Faculty,Jordana Brewster|Elijah Wood|Clea DuVall|Laura Harris|Josh Hartnett,Robert Rodriguez,104,Horror|Mystery|Science Fiction,1998-12-25,237,6.1,1998,20065432,53886815,33821383,6
9073,0.423925,20000000,3970078,-16029922,Playing by Heart,Gillian Anderson|Ellen Burstyn|Sean Connery|Anthony Edwards|Angelina Jolie,Willard Carroll,121,Comedy|Drama|Romance,1998-12-30,20,6.7,1998,26753909,5310755,-21443154,7
9083,0.396129,10000000,25605015,15605015,Can't Hardly Wait,Jennifer Love Hewitt|Ethan Embry|Charlie Korsmo|Lauren Ambrose|Peter Facinelli,Harry Elfont|Deborah Kaplan,100,Comedy|Drama|Romance,1998-06-12,74,6.2,1998,13376954,34251712,20874758,6
9084,0.388858,17000000,55041738,38041738,Halloween: H20,Jamie Lee Curtis|Josh Hartnett|Adam Arkin|Michelle Williams|Joseph Gordon-Levitt,Steve Miner,86,Horror|Thriller,1998-08-05,142,5.7,1998,22740822,73629083,50888261,6
9085,0.38868,60000000,37141130,-22858870,Psycho,Vince Vaughn|Anne Heche|Julianne Moore|Viggo Mortensen|William H. Macy,Gus Van Sant,105,Horror|Mystery|Thriller,1998-12-04,112,4.9,1998,80261728,49683521,-30578207,5
9088,0.383321,45000000,11203026,-33796974,Deep Rising,Treat Williams|Famke Janssen|Anthony Heald|Kevin J. O'Connor|Una Damon,Stephen Sommers,106,Adventure|Action|Horror|Science Fiction,1998-01-30,61,5.8,1998,60196296,14986237,-45210059,6
9089,0.375143,18000000,9495408,-8504592,The Red Violin,Carlo Cecchi|Irene Grazioli|Anita Laurenzi|Tommaso Puntelli|Samuele Amighetti,FranÃ§ois Girard,131,Drama|Thriller|Mystery|Music|Romance,1998-09-10,49,6.6,1998,24078518,12701964,-11376554,7
9091,0.366598,30000000,9898412,-20101588,Very Bad Things,Jon Favreau|Leland Orser|Cameron Diaz|Christian Slater|Jeremy Piven,Peter Berg,100,Comedy|Crime|Thriller,1998-09-11,83,6.2,1998,40130864,13241060,-26889804,6
9092,0.577579,75000000,14567883,-60432117,Soldier,Kurt Russell|Jason Scott Lee|Jason Isaacs|Connie Nielsen|Sean Pertwee,Paul W.S. Anderson,99,Action|War|Science Fiction,1998-10-23,94,5.8,1998,100327160,19487391,-80839769,6
9094,0.349511,5000000,5879254,879254,The Opposite of Sex,Christina Ricci|Martin Donovan|Lisa Kudrow|Lyle Lovett|Johnny Galecki,Don Roos,105,Comedy|Drama,1998-05-22,28,5.4,1998,6688477,7864651,1176174,5
9104,0.305742,30000000,29202884,-797116,Bulworth,Warren Beatty|Halle Berry|Sean Astin|Christine Baranski|Adilah Barnes,Warren Beatty,108,Comedy|Drama,1998-05-15,27,6.2,1998,40130864,39064565,-1066299,6
9114,0.263935,1500000,2375097,875097,Buffalo '66,Vincent Gallo|Christina Ricci|Ben Gazzara|Mickey Rourke|Rosanna Arquette,Vincent Gallo,110,Romance|Comedy|Crime|Drama,1998-01-20,84,6.9,1998,2006543,3177156,1170613,7
9115,0.262171,8000000,17460020,9460020,Half Baked,Dave Chappelle|Tommy Chong|Harland Williams|Guillermo DÃ­az|Jim Breuer,Tamra Davis,82,Comedy|Crime,1998-01-16,86,6.3,1998,10701563,23356189,12654626,6
9118,0.189141,10000000,6451628,-3548372,Gods and Monsters,Ian McKellen|Brendan Fraser|Lynn Redgrave|Lolita Davidovich|David Dukes,Bill Condon,105,Drama,1998-01-21,23,5.6,1998,13376954,8630313,-4746641,6
9119,0.245817,25000000,777423,-24222577,Without Limits,Billy Crudup|Donald Sutherland|Monica Potter|Jeremy Sisto|Matthew Lillard,Robert Towne,117,Drama,1998-09-11,11,6.0,1998,33442386,1039955,-32402431,6
9121,0.240661,10000000,19000000,9000000,Jane Austen's Mafia!,Jay Mohr|Billy Burke|Christina Applegate|Pamela Gidley|Olympia Dukakis,Jim Abrahams,84,Comedy|Crime,1998-07-24,19,5.7,1998,13376954,25416213,12039259,6
9123,0.235951,5000000,1980338,-3019662,Zero Effect,Bill Pullman|Ben Stiller|Ryan O'Neal|Kim Dickens|Angela Featherstone,Jake Kasdan,116,Comedy|Crime|Mystery|Thriller,1998-01-30,24,5.8,1998,6688477,2649089,-4039388,6
9127,0.226558,2000000,124494,-1875506,Six-String Samurai,Jeffrey Falcon|Justin McGuire|Kim De Angelo|Stephane Gauger|Clifford Hugo,Lance Mungia,91,Action|Adventure|Science Fiction,1998-09-18,15,5.8,1998,2675390,166535,-2508855,6
9134,0.214567,1500000,870751,-629249,Edge of Seventeen,Chris Stafford|Tina Holmes|Andersen Gabrych|Stephanie McVay|Lea DeLaria,David Moreton,99,Comedy|Drama|Romance,1998-05-14,10,4.8,1998,2006543,1164799,-841744,5
9141,0.194358,15000000,10443316,-4556684,Home Fries,Drew Barrymore|Catherine O'Hara|Luke Wilson|Jake Busey|Shelley Duvall,Dean Parisot,93,Drama|Comedy|Romance,1998-11-25,18,4.7,1998,20065432,13969976,-6095456,5
9145,0.188201,1100000,631221,-468779,Strangeland,Kevin Gage|Elizabeth PeÃ±a|Brett Harrelson|Robert Englund|Linda Cardellini,John Pieplow,86,Horror,1998-10-02,14,4.8,1998,1471465,844381,-627084,5
9147,0.18358,15000000,46905889,31905889,The Object of My Affection,Jennifer Aniston|Paul Rudd|Hayden Panettiere|Alan Alda|Allison Janney,Nicholas Hytner,111,Comedy|Drama|Romance,1998-04-17,38,5.1,1998,20065432,62745795,42680363,5
9152,0.26504,27000000,76000000,49000000,The Newton Boys,Matthew McConaughey|Skeet Ulrich|Ethan Hawke|Vincent D'Onofrio|Gail Cronauer,Richard Linklater,113,Crime|Action|Drama,1998-03-26,16,6.4,1998,36117777,101664855,65547078,6
9153,0.162242,20000000,37672350,17672350,How Stella Got Her Groove Back,Angela Bassett|Taye Diggs|Whoopi Goldberg|Regina King|Suzzanne Douglas,Kevin Rodney Sullivan,124,Comedy|Drama|Romance,1998-08-14,10,6.5,1998,26753909,50394131,23640222,6
9179,4.143585,40000000,211343479,171343479,The Little Mermaid,Jodi Benson|Christopher Daniel Barnes|Jason Marin|Samuel E. Wright|Buddy Hackett,Ron Clements|John Musker,83,Animation|Family,1989-11-17,1042,7.1,1989,70359397,371749996,301390599,7
9180,3.536655,48000000,474171806,426171806,Indiana Jones and the Last Crusade,Harrison Ford|Sean Connery|Denholm Elliott|Alison Doody|John Rhys-Davies,Steven Spielberg,127,Adventure|Action,1989-05-24,2031,7.4,1989,84431277,834061065,749629788,7
9181,2.719764,16000000,92823546,76823546,When Harry Met Sally...,Meg Ryan|Billy Crystal|Carrie Fisher|Bruno Kirby|Steven Ford,Rob Reiner,96,Comedy|Romance|Drama,1989-07-12,532,7.1,1989,28143759,163275219,135131460,7
9182,2.640852,35000000,411348924,376348924,Batman,Jack Nicholson|Michael Keaton|Kim Basinger|Michael Gough|Pat Hingle,Tim Burton,126,Fantasy|Action,1989-06-23,1207,6.9,1989,61564472,723556562,661992090,7
9183,2.566875,40000000,332000000,292000000,Back to the Future Part II,Michael J. Fox|Christopher Lloyd|Lea Thompson|Elisabeth Shue|James Tolkan,Robert Zemeckis,108,Adventure|Comedy|Family|Science Fiction|Action,1989-11-20,2436,7.2,1989,70359397,583982999,513623602,7
9184,2.470407,16400000,235860116,219460116,Dead Poets Society,Robin Williams|Ethan Hawke|Robert Sean Leonard|Gale Hansen|Josh Charles,Peter Weir,129,Drama,1989-06-02,1426,7.9,1989,28847353,414874391,386027038,8
9185,2.379507,37000000,215394738,178394738,Ghostbusters II,Bill Murray|Dan Aykroyd|Sigourney Weaver|Harold Ramis|Rick Moranis,Ivan Reitman,108,Fantasy|Action|Comedy|Science Fiction|Family,1989-06-15,569,6.2,1989,65082442,378876100,313793658,6
9186,2.176623,32000000,156167015,124167015,Licence to Kill,Timothy Dalton|Carey Lowell|Robert Davi|Talisa Soto|Anthony Zerbe,John Glen,133,Adventure|Action|Thriller,1989-07-07,332,5.6,1989,56287518,274695427,218407909,6
9187,1.859089,27000000,71320000,44320000,National Lampoon's Christmas Vacation,Chevy Chase|Beverly D'Angelo|Randy Quaid|Juliette Lewis|Johnny Galecki,Jeremiah S. Chechik,97,Comedy,1989-12-01,436,7.2,1989,47492593,125450805,77958212,7
9188,1.836091,18000000,26828365,8828365,Glory,Matthew Broderick|Denzel Washington|Cary Elwes|Morgan Freeman|Jihmi Kennedy,Edward Zwick,122,War,1989-12-15,207,7.1,1989,31661728,47190689,15528961,7
9189,1.69108,70000000,90000098,20000098,The Abyss,Ed Harris|Mary Elizabeth Mastrantonio|Michael Biehn|Leo Burmester|Todd Graff,James Cameron,139,Adventure|Action|Thriller|Science Fiction,1989-08-08,446,6.9,1989,123128945,158308816,35179871,7
9190,1.510501,25000000,227853986,202853986,Lethal Weapon 2,Mel Gibson|Danny Glover|Joe Pesci|Joss Ackland|Derrick O'Connor,Richard Donner,114,Action|Adventure|Comedy|Crime|Thriller,1989-07-07,608,6.5,1989,43974623,400791729,356817106,6
9191,1.362379,55000000,63408614,8408614,Tango & Cash,Sylvester Stallone|Kurt Russell|Teri Hatcher|Jack Palance|Brion James,Andrei Konchalovsky|Albert Magnoli,104,Action|Adventure|Comedy,1989-12-22,239,5.9,1989,96744171,111534797,14790626,6
9192,1.280429,10000000,40485039,30485039,Bill & Ted's Excellent Adventure,Keanu Reeves|Alex Winter|George Carlin|Dan Shor|Hal Landon Jr.,Stephen Herek,90,Adventure|Comedy|Science Fiction,1989-02-17,225,6.6,1989,17589849,71212573,53622724,7
9193,1.274285,7500000,296000000,288500000,Look Who's Talking,John Travolta|Kirstie Alley|Olympia Dukakis|George Segal|Bruce Willis,Amy Heckerling,93,Comedy|Romance,1989-10-12,278,5.7,1989,13192387,520659541,507467154,6
9194,1.218498,32000000,222724172,190724172,"Honey, I Shrunk the Kids",Rick Moranis|Marcia Strassman|Matt Frewer|Kristine Sutherland|Amy O'Neill,Joe Johnston,93,Adventure|Comedy|Family|Science Fiction,1989-06-22,390,5.9,1989,56287518,391768464,335480946,6
9195,1.190512,30000000,70200000,40200000,Star Trek V: The Final Frontier,William Shatner|Leonard Nimoy|DeForest Kelley|James Doohan|George Takei,William Shatner,107,Science Fiction|Action|Adventure|Thriller,1989-06-09,216,5.3,1989,52769548,123480742,70711194,5
9196,0.94235,1500000,14697005,13197005,Kickboxer,Jean-Claude Van Damme|Dennis Alexio|Dennis Chan|Michel Qissi|Haskell V. Anderson III,Mark DiSalle|David Worth|Jean-Claude Van Damme,97,Action|Thriller,1989-04-20,139,6.2,1989,2638477,25851810,23213333,6
9197,0.918962,8000000,22168359,14168359,A Nightmare on Elm Street 5: The Dream Child,Robert Englund|Lisa Wilcox|Erika Anderson|Valorie Armstrong|Michael Ashton,Stephen Hopkins,89,Horror|Thriller,1989-08-11,128,5.6,1989,14071879,38993809,24921930,6
9198,0.914399,500000,10166459,9666459,Cyborg,Jean-Claude Van Damme|Deborah Richter|Vincent Klyn|Alex Daniels|Ralf Moeller,Albert Pyun,86,Action|Science Fiction,1989-04-07,73,4.8,1989,879492,17882648,17003156,5
9199,0.895389999999999,18000000,36602000,18602000,The 'Burbs,Tom Hanks|Bruce Dern|Carrie Fisher|Rick Ducommun|Corey Feldman,Joe Dante,101,Comedy|Horror|Thriller,1989-02-17,157,6.4,1989,31661728,64382366,32720638,6
9200,0.836515,11500000,57469467,45969467,Pet Sematary,Dale Midkiff|Fred Gwynne|Denise Crosby|Brad Greenquist|Michael Lombard,Mary Lambert,103,Drama|Horror,1989-04-21,176,6.4,1989,20228326,101087926,80859600,6
9202,0.737259,18000000,46908987,28908987,"See No Evil, Hear No Evil",Richard Pryor|Gene Wilder|Joan Severance|Kevin Spacey|Alan North,Arthur Hiller,103,Crime|Comedy,1989-05-12,92,6.3,1989,31661728,82512201,50850473,6
9203,0.724013,14000000,161001698,147001698,Born on the Fourth of July,Tom Cruise|Raymond J. Barry|Caroline Kava|Holly Marie Combs|Kyra Sedgwick,Oliver Stone,145,Drama|War,1989-12-20,190,6.3,1989,24625789,283199561,258573772,6
9204,0.720081,15000000,79258538,64258538,Uncle Buck,John Candy|Jean Louisa Kelly|Macaulay Culkin|Gaby Hoffmann|Amy Madigan,John Hughes,100,Comedy|Drama|Family,1989-08-16,179,6.6,1989,26384774,139414574,113029800,7
9207,0.602613,11000000,49797148,38797148,Major League,Tom Berenger|Charlie Sheen|Corbin Bernsen|Margaret Whitton|James Gammon,David S. Ward,107,Comedy,1989-04-06,110,6.5,1989,19348834,87592433,68243599,6
9209,0.573045,6500000,30218387,23718387,Weekend at Bernie's,Andrew McCarthy|Jonathan Silverman|Catherine Mary Stewart|Terry Kiser|Don Calfa,Ted Kotcheff,97,Comedy,1989-07-05,104,6.2,1989,11433402,53153687,41720285,6
9211,0.547658,18598420,78247647,59649227,K-9,Jim Belushi|Mel Harris|Kevin Tighe|Ed O'Neill|Rando,Rod Daniel,101,Action|Adventure|Comedy|Crime,1989-04-28,120,5.5,1989,32714340,137636432,104922092,5
9212,0.544381999999999,22500000,18671317,-3828683,Casualties of War,Michael J. Fox|Sean Penn|Don Harvey|John C. Reilly|John Leguizamo,Brian De Palma,113,Drama|History|War,1989-08-18,91,6.5,1989,39577161,32842565,-6734596,6
9218,0.498792,5000000,14000000,9000000,Friday the 13th Part VIII: Jason Takes Manhattan,Kane Hodder|Jensen Daggett|Scott Reeves|Barbara Bingham|Peter Mark Richman,Rob Hedden,100,Horror|Thriller,1989-07-28,85,4.7,1989,8794924,24625789,15830865,5
9219,0.494235,31000000,74134790,43134790,Always,Richard Dreyfuss|Holly Hunter|John Goodman|Audrey Hepburn|Brad Johnson,Steven Spielberg,122,Fantasy|Drama|Romance,1989-12-22,68,5.8,1989,54528533,130401979,75873446,6
9222,0.481276,3000000,1145404,-1854596,Miracle Mile,Anthony Edwards|Mare Winningham|John Agar|Lou Hancock|Mykelti Williamson,Steve De Jarnatt,87,Science Fiction|Thriller,1989-05-19,19,6.9,1989,5276954,2014748,-3262206,7
9226,0.4669,13800000,27100027,13300027,All Dogs Go to Heaven,Burt Reynolds|Dom DeLuise|Judith Barsi|Melba Moore|Daryl Gilley,Don Bluth|Gary Goldman|Dan Kuenster,89,Drama|Animation|Family|Comedy|Fantasy,1989-11-17,133,6.3,1989,24273992,47668539,23394547,6
9228,0.452278,30000000,60864870,30864870,Harlem Nights,Eddie Murphy|Richard Pryor|Redd Foxx|Danny Aiello|Michael Lerner,Eddie Murphy,116,Action|Comedy|Crime|Drama|Thriller,1989-11-17,41,5.9,1989,52769548,107060389,54290841,6
9229,0.448357,19000000,110879513,91879513,Sea of Love,Al Pacino|John Goodman|Michael Rooker|William Hickey|Richard Jenkins,Harold Becker,113,Drama|Crime|Mystery,1989-09-15,60,6.7,1989,33420713,195035393,161614680,7
9231,0.438179,10000000,7825000,-2175000,Dead Calm,Nicole Kidman|Sam Neill|Billy Zane|George Shevtsov|Rod Mullinar,Phillip Noyce,96,Crime|Thriller|Horror|Drama,1989-04-07,70,6.3,1989,17589849,13764057,-3825792,6
9234,0.423064,5000000,16554699,11554699,Shocker,Michael Murphy|Mitch Pileggi|Sam Scarber|Camille Cooper|Ted Raimi,Wes Craven,109,Thriller|Comedy|Horror,1989-10-27,37,5.9,1989,8794924,29119466,20324542,6
9236,0.409695,7500000,145793296,138293296,Driving Miss Daisy,Morgan Freeman|Jessica Tandy|Dan Aykroyd|Patti LuPone|Esther Rolle,Bruce Beresford,99,Comedy|Drama,1989-12-13,181,6.9,1989,13192387,256448211,243255824,7
9238,0.415913,19000000,18254702,-745298,Crimes and Misdemeanors,Woody Allen|Martin Landau|Anjelica Huston|Joanna Gleason|Alan Alda,Woody Allen,104,Comedy|Drama,1989-10-13,86,6.9,1989,33420713,32109745,-1310968,7
9239,0.382943,30000000,45892212,15892212,Black Rain,Michael Douglas|Andy GarcÃ­a|Kate Capshaw|Shigeru KÃ´yama|John Spencer,Ridley Scott,125,Action|Thriller|Crime,1989-09-22,114,6.0,1989,52769548,80723709,27954161,6
9247,0.337545,645180,14743391,14098211,My Left Foot: The Story of Christy Brown,Daniel Day-Lewis|Brenda Fricker|Alison Whelan|Declan Croghan|Eanna MacLiam,Jim Sheridan,103,Drama,1989-07-21,94,7.3,1989,1134861,25933402,24798541,7
9254,0.307623,6500000,37295445,30795445,Do the Right Thing,Ossie Davis|Danny Aiello|Giancarlo Esposito|Richard Edson|Spike Lee,Spike Lee,120,Crime|Drama,1989-06-30,134,7.5,1989,11433402,65602126,54168724,7
9264,0.26954,5000000,11642254,6642254,Halloween 5: The Revenge of Michael Myers,Donald Pleasence|Danielle Harris|Ellie Cornell|Beau Starr|Don Shanks,Dominique Othenin-Girard,96,Horror|Thriller,1989-10-12,83,5.2,1989,8794924,20478549,11683625,5
9267,0.2578,12000000,15942628,3942628,Next of Kin,Patrick Swayze|Liam Neeson|Adam Baldwin|Helen Hunt|Bill Paxton,John Irvin,108,Adventure|Drama|Action|Thriller,1989-10-20,24,5.0,1989,21107819,28042842,6935023,5
9276,0.240681,15000000,30050028,15050028,Road House,Patrick Swayze|Kelly Lynch|Sam Elliott|Ben Gazzara|Marshall R. Teague,Rowdy Herrington,114,Action|Thriller,1989-05-19,121,6.3,1989,26384774,52857546,26472772,6
9277,0.233923,8045760,35150960,27105200,Fletch Lives,Chevy Chase|Hal Holbrook|Julianne Phillips|R. Lee Ermey|Richard Libertini,Michael Ritchie,95,Comedy|Crime|Mystery,1989-03-17,46,5.9,1989,14152370,61830009,47677639,6
9284,0.19766,15000000,40590000,25590000,Three Fugitives,Nick Nolte|Martin Short|Sarah Rowland Doroff|James Earl Jones|Alan Ruck,Francis Veber,96,Comedy,1989-01-27,20,6.5,1989,26384774,71397198,45012424,6
9287,0.188629,33000000,1132112,-31867888,Valmont,Colin Firth|Annette Bening|Meg Tilly|Fairuza Balk|SiÃ¢n Phillips,MiloÅ¡ Forman,137,Drama|Romance,1989-11-17,24,6.6,1989,58046502,1991367,-56055135,7
9288,0.181067,2500000,4729352,2229352,Drugstore Cowboy,Matt Dillon|Kelly Lynch|James Le Gros|Heather Graham|Grace Zabriskie,Gus Van Sant,100,Crime|Drama,1989-09-09,50,6.8,1989,4397462,8318858,3921396,7
9289,0.178696,6000000,14278900,8278900,The Wizard,Fred Savage|Luke Edwards|Beau Bridges|Christian Slater|Jenny Lewis,Todd Holland,100,Adventure|Comedy|Drama|Family|Romance,1989-12-15,36,6.5,1989,10553909,25116370,14562461,6
9303,0.114027,7000000,793775,-6206225,Little Monsters,Fred Savage|Howie Mandel|Daniel Stern|Margaret Whitton|Rick Ducommun,Richard Greenberg,102,Adventure|Fantasy|Comedy|Family,1989-08-25,26,5.7,1989,12312894,1396238,-10916656,6
9316,3.852269,25000000,377350553,352350553,Beauty and the Beast,Paige O'Hara|Robby Benson|Richard White|Jerry Orbach|David Ogden Stiers,Gary Trousdale|Kirk Wise,84,Romance|Family|Animation|Fantasy|Music,1991-11-12,1703,7.3,1991,40027321,604173269,564145948,7
9317,3.584406,100000000,520000000,420000000,Terminator 2: Judgment Day,Arnold Schwarzenegger|Linda Hamilton|Edward Furlong|Robert Patrick|Earl Boen,James Cameron,137,Action|Thriller|Science Fiction,1991-07-01,2836,7.5,1991,160109284,832568277,672458993,7
9318,2.326917,70000000,300854823,230854823,Hook,Robin Williams|Dustin Hoffman|Julia Roberts|Bob Hoskins|Caroline Goodall,Steven Spielberg,144,Adventure|Fantasy|Comedy|Family,1991-12-11,834,6.5,1991,112076498,481696503,369620005,6
9319,1.606765,48000000,390493908,342493908,Robin Hood: Prince of Thieves,Kevin Costner|Morgan Freeman|Christian Slater|Mary Elizabeth Mastrantonio|Alan Rickman,Kevin Reynolds,143,Adventure|Drama|Action|Romance,1991-06-14,518,6.5,1991,76852456,625217000,548364544,6
9320,1.301458,30000000,15556340,-14443660,Highlander II: The Quickening,Christopher Lambert|Sean Connery|Virginia Madsen|Michael Ironside|John C. McGinley,Russell Mulcahy,91,Action|Fantasy|Science Fiction,1991-01-30,93,4.8,1991,48032785,24907144,-23125641,5
9321,1.287839,35000000,182300000,147300000,Cape Fear,Robert De Niro|Nick Nolte|Jessica Lange|Juliette Lewis|Joe Don Baker,Martin Scorsese,128,Crime|Thriller,1991-11-15,289,6.9,1991,56038249,291879225,235840976,7
9322,1.28293,27000000,96900000,69900000,Star Trek VI: The Undiscovered Country,William Shatner|Leonard Nimoy|DeForest Kelley|James Doohan|George Takei,Nicholas Meyer,113,Science Fiction|Action|Adventure|Thriller,1991-12-05,237,6.6,1991,43229506,155145896,111916390,7
9323,1.259634,23000000,86930411,63930411,The Naked Gun 2Â½: The Smell of Fear,Leslie Nielsen|Priscilla Presley|George Kennedy|O.J. Simpson|Robert Goulet,David Zucker,85,Action|Comedy|Crime,1991-06-28,257,6.5,1991,36825135,139183658,102358523,6
9324,1.231168,24000000,83531958,59531958,Point Break,Patrick Swayze|Keanu Reeves|Gary Busey|Lori Petty|John C. McGinley,Kathryn Bigelow,120,Action|Thriller|Crime,1991-07-12,468,6.7,1991,38426228,133742420,95316192,7
9326,1.020069,75000000,152368585,77368585,Backdraft,Kurt Russell|William Baldwin|Robert De Niro|Donald Sutherland|Jennifer Jason Leigh,Ron Howard,137,Action|Crime|Drama|Mystery|Thriller,1991-05-24,193,6.2,1991,120081963,243956250,123874287,6
9327,0.983036,30000000,191502426,161502426,The Addams Family,RaÃºl JuliÃ¡|Anjelica Huston|Christopher Lloyd|Christina Ricci|Carel Struycken,Barry Sonnenfeld,99,Comedy|Family|Fantasy,1991-11-22,414,6.6,1991,48032785,306613163,258580378,7
9328,0.977243,65000000,17218080,-47781920,Hudson Hawk,Bruce Willis|Danny Aiello|Andie MacDowell|James Coburn|Richard E. Grant,Michael Lehmann,100,Action|Adventure|Comedy,1991-05-23,155,5.6,1991,104071034,27567744,-76503290,6
9329,0.963521,42000000,62000000,20000000,The Rocketeer,Billy Campbell|Jennifer Connelly|Alan Arkin|Timothy Dalton|Paul Sorvino,Joe Johnston,108,Action|Adventure|Science Fiction|Family,1991-06-21,149,6.3,1991,67245899,99267756,32021857,6
9330,0.915804,16000000,45361000,29361000,Thelma & Louise,Susan Sarandon|Geena Davis|Harvey Keitel|Brad Pitt|Michael Madsen,Ridley Scott,130,Drama|Thriller|Crime|Adventure,1991-05-24,375,7.0,1991,25617485,72627172,47009687,7
9331,0.816448,38000000,34416893,-3583107,The Doors,Val Kilmer|Meg Ryan|Kyle MacLachlan|Frank Whaley|Kevin Dillon,Oliver Stone,140,Drama|Music,1991-03-01,129,6.5,1991,60841527,55104641,-5736886,6
9332,0.799449,25000000,78,-24999922,Teenage Mutant Ninja Turtles II: The Secret of the Ooze,Paige Turco|David Warner|Michelan Sisti|Leif Tilden|Kenn Scott,Michael Pressman,88,Science Fiction|Adventure|Action|Comedy|Family,1991-03-22,161,6.0,1991,40027321,124,-40027197,6
9333,0.764796,40000000,8479793,-31520207,Nothing but Trouble,Chevy Chase|Dan Aykroyd|John Candy|Demi Moore|Valri Bromfield,Dan Aykroyd,94,Comedy|Adventure,1991-02-14,36,5.3,1991,64043713,13576935,-50466778,5
9335,0.695385,19000000,272742922,253742922,The Silence of the Lambs,Jodie Foster|Anthony Hopkins|Scott Glenn|Ted Levine|Anthony Heald,Jonathan Demme,118,Crime|Drama|Thriller,1991-02-14,2679,7.9,1991,30420763,436686740,406265977,8
9336,0.693523,9000000,6153939,-2846061,Barton Fink,John Turturro|John Goodman|Judy Davis|Michael Lerner|Tony Shalhoub,Joel Coen,116,Comedy|Drama,1991-08-01,201,7.0,1991,14409835,9853027,-4556808,7
9339,0.689242,11000000,34872033,23872033,Freddy's Dead: The Final Nightmare,Robert Englund|Lisa Zane|Shon Greenblatt|Lezlie Deane|Ricky Dean Logan,Rachel Talalay,89,Horror|Thriller|Comedy,1991-09-05,141,5.4,1991,17612021,55833362,38221341,5
9341,0.662297,29000000,59509925,30509925,The Last Boy Scout,Bruce Willis|Damon Wayans|Chelsea Field|Noble Willingham|Halle Berry,Tony Scott,105,Adventure|Action|Comedy|Thriller,1991-12-11,274,6.4,1991,46431692,95280914,48849222,6
9342,0.658866,40000000,205405498,165405498,JFK,Kevin Costner|Tommy Lee Jones|Gary Oldman|Kevin Bacon|Michael Rooker,Oliver Stone,189,Drama|Thriller|History,1991-12-20,258,7.2,1991,64043713,328873272,264829559,7
9343,0.649755,6500000,57504069,51004069,Boyz n the Hood,Laurence Fishburne|Cuba Gooding Jr.|Ice Cube|Morris Chestnut|Angela Bassett,John Singleton,112,Crime|Drama,1991-07-12,168,7.3,1991,10407103,92069353,81662250,7
9344,0.63395,23000000,7434726,-15565274,Harley Davidson and the Marlboro Man,Mickey Rourke|Don Johnson|Chelsea Field|Daniel Baldwin|Giancarlo Esposito,Simon Wincer,98,Action|Thriller,1991-08-23,44,6.4,1991,36825135,11903686,-24921449,6
9345,0.627123,15000000,30102717,15102717,Double Impact,Jean-Claude Van Damme|Geoffrey Lewis|Alonna Shaw|Cory Everson|Philip Chan Yan-Kin,Sheldon Lettich,110,Thriller|Action|Crime|Drama,1991-08-10,113,5.1,1991,24016392,48197244,24180852,5
9347,0.601417,35000000,63710000,28710000,What About Bob?,Bill Murray|Richard Dreyfuss|Julie Hagerty|Charlie Korsmo|Kathryn Erbe,Frank Oz,100,Comedy,1991-05-17,128,6.8,1991,56038249,102005624,45967375,7
9349,0.583385,13000000,20560255,7560255,Child's Play 3,Justin Whalin|Perrey Reeves|Jeremy Sylvers|Travis Fine|Dean Jacobson,Jack Bender,90,Horror,1991-08-30,114,5.5,1991,20814206,32918877,12104671,5
9351,0.533227999999999,26000000,124033791,98033791,City Slickers,Billy Crystal|Daniel Stern|Bruno Kirby|Jack Palance|Patricia Wettig,Ron Underwood,112,Action|Adventure|Comedy|Drama|Western,1991-06-07,114,6.1,1991,41628413,198589614,156961201,6
9352,0.514489,26000000,181096164,155096164,Hot Shots!,Charlie Sheen|Cary Elwes|Valeria Golino|Lloyd Bridges|Kevin Dunn,Jim Abrahams,84,Action|Comedy|War,1991-07-31,313,6.2,1991,41628413,289951771,248323358,6
9354,0.483931,11000000,2807854,-8192146,Return to the Blue Lagoon,Milla Jovovich|Brian Krause|Lisa Pelikan|Courtney Barilla|Garette Ratliff Henson,William A. Graham,98,Drama|Adventure|Romance,1991-08-02,78,5.0,1991,17612021,4495634,-13116387,5
9356,0.474911,11000000,119418501,108418501,Fried Green Tomatoes,Kathy Bates|Mary-Louise Parker|Jessica Tandy|Cicely Tyson|Mary Stuart Masterson,Jon Avnet,130,Drama|Comedy,1991-12-27,134,7.3,1991,17612021,191200107,173588086,7
9358,0.449397,8000000,2275557,-5724443,Showdown in Little Tokyo,Dolph Lundgren|Brandon Lee|Cary-Hiroyuki Tagawa|Tia Carrere|Philip Tan,Mark L. Lester,79,Action|Thriller,1991-08-23,39,5.4,1991,12808742,3643378,-9165364,5
9359,0.446515,19000000,174999005,155999005,Sleeping with the Enemy,Julia Roberts|Patrick Bergin|Kevin Anderson|Elizabeth Lawrence|Kyle Secor,Joseph Ruben,99,Crime|Thriller,1991-02-08,114,6.1,1991,30420763,280189654,249768891,6
9361,0.44464,18000000,11657385,-6342615,Rock-A-Doodle,Glen Campbell|Eddie Deezen|Toby Scott Ganger|Christopher Plummer,Don Bluth|Gary Goldman,77,Comedy|Family|Animation|Fantasy|Music,1991-08-02,21,5.3,1991,28819671,18664555,-10155116,5
9368,0.386486,24000000,41895491,17895491,The Fisher King,Jeff Bridges|Robin Williams|Mercedes Ruehl|Amanda Plummer|Michael Jeter,Terry Gilliam,137,Drama|Comedy,1991-09-09,158,6.8,1991,38426228,67078570,28652342,7
9371,0.376137,10000000,25196249,15196249,Don't Tell Mom the Babysitter's Dead,Christina Applegate|Joanna Cassidy|Josh Charles|Keith Coogan|John Getz,Stephen Herek,105,Comedy|Family,1991-06-07,48,5.9,1991,16010928,40341533,24330605,6
9372,0.26744,14000000,2735731,-11264269,Shadows and Fog,Woody Allen|Kathy Bates|John Cusack|Mia Farrow|Jodie Foster,Woody Allen,85,Thriller|Comedy,1991-12-05,26,6.0,1991,22415299,4380159,-18035140,6
9373,0.369101,30000000,49114016,19114016,Bugsy,Warren Beatty|Annette Bening|Harvey Keitel|Ben Kingsley|Elliott Gould,Barry Levinson,134,Drama|Crime,1991-12-10,41,5.7,1991,48032785,78636099,30603314,6
9374,0.363923,6000000,1193062,-4806938,Cool as Ice,Vanilla Ice|Kristin Minter|Naomi Campbell|Deezer D|Kevin Hicks,David Kellogg,91,Drama|Action|Comedy|Music|Romance,1991-10-18,14,3.9,1991,9606557,1910203,-7696354,4
9375,0.304932,14000000,39673161,25673161,Out for Justice,Steven Seagal|William Forsythe|Jerry Orbach|Jo Champa|Shareen Mitchell,John Flynn,91,Action|Thriller|Crime,1991-04-12,44,5.6,1991,22415299,63520414,41105115,6
9380,0.350342,30000000,74787599,44787599,The Prince of Tides,Nick Nolte|Barbra Streisand|Blythe Danner|Kate Nelligan|Jeroen KrabbÃ©,Barbra Streisand,132,Drama|Romance,1991-12-25,18,5.9,1991,48032785,119741889,71709104,6
9382,0.329328,14000000,32482682,18482682,Jungle Fever,Spike Lee|Annabella Sciorra|Ruby Dee|John Turturro|Frank Vincent,Spike Lee,132,Drama|Romance,1991-06-07,34,5.5,1991,22415299,52007789,29592490,5
9396,0.261842,8500000,47624253,39124253,New Jack City,Wesley Snipes|Ice-T|Allen Payne|Chris Rock|Mario Van Peebles,Mario Van Peebles,97,Thriller|Crime|Drama,1991-03-08,58,6.0,1991,13609289,76250850,62641561,6
9397,0.275786,8000000,10400000,2400000,A Rage in Harlem,Forest Whitaker|Gregory Hines|Robin Givens|Danny Glover|T. K. Carter,Bill Duke,115,Crime|Comedy,1991-05-03,10,6.0,1991,12808742,16651365,3842623,6
9400,0.263047,35000000,23562716,-11437284,Oscar,Sylvester Stallone|Ornella Muti|Don Ameche|Peter Riegert|Tim Curry,John Landis,109,Action|Comedy|Thriller|Family,1991-04-26,77,6.3,1991,56038249,37726095,-18312154,6
9418,0.211558,23000000,20246790,-2753210,Mobsters,Christian Slater|Costas Mandylor|Richard Grieco|Patrick Dempsey|Lara Flynn Boyle,Michael Karbelnikoff,104,Drama|Action|Thriller|Crime,1991-07-26,15,6.0,1991,36825135,32416990,-4408145,6
9426,0.192123,22000000,11511031,-10488969,Shattered,Tom Berenger|Bob Hoskins|Greta Scacchi|Joanne Whalley|Corbin Bernsen,Wolfgang Petersen,98,Mystery|Thriller,1991-10-11,11,6.5,1991,35224042,18430229,-16793813,6
9427,0.191606,14000000,34793160,20793160,White Fang,Klaus Maria Brandauer|Ethan Hawke|Seymour Cassel|Susan Hogan|James Remar,Randal Kleiser,107,Action|Adventure|Drama|Family,1991-01-18,59,6.5,1991,22415299,55707079,33291780,6
9432,0.172296,17000000,4603929,-12396071,Dutch,Ed O'Neill|Ethan Embry|JoBeth Williams|Christopher McDonald|Ari Meyers,Peter Faiman,107,Comedy,1991-07-19,25,6.6,1991,27218578,7371317,-19847261,7
9435,0.1523,13000000,3752426,-9247574,Mannequin Two: On the Move,Kristy Swanson|William Ragsdale|Meshach Taylor|Terry Kiser|Stuart Pankin,Stewart Raffill,95,Fantasy|Comedy|Science Fiction|Romance,1991-01-07,11,4.8,1991,20814206,6007982,-14806224,5
9449,3.777441,28000000,140767956,112767956,Die Hard,Bruce Willis|Alan Rickman|Alexander Godunov|Bonnie Bedelia|Reginald VelJohnson,John McTiernan,131,Action|Thriller,1988-07-15,2800,7.2,1988,51628948,259560770,207931822,7
9450,2.150682,18000000,151668774,133668774,Big,Tom Hanks|Elizabeth Perkins|Robert Loggia|John Heard|Jared Rushton,Penny Marshall,104,Fantasy|Drama|Comedy|Romance|Family,1988-06-03,564,6.7,1988,33190038,279660690,246470652,7
9451,1.905883,12000000,78756177,66756177,The Naked Gun: From the Files of Police Squad!,Leslie Nielsen|Priscilla Presley|Ricardo Montalban|George Kennedy|O.J. Simpson,David Zucker,85,Action|Comedy|Crime,1988-12-02,543,6.8,1988,22126692,145217807,123091115,7
9452,1.651962,8000000,22433275,14433275,License to Drive,Corey Haim|Corey Feldman|Carol Kane|Heather Graham|Richard Masur,Greg Beeman,90,Comedy|Family,1988-07-06,52,6.2,1988,14751128,41364514,26613386,6
9453,1.628865,15000000,73326666,58326666,Beetlejuice,Geena Davis|Alec Baldwin|Winona Ryder|Michael Keaton|Catherine O'Hara,Tim Burton,92,Fantasy|Comedy,1988-02-29,739,7.0,1988,27658365,135206381,107548016,7
9454,1.45982099999999,25000000,354825435,329825435,Rain Man,Dustin Hoffman|Tom Cruise|Valeria Golino|Gerald R. Molen|Jack Murdock,Barry Levinson,133,Drama,1988-12-11,934,7.4,1988,46097275,654259434,608162159,7
9455,1.39258099999999,1500000,11806119,10306119,Bloodsport,Jean-Claude Van Damme|Donald Gibb|Ken Siu|Bolo Yeung|Leah Ayres,Newt Arnold,92,Action,1988-02-26,180,6.4,1988,2765836,21769196,19003360,6
9456,1.279955,39000000,288752301,249752301,Coming to America,Eddie Murphy|Arsenio Hall|James Earl Jones|John Amos|Shari Headley,John Landis,116,Comedy|Romance,1988-06-28,500,6.4,1988,71911749,532427775,460516026,6
9457,1.183033,63000000,189015611,126015611,Rambo III,Sylvester Stallone|Richard Crenna|Kurtwood Smith|Spiros FocÃ¡s|Sasson Gabai,Peter MacDonald,102,Action|Adventure|Thriller|War,1988-05-24,385,5.7,1988,116165134,348524188,232359054,6
9460,1.144528,15000000,216614388,201614388,Twins,Arnold Schwarzenegger|Danny DeVito|Kelly Preston|Chloe Webb|David Caruso,Ivan Reitman,107,Comedy|Drama,1988-12-09,287,5.5,1988,27658365,399413325,371754960,5
9461,1.115598,70000000,329803958,259803958,Who Framed Roger Rabbit,Bob Hoskins|Christopher Lloyd|Joanna Cassidy|Charles Fleischer|Kathleen Turner,Robert Zemeckis,104,Fantasy|Animation|Comedy|Crime|Family,1988-06-21,723,6.9,1988,129072371,608122557,479050186,7
9462,1.101103,12300000,84460846,72160846,The Land Before Time,Gabriel Damon|Candace Hutson|Judith Barsi|Will Ryan|Pat Hingle,Don Bluth,69,Animation|Adventure|Family,1988-11-18,340,6.9,1988,22679859,155736595,133056736,7
9463,1.079886,20000000,171504781,151504781,Cocktail,Tom Cruise|Bryan Brown|Elisabeth Shue|Lisa Banes|Kelly Lynch,Roger Donaldson,104,Drama|Romance,1988-07-29,175,5.5,1988,36877820,316236126,279358306,5
9465,0.891508,9000000,44196684,35196684,Child's Play,Catherine Hicks|Chris Sarandon|Alex Vincent|Brad Dourif|Dinah Manoff,Tom Holland,87,Horror|Thriller,1988-11-08,254,6.2,1988,16595019,81493868,64898849,6
9466,0.869474,35000000,57269863,22269863,Willow,Warwick Davis|Val Kilmer|Joanne Whalley|Jean Marsh|Patricia Hayes,Ron Howard,126,Adventure|Drama|Action,1988-05-01,250,6.7,1988,64536185,105599386,41063201,7
9468,0.78304,7000000,72500000,65500000,A Nightmare on Elm Street 4: The Dream Master,Robert Englund|Tuesday Knight|Ken Sagoes|Rodney Eastman|Lisa Wilcox,Renny Harlin,99,Horror|Thriller,1988-08-19,135,5.9,1988,12907237,133682099,120774862,6
9470,0.75639,7000000,50888000,43888000,Bull Durham,Kevin Costner|Susan Sarandon|Tim Robbins|Trey Wilson|Robert Wuhl,Ron Shelton,108,Comedy|Romance,1988-06-15,81,6.3,1988,12907237,93831926,80924689,6
9471,0.753578,29000000,34994648,5994648,Red Heat,Arnold Schwarzenegger|Jim Belushi|Ed O'Ross|Peter Boyle|Laurence Fishburne,Walter Hill,104,Comedy|Action|Crime,1988-06-17,172,5.6,1988,53472839,64526317,11053478,6
9472,0.727397,7500000,62493712,54993712,A Fish Called Wanda,John Cleese|Jamie Lee Curtis|Kevin Kline|Michael Palin|Maria Aitken,Charles Crichton,108,Comedy|Crime,1988-07-15,270,6.8,1988,13829182,115231594,101402412,7
9475,0.669161,19000000,8247943,-10752057,The Blob,"Kevin Dillon|Shawnee Smith|Donovan Leitch, Jr.|Jeffrey DeMunn|Candy Clark",Chuck Russell,95,Horror|Science Fiction,1988-08-05,65,6.0,1988,35033929,15208308,-19825621,6
9476,0.657109,17500000,25024919,7524919,Cocoon: The Return,Don Ameche|Wilford Brimley|Courteney Cox|Hume Cronyn|Jack Gilford,Daniel Petrie,116,Comedy|Drama|Science Fiction,1988-09-13,46,5.7,1988,32268092,46143223,13875131,6
9481,0.588756,15000000,34604000,19604000,Mississippi Burning,Gene Hackman|Willem Dafoe|Frances McDormand|Brad Dourif|R. Lee Ermey,Alan Parker,128,Thriller|Crime|Drama,1988-12-08,144,7.1,1988,27658365,63806004,36147639,7
9483,0.572843,28000000,103173635,75173635,Working Girl,Harrison Ford|Melanie Griffith|Sigourney Weaver|Alec Baldwin|Joan Cusack,Mike Nichols,114,Comedy|Drama|Romance,1988-12-20,116,6.4,1988,51628948,190240939,138611991,6
9484,0.540362,4000000,13008928,9008928,They Live,Roddy Piper|Keith David|Meg Foster|George Buck Flower|Peter Jason,John Carpenter,94,Action|Horror|Science Fiction|Thriller,1988-11-23,229,6.9,1988,7375564,23987045,16611481,7
9485,0.538522,3000000,7282851,4282851,Phantasm II,James Le Gros|Reggie Bannister|Angus Scrimm|Paula Irvine|Samantha Phillips,Don Coscarelli,97,Action|Horror|Science Fiction|Thriller,1988-07-08,25,6.1,1988,5531673,13428783,7897110,6
9488,0.513842,5000000,17768757,12768757,Halloween 4: The Return of Michael Myers,Donald Pleasence|Ellie Cornell|Danielle Harris|George P. Wilbur|Michael Pataki,Dwight H. Little,88,Horror|Thriller,1988-10-21,92,5.9,1988,9219455,32763651,23544196,6
9489,0.499298,7000000,20256975,13256975,Action Jackson,Carl Weathers|Craig T. Nelson|Vanity|Sharon Stone|Thomas F. Wilson,Craig R. Baxley,96,Action|Adventure|Comedy|Crime|Drama,1988-02-12,22,5.4,1988,12907237,37351654,24444417,5
9490,0.497587,10000000,21486757,11486757,Married to the Mob,Michelle Pfeiffer|Matthew Modine|Oliver Platt|Alec Baldwin|Dean Stockwell,Jonathan Demme,104,Action|Comedy|Thriller|Crime|Romance,1988-08-19,25,6.0,1988,18438910,39619238,21180328,6
9492,0.485136,2800000,19170001,16370001,Friday the 13th Part VII: The New Blood,Kane Hodder|Lar Park Lincoln|Susan Jennifer Sullivan|Kevin Spirtas|Terry Kiser,John Carl Buechler,88,Horror|Thriller,1988-05-13,81,5.4,1988,5162894,35347392,30184498,5
9494,0.481627,14000000,34670720,20670720,Dangerous Liaisons,Glenn Close|John Malkovich|Michelle Pfeiffer|Swoosie Kurtz|Keanu Reeves,Stephen Frears,119,Drama|Romance,1988-12-16,124,6.7,1988,25814474,63929029,38114555,7
9495,0.480782,20000000,13854000,-6146000,My Stepmother is an Alien,Dan Aykroyd|Kim Basinger|Jon Lovitz|Alyson Hannigan|Seth Green,Richard Benjamin,108,Comedy|Science Fiction,1988-12-09,65,5.6,1988,36877820,25545266,-11332554,6
9496,0.469728,20000000,17637950,-2362050,Frantic,Harrison Ford|Emmanuelle Seigner|Betty Buckley|John Mahoney|Jimmie Ray Weeks,Roman Polanski,120,Thriller|Action|Crime|Drama|Mystery,1988-02-16,87,6.4,1988,36877820,32522457,-4355363,6
9503,0.41037,6200000,9205924,3005924,Return of the Living Dead Part II,James Karen|Thom Mathews|Suzanne Snyder|Michael Kenworthy|Marsha Dietlein,Ken Wiederhorn,89,Comedy|Horror,1988-01-15,35,6.1,1988,11432124,16974720,5542596,6
9508,0.384618,10500000,14144000,3644000,Poltergeist III,Tom Skerritt|Nancy Allen|Heather O'Rourke|Lara Flynn Boyle|Kipley Wentz,Gary Sherman,98,Horror|Thriller,1988-06-10,58,4.4,1988,19360855,26079994,6719139,4
9512,0.370575,30000000,38413606,8413606,Midnight Run,Robert De Niro|Charles Grodin|Yaphet Kotto|John Ashton|Dennis Farina,Martin Brest,126,Adventure|Comedy|Crime,1988-07-20,105,6.9,1988,55316730,70830503,15513773,7
9514,0.35674,7500000,18869631,11369631,Above the Law,Steven Seagal|Pam Grier|Henry Silva|Sharon Stone|Ron Dean,Andrew Davis,99,Action|Adventure|Drama|Thriller,1988-04-08,67,5.9,1988,13829182,34793543,20964361,6
9515,0.35363,7000000,8373585,1373585,The Last Temptation of Christ,Willem Dafoe|Harvey Keitel|Barbara Hershey|David Bowie|Harry Dean Stanton,Martin Scorsese,164,Drama,1988-08-12,76,6.7,1988,12907237,15439978,2532741,7
9519,0.336536,1300000,354704,-945296,Prison,Viggo Mortensen|Chelsea Field|Lane Smith|Lincoln Kilpatrick|Tom Everett,Renny Harlin,102,Crime|Drama|Horror|Thriller,1988-03-04,11,6.8,1988,2397058,654035,-1743023,7
9524,0.320295,24000000,43455230,19455230,The Great Outdoors,John Candy|Dan Aykroyd|Annette Bening|Stephanie Faracy|Chris Young,Howard Deutch,91,Comedy,1988-06-17,65,6.2,1988,44253384,80126708,35873324,6
9530,0.288071,13000000,8038508,-4961492,Dead Ringers,Jeremy Irons|GeneviÃ¨ve Bujold|Heidi von Palleske|Barbara Gordon|Shirley Douglas,David Cronenberg,115,Drama|Horror|Thriller,1988-09-23,65,6.9,1988,23970583,14822132,-9148451,7
9532,0.28514,6000000,28202109,22202109,Ernest Saves Christmas,Jim Varney|Douglas Seale|Noelle Parker|Gailard Sartain|Bill Byrge,John R. Cherry III,95,Comedy|Family,1988-11-11,23,5.2,1988,11063346,52001615,40938269,5
9535,0.265664,4000000,9797098,5797098,Bad Dreams,Jennifer Rubin|Bruce Abbott|Richard Lynch|Dean Cameron|Harris Yulin,Andrew Fleming,86,Horror|Thriller,1988-04-08,11,4.9,1988,7375564,18064781,10689217,5
9540,0.254085,1200000,3109904,1909904,Night of the Demons,Cathy Podewell|Alvin Alexis|Amelia Kinkade|Linnea Quigley|Hal Havins,Kevin Tenney,90,Horror,1988-10-14,30,5.4,1988,2212669,5734324,3521655,5
9542,0.246182,4000000,3468572,-531428,Talk Radio,Eric Bogosian|Ellen Greene|Leslie Hope|John C. McGinley|Alec Baldwin,Oliver Stone,110,Drama,1988-12-21,16,5.5,1988,7375564,6395668,-979896,5
9544,0.407649,10000000,3916303,-6083697,Earth Girls Are Easy,Geena Davis|Jeff Goldblum|Jim Carrey|Damon Wayans|Julie Brown,Julien Temple,100,Music|Comedy|Drama|Romance|Science Fiction,1988-09-08,43,5.5,1988,18438910,7221235,-11217675,5
9554,0.200403,15000000,21032267,6032267,Punchline,Sally Field|Tom Hanks|John Goodman|Mark Rydell|Kim Greist,David Seltzer,123,Comedy|Drama,1988-10-07,19,5.1,1988,27658365,38781208,11122843,5
9555,0.199235,4500000,3813293,-686707,Critters 2,Scott Grimes|Don Keith Opper|Terrence Mann|Roxanne Kernohan|Eddie Deezen,Mick Garris,86,Thriller|Comedy|Horror|Science Fiction,1988-04-29,40,4.5,1988,8297509,7031296,-1266213,4
9557,0.18872,7000000,5344577,-1655423,Monkey Shines,Jason Beghe|John Pankow|Kate McNeil|Joyce Van Patten|Christine Forrest,George A. Romero,113,Thriller|Drama|Horror|Science Fiction,1988-07-29,17,6.0,1988,12907237,9854817,-3052420,6
9565,0.167846,7000000,19595031,12595031,The Serpent and the Rainbow,Bill Pullman|Cathy Tyson|Zakes Mokae|Paul Winfield|Brent Jennings,Wes Craven,98,Horror|Thriller,1988-02-05,37,5.7,1988,12907237,36131101,23223864,6
9568,0.155543,6000000,46616067,40616067,Colors,Sean Penn|Robert Duvall|MarÃ­a Conchita Alonso|Randy Brooks|Grand L. Bush,Dennis Hopper,120,Action|Crime|Drama,1988-04-15,36,6.4,1988,11063346,85954947,74891601,6
9569,0.154945,20000000,51684798,31684798,Biloxi Blues,Matthew Broderick|Christopher Walken|Matt Mulhern|Corey Parker|Casey Siemaszko,Mike Nichols,106,Comedy|Drama|Romance,1988-03-25,24,6.4,1988,36877820,95301135,58423315,6
9571,0.149591,2000000,725131,-1274869,Vampire's Kiss,Nicolas Cage|MarÃ­a Conchita Alonso|Jennifer Beals|Elizabeth Ashley|Kasi Lemmons,Robert Bierman,103,Comedy|Fantasy|Horror,1988-09-17,28,5.5,1988,3687782,1337062,-2350720,5
9578,0.117336,2500000,1189315,-1310685,The Lair of the White Worm,Amanda Donohoe|Hugh Grant|Catherine Oxenberg|Peter Capaldi|Sammi Davis,Ken Russell,93,Comedy|Horror,1988-09-14,19,5.4,1988,4609727,2192967,-2416760,5
9585,0.077948,15000000,6908797,-8091203,A Cry in the Dark,Meryl Streep|Sam Neill|Dale Reeves|David Hoflin|Jason Reason,Fred Schepisi,120,Drama|Foreign,1988-11-11,16,5.5,1988,27658365,12739068,-14919297,5
9587,0.076438,16000000,4192440,-11807560,Red Scorpion,Dolph Lundgren|M. Emmet Walsh|Al White|T. P. McKenna|Carmen Argenziano,Joseph Zito,105,Action|History|War,1988-12-24,22,4.6,1988,29502256,7730402,-21771854,5
9590,0.057681,5000000,3569939,-1430061,The New Adventures of Pippi Longstocking,Tami Erin|David Seaman|Cory Crow|Eileen Brennan|Dennis Dugan,Ken Annakin,100,Fantasy|Adventure|Family,1988-07-06,10,5.7,1988,9219455,6582578,-2636877,6
9594,3.474728,18000000,98235548,80235548,Predator,Arnold Schwarzenegger|Carl Weathers|Elpidia Carrillo|Bill Duke|Jesse Ventura,John McTiernan,107,Science Fiction|Action|Adventure|Thriller,1987-06-11,1250,7.1,1987,34543447,188521918,153978471,7
9595,2.0267,17000000,46357676,29357676,Full Metal Jacket,Matthew Modine|Adam Baldwin|Vincent D'Onofrio|R. Lee Ermey|Dorian Harewood,Stanley Kubrick,116,Drama|War,1987-06-26,1311,7.7,1987,32624367,88964109,56339742,8
9596,1.945847,6000000,213954274,207954274,Dirty Dancing,Jennifer Grey|Patrick Swayze|Jerry Orbach|Cynthia Rhodes|Jack Weston,Emile Ardolino,100,Drama|Music|Romance,1987-08-21,654,6.9,1987,11514482,410595461,399080979,7
9597,1.846689,22700000,38119483,15419483,Spaceballs,Mel Brooks|Rick Moranis|Bill Pullman|Daphne Zuniga|John Candy,Mel Brooks,96,Comedy|Science Fiction,1987-06-24,496,6.5,1987,43563125,73154354,29591229,6
9598,1.511663,40000000,191185897,151185897,The Living Daylights,Timothy Dalton|Maryam d'Abo|Jeroen KrabbÃ©|Joe Don Baker|John Rhys-Davies,John Glen,130,Action|Adventure|Thriller,1987-06-29,238,6.0,1987,76763217,366901114,290137897,6
9599,1.503371,13000000,53000000,40000000,RoboCop,Peter Weller|Nancy Allen|Ronny Cox|Kurtwood Smith|Miguel Ferrer,Paul Verhoeven,102,Action|Thriller|Science Fiction,1987-07-17,834,6.8,1987,24948045,101711263,76763218,7
9600,1.427206,3600000,5923044,2323044,Evil Dead II,Bruce Campbell|Sarah Berry|Dan Hicks|Kassie DePaiva|Denise Bixler,Sam Raimi,84,Horror|Comedy|Fantasy,1987-03-13,383,7.5,1987,6908689,11366797,4458108,7
9601,1.393529,15000000,120207127,105207127,Lethal Weapon,Mel Gibson|Danny Glover|Gary Busey|Mitchell Ryan|Tom Atkins,Richard Donner,110,Adventure|Action|Comedy|Thriller|Crime,1987-03-06,801,6.6,1987,28786206,230687145,201900939,7
9602,1.354524,27000000,38122105,11122105,The Running Man,Arnold Schwarzenegger|Richard Dawson|MarÃ­a Conchita Alonso|Yaphet Kotto|Jim Brown,Paul Michael Glaser,101,Action|Science Fiction,1987-11-13,352,6.3,1987,51815171,73159385,21344214,6
9603,1.285867,23000000,51881013,28881013,Jaws: The Revenge,Lorraine Gary|Lance Guest|Mario Van Peebles|Michael Caine|Karen Young,Joseph Sargent,89,Adventure|Thriller,1987-07-17,111,3.7,1987,44138850,99563837,55424987,4
9604,1.186793,16000000,30857814,14857814,The Princess Bride,Cary Elwes|Robin Wright|Mandy Patinkin|AndrÃ© the Giant|Chris Sarandon,Rob Reiner,98,Adventure|Family|Fantasy|Comedy|Romance,1987-09-18,1000,7.5,1987,30705287,59218627,28513340,7
9605,1.121083,5000000,44793222,39793222,A Nightmare on Elm Street 3: Dream Warriors,Robert Englund|Patricia Arquette|Heather Langenkamp|John Saxon|Craig Wasson,Chuck Russell,96,Horror|Thriller,1987-02-27,168,6.2,1987,9595402,85961796,76366394,6
9606,1.082108,15000000,43848069,28848069,Wall Street,Charlie Sheen|Michael Douglas|Martin Sheen|Daryl Hannah|John C. McGinley,Oliver Stone,126,Crime|Drama,1987-12-10,294,6.7,1987,28786206,84147971,55361765,7
9607,1.07467,20000000,299965036,279965036,Beverly Hills Cop II,Eddie Murphy|Judge Reinhold|John Ashton|Ronny Cox|Paul Reiser,Tony Scott,100,Action|Comedy|Crime,1987-05-18,333,6.1,1987,38381608,575657032,537275424,6
9608,1.065222,17000000,19300000,2300000,Superman IV: The Quest for Peace,Christopher Reeve|Margot Kidder|Gene Hackman|Jackie Cooper|Marc McClure,Sidney J. Furie,90,Action|Adventure|Fantasy|Science Fiction|Thriller,1987-07-23,149,4.3,1987,32624367,37038252,4413885,4
9609,1.026436,6000000,29180280,23180280,Raising Arizona,Nicolas Cage|Holly Hunter|Trey Wilson|John Goodman|William Forsythe,Joel Coen,94,Comedy|Crime,1987-03-01,268,7.0,1987,11514482,55999304,44484822,7
9610,1.016148,25000000,76270454,51270454,The Untouchables,Kevin Costner|Sean Connery|Robert De Niro|Andy GarcÃ­a|Charles Martin Smith,Brian De Palma,119,Crime|Drama|History|Thriller,1987-06-02,751,7.5,1987,47977010,146369136,98392126,7
9611,1.011111,13000000,123922370,110922370,"Good Morning, Vietnam",Robin Williams|Forest Whitaker|Tung Thanh Tran|Chintara Sukapatana|Bruno Kirby,Barry Levinson,121,Comedy|Drama|War,1987-12-23,363,7.0,1987,24948045,237816996,212868951,7
9612,0.97023,23000000,43984230,20984230,The Last Emperor,John Lone|Peter O'Toole|Joan Chen|Dennis Dun|Ryuichi Sakamoto,Bernardo Bertolucci,163,Drama|History,1987-10-21,165,7.1,1987,44138850,84409275,40270425,7
9613,0.865812999999999,14000000,320145693,306145693,Fatal Attraction,Michael Douglas|Glenn Close|Anne Archer|Ellen Hamilton Latzen|Jane Krakowski,Adrian Lyne,119,Horror|Drama|Romance|Thriller,1987-09-11,131,6.4,1987,26867126,614385336,587518210,6
9617,0.754116,17000000,17185632,185632,Angel Heart,Mickey Rourke|Robert De Niro|Lisa Bonet|Charlotte Rampling|Stocker Fontelieu,Alan Parker,113,Horror|Mystery|Thriller,1987-03-06,139,6.7,1987,32624367,32980610,356243,7
9618,0.721427,25000000,16057580,-8942420,Over the Top,Sylvester Stallone|Robert Loggia|Rick Zumwalt|David Mendenhall|Bruce Way,Menahem Golan,93,Action|Drama,1987-02-13,182,5.4,1987,47977010,30815787,-17161223,5
9620,0.658247999999999,8500000,32222567,23722567,The Lost Boys,Jason Patric|Corey Haim|Corey Feldman|Dianne Wiest|Kiefer Sutherland,Joel Schumacher,97,Comedy|Horror,1987-07-31,295,6.5,1987,16312183,61837697,45525514,6
9622,0.614942,3500000,14000000,10500000,Creepshow 2,George Kennedy|Dorothy Lamour|Lois Chiles|Tom Savini|Tom Wright,Michael Gornick,92,Horror,1987-05-01,42,5.8,1987,6716781,26867126,20150345,6
9624,0.601451,1880006,26713187,24833181,Overboard,Goldie Hawn|Kurt Russell|Edward Herrmann|Katherine Helmond|Mike Hagerty,Garry Marshall,106,Comedy|Romance,1987-12-16,115,6.6,1987,3607882,51264754,47656872,7
9625,0.598029,3000000,3221568,221568,Barfly,Mickey Rourke|Faye Dunaway|Alice Krige|Jack Nance|J.C. Quinn,Barbet Schroeder,100,Comedy|Drama|Romance,1987-09-02,35,7.1,1987,5757241,6182448,425207,7
9626,0.57606,20000000,51249404,31249404,Broadcast News,William Hurt|Albert Brooks|Holly Hunter|Robert Prosky|Lois Chiles,James L. Brooks,133,Comedy|Drama|Romance,1987-12-16,42,6.3,1987,38381608,98351728,59970120,6
9628,0.548575,18000000,39321715,21321715,Blind Date,Kim Basinger|Bruce Willis|John Larroquette|William Daniels|George Coe,Blake Edwards,95,Comedy|Romance,1987-03-27,57,5.6,1987,34543447,75461534,40918087,6
9630,0.5137,20000000,66673516,46673516,Dragnet,Dan Aykroyd|Tom Hanks|Christopher Plummer|Harry Morgan|Alexandra Paul,Tom Mankiewicz,106,Action|Comedy|Crime,1987-06-25,74,5.8,1987,38381608,127951840,89570232,6
9634,0.47393,15000000,13290368,-1709632,The Pick-up Artist,Molly Ringwald|Robert Downey Jr.|Dennis Hopper|Danny Aiello|Harvey Keitel,James Toback,81,Romance|Comedy|Crime|Drama,1987-09-18,14,5.6,1987,28786206,25505285,-3280921,6
9638,0.447184,10000000,14000,-9986000,Cherry 2000,Melanie Griffith|David Andrews|Pamela Gidley|Ben Johnson|Marshall Bell,Steve De Jarnatt,99,Science Fiction,1987-11-12,35,6.0,1987,19190804,26867,-19163937,6
9641,0.406719,15000000,35509515,20509515,No Way Out,Kevin Costner|Gene Hackman|Sean Young|Will Patton|Howard Duff,Roger Donaldson,114,Crime|Drama|Action|Thriller|Mystery,1987-08-14,67,7.0,1987,28786206,68145615,39359409,7
9643,0.397728,12000000,110996879,98996879,The Secret of My Success,Michael J. Fox|Helen Slater|Richard Jordan|Margaret Whitton|John Pankow,Herbert Ross,111,Comedy,1987-04-10,63,5.7,1987,23028965,213011939,189982974,6
9646,0.380326,11000000,168000000,157000000,Three Men and a Baby,Tom Selleck|Steve Guttenberg|Ted Danson|Nancy Travis|Margaret Colin,Leonard Nimoy,102,Family|Comedy|Drama,1987-11-27,103,6.1,1987,21109884,322405513,301295629,6
9651,0.356749,3000000,14182492,11182492,Prince of Darkness,Donald Pleasence|Lisa Blount|Victor Wong|Jameson Parker|Dennis Dun,John Carpenter,101,Horror,1987-10-23,62,6.5,1987,5757241,27217342,21460101,6
9653,0.349927,1000000,14564027,13564027,Hellraiser,Andrew Robinson|Clare Higgins|Ashley Laurence|Sean Chapman|Oliver Smith,Clive Barker,94,Horror,1987-09-11,189,6.7,1987,1919080,27949539,26030459,7
9654,0.187714,7200000,2300000,-4900000,Mio min Mio,Nick Pickard|Christian Bale|Timothy Bottoms|Susannah York|Christopher Lee,Vladimir Grammatikov,99,Adventure|Drama|Fantasy|Family|Mystery,1987-07-01,11,6.1,1987,13817379,4413885,-9403494,6
9659,0.322457,6500000,54215416,47715416,La Bamba,Lou Diamond Phillips|Danielle von Zerneck|Elizabeth PeÃ±a|Rosanna DeSoto|Esai Morales,Luis Valdez,108,Drama|Music,1987-07-24,43,6.9,1987,12474022,104043744,91569722,7
9660,0.32054,17000000,10278549,-6721451,Someone to Watch Over Me,Tom Berenger|Mimi Rogers|Lorraine Bracco|Jerry Orbach|John Rubinstein,Ridley Scott,106,Crime|Drama|Romance|Thriller,1987-10-09,10,5.4,1987,32624367,19725362,-12899005,5
9665,0.313707,18000000,18532286,532286,Project X,Matthew Broderick|Helen Hunt|Willie|William Sadler|Johnny Ray McGhee,Jonathan Kaplan,108,Action|Comedy|Drama|Science Fiction,1987-04-17,29,6.0,1987,34543447,35564947,1021500,6
9669,0.287829,14000000,57915972,43915972,Throw Momma from the Train,Danny DeVito|Billy Crystal|Kim Greist|Anne Ramsey|Kate Mulgrew,Danny DeVito,88,Crime|Comedy,1987-12-11,54,5.8,1987,26867126,111145408,84278282,6
9671,0.28269,12000000,3769990,-8230010,The Monster Squad,Andre Gower|Robby Kiger|Stephen Macht|Duncan Regehr|Ryan Lambert,Fred Dekker,82,Horror|Comedy|Action|Fantasy|Science Fiction,1987-08-14,58,7.0,1987,23028965,7234914,-15794051,7
9679,0.481561,1800000,31623833,29823833,Can't Buy Me Love,Patrick Dempsey|Seth Green|Gerardo MejÃ­a|Courtney Gains|Sharon Farrell,Steve Rash,94,Drama|Comedy|Romance|Family,1987-08-14,72,6.4,1987,3454344,60688679,57234335,6
9688,0.20076,6000000,42721196,36721196,Mannequin,Andrew McCarthy|Kim Cattrall|Estelle Getty|James Spader|G. W. Bailey,Michael Gottlieb,89,Fantasy|Comedy|Romance,1987-02-13,61,5.6,1987,11514482,81985411,70470929,6
9704,0.146481,3000000,23509382,20509382,Ernest Goes to Camp,Jim Varney|Victoria Racimo|John Vernon|Gailard Sartain|Daniel Butler,John R. Cherry III,92,Comedy|Family,1987-05-22,15,6.1,1987,5757241,45116395,39359154,6
9710,0.159907,250000,154323,-95677,"Silent Night, Deadly Night Part 2",Eric Freeman|James Newman|Elizabeth Kaitan|Jean Miller|Darrel Guilbeau,Lee Harry,88,Comedy|Horror,1987-04-10,11,5.5,1987,479770,296158,-183612,5
9719,3.309196,12000000,56715371,44715371,2001: A Space Odyssey,Keir Dullea|Douglas Rain|Gary Lockwood|William Sylvester|Daniel Richter,Stanley Kubrick,149,Science Fiction|Mystery|Adventure,2068-04-05,1708,7.7,1968,75227563,355546597,280319034,8
9720,1.152937,5800000,33395426,27595426,Planet of the Apes,Charlton Heston|Roddy McDowall|Kim Hunter|Maurice Evans|James Daly,Franklin J. Schaffner,112,Adventure|Science Fiction|Mystery,2068-02-07,469,7.2,1968,36359988,209354710,172994722,7
9724,0.786853999999999,5500000,42300873,36800873,Bullitt,Steve McQueen|Jacqueline Bisset|Robert Vaughn|Don Gordon|Simon Oakland,Peter Yates,113,Action|Crime|Drama|Thriller,2068-10-17,143,6.7,1968,34479299,265182633,230703334,7
9727,0.724527,3200000,33395426,30195426,Rosemary's Baby,Mia Farrow|John Cassavetes|Ruth Gordon|Sidney Blackmer|Maurice Evans,Roman Polanski,136,Horror|Drama|Mystery,2068-06-12,448,7.3,1968,20060683,209354710,189294027,7
9729,0.633128999999999,10000000,16800000,6800000,Oliver!,Ron Moody|Shani Wallis|Oliver Reed|Harry Secombe|Mark Lester,Carol Reed,153,Drama|Family|Music,2068-09-26,42,6.2,1968,62689636,105318588,42628952,6
9730,0.621202,1800000,6800000,5000000,Hang 'em High,Clint Eastwood|Inger Stevens|Ed Begley|Pat Hingle|Ben Johnson,Ted Post,114,Western,2068-07-31,86,6.3,1968,11284134,42628952,31344818,6
9731,0.569422,7700000,21000000,13300000,Where Eagles Dare,Richard Burton|Clint Eastwood|Mary Ure|Patrick Wymark|Michael Hordern,Brian G. Hutton,155,Adventure|Drama|Action|History|War,2068-12-04,116,6.9,1968,48271019,131648235,83377216,7
9737,0.378658,7000000,11000000,4000000,The Green Berets,John Wayne|David Janssen|George Takei|Jack Soo|Jim Hutton,John Wayne,142,War|Drama,2068-07-04,17,5.6,1968,43882745,68958599,25075854,6
9756,0.045242,950000,814666,-135334,Charly,Cliff Robertson|Claire Bloom|Lilia Skala|Leon Janney|Ruth White,Ralph Nelson,103,Drama|Romance|Science Fiction,2068-09-23,13,6.0,1968,5955515,5107111,-848404,6
9758,3.264571,13000000,47542841,34542841,The Godfather: Part II,Al Pacino|Robert Duvall|Diane Keaton|Robert De Niro|John Cazale,Francis Ford Coppola,200,Drama|Crime,1974-12-20,2131,8.1,1974,57489690,210247939,152758249,8
9759,1.650848,6000000,30000000,24000000,Chinatown,Jack Nicholson|Faye Dunaway|John Huston|Perry Lopez|John Hillerman,Roman Polanski,130,Crime|Drama|Mystery|Thriller,1974-06-20,456,7.7,1974,26533703,132668516,106134813,8
9760,1.619555,7000000,97572000,90572000,The Man with the Golden Gun,Roger Moore|Christopher Lee|Britt Ekland|Maud Adams|HervÃ© Villechaize,Guy Hamilton,125,Adventure|Action|Thriller,1974-12-01,283,6.1,1974,30955987,431491083,400535096,6
9761,1.049959,2800000,86273333,83473333,Young Frankenstein,Gene Wilder|Peter Boyle|Marty Feldman|Madeline Kahn|Cloris Leachman,Mel Brooks,106,Comedy|Science Fiction,1974-12-15,445,7.5,1974,12382394,381525170,369142776,7
9762,0.906087,85000,30859000,30774000,The Texas Chain Saw Massacre,Allen Danziger|Paul A. Partain|William Vail|Teri McMinn|Edwin Neal,Tobe Hooper,83,Horror|Thriller,1974-10-01,249,6.8,1974,375894,136467258,136091364,7
9764,0.761779,1600000,4420000,2820000,The Conversation,Gene Hackman|John Cazale|Frederic Forrest|Cindy Williams|Harrison Ford,Francis Ford Coppola,113,Crime|Drama|Mystery,1974-04-07,166,7.2,1974,7075654,19546494,12470840,7
9767,0.577802,2600000,119500000,116900000,Blazing Saddles,Cleavon Little|Gene Wilder|Harvey Korman|Slim Pickens|Madeline Kahn,Mel Brooks,93,Comedy|Western,1974-02-07,334,7.0,1974,11497938,528462924,516964986,7
9769,0.463337,3000000,47000000,44000000,Airport 1975,"Charlton Heston|Karen Black|George Kennedy|Gloria Swanson|Efrem Zimbalist, Jr.",Jack Smight,107,Action|Adventure|Drama|Thriller,1974-10-18,30,6.1,1974,13266851,207847342,194580491,6
9770,0.415866,3000000,12800000,9800000,The Sugarland Express,Goldie Hawn|William Atherton|Ben Johnson|Louise Latham|Michael Sacks,Steven Spielberg,110,Action|Crime|Drama,1974-04-05,33,6.1,1974,13266851,56605233,43338382,6
9772,0.372231,6500000,26533200,20033200,The Great Gatsby,Robert Redford|Mia Farrow|Bruce Dern|Karen Black|Sam Waterston,Jack Clayton,144,Drama|Romance,1974-03-27,74,6.1,1974,28744845,117337342,88592497,6
9781,0.400179,3000000,22000000,19000000,Death Wish,Charles Bronson|Hope Lange|Vincent Gardenia|Steven Keats|William Redfield,Michael Winner,93,Action|Crime|Drama|Thriller,1974-07-24,52,6.8,1974,13266851,97290245,84023394,7
9785,0.226287,14000000,116000000,102000000,The Towering Inferno,Steve McQueen|Paul Newman|Faye Dunaway|Robert Vaughn|William Holden,John Guillermin,159,Action|Thriller,1974-12-14,72,7.2,1974,61911974,512984931,451072957,7
9790,0.186995,7000000,79666653,72666653,Earthquake,Charlton Heston|Ava Gardner|George Kennedy|Lorne Greene|GeneviÃ¨ve Bujold,Mark Robson,123,Action|Drama|Thriller,1974-11-15,23,6.0,1974,30955987,352308556,321352569,6
9805,3.258151,3000000,108981275,105981275,One Flew Over the Cuckoo's Nest,Jack Nicholson|Louise Fletcher|Danny DeVito|William Redfield|Scatman Crothers,MiloÅ¡ Forman,133,Drama,1975-11-18,1612,8.0,1975,12155463,441572637,429417174,8
9806,2.563191,7000000,470654000,463654000,Jaws,Roy Scheider|Robert Shaw|Richard Dreyfuss|Lorraine Gary|Murray Hamilton,Steven Spielberg,124,Horror|Thriller|Adventure,1975-06-18,1415,7.3,1975,28362748,1907005841,1878643093,7
9807,2.234953,400000,5028948,4628948,Monty Python and the Holy Grail,Graham Chapman|John Cleese|Eric Idle|Michael Palin|Terry Gilliam,Terry Gilliam|Terry Jones,91,Adventure|Comedy|Fantasy,1975-03-13,1097,7.6,1975,1620728,20376397,18755669,8
9808,1.40994699999999,1200000,112892319,111692319,The Rocky Horror Picture Show,Tim Curry|Susan Sarandon|Barry Bostwick|Richard O'Brien|Patricia Quinn,Jim Sharman,100,Comedy|Horror|Music|Science Fiction,1975-08-14,332,7.1,1975,4862185,457419488,452557303,7
9809,1.019569,11000000,20000000,9000000,Barry Lyndon,Ryan O'Neal|Marisa Berenson|Hardy KrÃ¼ger|Diana KÃ¶rner|Frank Middlemass,Stanley Kubrick,184,Drama|Romance|War,1975-12-18,240,7.2,1975,44570032,81036423,36466391,7
9810,0.790976,5000000,41833347,36833347,The Return of the Pink Panther,Peter Sellers|Christopher Plummer|Herbert Lom|Catherine Schell|Peter Arne,Blake Edwards,113,Comedy,1975-05-21,58,6.6,1975,20259105,169501241,149242136,7
9822,0.423755,2700000,5000000,2300000,Hard Times,Charles Bronson|James Coburn|Jill Ireland|Strother Martin|Margaret Blye,Walter Hill,93,Drama,1975-09-04,14,5.9,1975,10939917,20259105,9319188,6
9824,0.347121,5000000,34251525,29251525,Tommy,Oliver Reed|Ann-Margret|Roger Daltrey|Elton John|Eric Clapton,Ken Russell,111,Drama|Music,1975-03-19,29,6.1,1975,20259105,138781054,118521949,6
9830,0.277357,1800000,46665856,44865856,Dog Day Afternoon,Al Pacino|John Cazale|Charles Durning|Chris Sarandon|James Broderick,Sidney Lumet,125,Crime|Drama|Thriller,1975-08-11,312,7.2,1975,7293278,189081703,181788425,7
9849,3.170651,1100000,59600000,58500000,Dr. No,Sean Connery|Ursula Andress|Joseph Wiseman|Jack Lord|Bernard Lee,Terence Young,110,Adventure|Action|Thriller,2062-10-04,560,6.7,1962,7929293,429623553,421694260,7
9850,1.168767,15000000,70000000,55000000,Lawrence of Arabia,Peter O'Toole|Alec Guinness|Anthony Quinn|Jack Hawkins|Omar Sharif,David Lean,216,Adventure|Drama|History|War,2062-12-10,517,7.5,1962,108126733,504591421,396464688,7
9852,0.810805,2000000,13129846,11129846,To Kill a Mockingbird,Gregory Peck|John Megna|Frank Overton|Rosemary Murphy|Ruth White,Robert Mulligan,129,Crime|Drama,2062-12-25,317,7.7,1962,14416897,94645823,80228926,8
9856,0.526108,15000000,50000000,35000000,How the West Was Won,Carroll Baker|Lee J. Cobb|Henry Fonda|Carolyn Jones|Karl Malden,John Ford|Henry Hathaway|George Marshall|Richard Thorpe,162,Western|Action|Adventure|Drama,2062-11-01,37,6.1,1962,108126733,360422443,252295710,6
9858,0.507078,3200000,8000000,4800000,The Man Who Shot Liberty Valance,John Wayne|James Stewart|Vera Miles|Lee Marvin|Edmond O'Brien,John Ford,123,Western,2062-04-22,134,7.1,1962,23067036,57667591,34600555,7
9866,0.23941,2650000,3100000,450000,Birdman of Alcatraz,Burt Lancaster|Karl Malden|Thelma Ritter|Neville Brand|Betty Field,John Frankenheimer,143,Drama,2062-07-03,19,6.4,1962,19102389,22346191,3243802,6
9871,0.461577,500000,2500000,2000000,The Miracle Worker,Anne Bancroft|Patty Duke|Victor Jory|Inga Swenson|Andrew Prine,Arthur Penn,106,Drama,2062-05-22,22,6.8,1962,3604224,18021122,14416898,7
9881,3.153791,3500000,124900000,121400000,Goldfinger,Sean Connery|Honor Blackman|Gert FrÃ¶be|Shirley Eaton|Tania Mallet,Guy Hamilton,110,Adventure|Action|Thriller,2064-09-17,602,7.0,1964,24605935,878080399,853474464,7
9882,2.210475,1800000,9440272,7640272,Dr. Strangelove or: How I Learned to Stop Worrying and Love the Bomb,Peter Sellers|George C. Scott|Sterling Hayden|Keenan Wynn|Slim Pickens,Stanley Kubrick,95,Drama|Comedy|War,2064-01-29,804,7.7,1964,12654481,66367636,53713155,8
9883,1.987819,6000000,102272727,96272727,Mary Poppins,Julie Andrews|Dick Van Dyke|David Tomlinson|Glynis Johns|Hermione Baddeley,Robert Stevenson,139,Comedy|Music|Family|Fantasy,2064-08-27,613,7.2,1964,42181604,719004619,676823015,7
9884,0.812194,500000,1000549,500549,A Hard Day's Night,John Lennon|Paul McCartney|George Harrison|Ringo Starr|Wilfrid Brambell,Richard Lester,88,Comedy|Music,2064-07-06,92,6.9,1964,3515133,7034127,3518994,7
9886,0.663446,2135161,7000000,4864839,Marnie,Tippi Hedren|Sean Connery|Diane Baker|Martin Gabel|Louise Latham,Alfred Hitchcock,130,Crime|Drama|Mystery|Thriller,2064-07-09,94,7.2,1964,15010752,49211871,34201119,7
9887,0.633882,17000000,72000000,55000000,My Fair Lady,Audrey Hepburn|Rex Harrison|Stanley Holloway|Wilfrid Hyde-White|Gladys Cooper,George Cukor,170,Drama|Family|Music|Romance,2064-10-21,184,7.1,1964,119514545,506179253,386664708,7
9905,0.182922,3000000,12000000,9000000,The Night of the Iguana,Richard Burton|Ava Gardner|Deborah Kerr|Sue Lyon|Skip Ward,John Huston,125,Drama|Romance,2064-08-06,15,5.7,1964,21090802,84363208,63272406,6
9923,3.072555,2200000,26589000,24389000,A Clockwork Orange,Malcolm McDowell|Patrick Magee|Adrienne Corri|Michael Bates|Warren Clarke,Stanley Kubrick,136,Science Fiction|Drama,2071-12-18,1786,7.7,1971,11847428,143186947,131339519,8
9924,2.430667,3000000,4000000,1000000,Willy Wonka & the Chocolate Factory,Gene Wilder|Jack Albertson|Peter Ostrum|Roy Kinnear|Denise Nickerson,Mel Stuart,100,Family|Fantasy,2071-06-29,434,7.2,1971,16155584,21540779,5385195,7
9925,1.75511699999999,7200000,116000000,108800000,Diamonds Are Forever,Sean Connery|Jill St. John|Charles Gray|Lana Wood|Jimmy Dean,Guy Hamilton,120,Adventure|Action|Thriller|Science Fiction,2071-12-13,331,6.2,1971,38773403,624682610,585909207,6
9927,0.885391,4000000,35976000,31976000,Dirty Harry,Clint Eastwood|Harry Guardino|Reni Santoni|John Vernon|Andrew Robinson,Don Siegel,102,Action|Crime|Thriller,2071-12-22,300,7.2,1971,21540779,193737772,172196993,7
9928,0.861629999999999,2500000,12348905,9848905,Escape from the Planet of the Apes,Roddy McDowall|Kim Hunter|Bradford Dillman|Natalie Trundy|Eric Braeden,Don Taylor,98,Action|Science Fiction,2071-05-20,125,6.2,1971,13462987,66501260,53038273,6
9929,0.735185,2200000,3251794,1051794,Straw Dogs,Dustin Hoffman|Susan George|Peter Vaughan|T. P. McKenna|Del Henney,Sam Peckinpah,118,Crime|Drama|Thriller|Mystery,2071-12-29,84,6.8,1971,11847428,17511544,5664116,7
9932,0.627942,777000,2437000,1660000,THX 1138,Robert Duvall|Donald Pleasence|Don Pedro Colley|Maggie McOmie|Ian Wolfe,George Lucas,86,Drama|Mystery|Science Fiction|Thriller,2071-03-11,125,6.1,1971,4184296,13123720,8939424,6
9934,0.604241,1800000,41158757,39358757,The French Connection,Gene Hackman|Fernando Rey|Roy Scheider|Tony Lo Bianco|Marcel Bozzuffi,William Friedkin,104,Action|Crime|Thriller,2071-10-09,201,7.0,1971,9693350,221647928,211954578,7
9935,0.560488,725000,10600000,9875000,Play Misty for Me,Clint Eastwood|Jessica Walter|John Larch|Donna Mills|Jack Ging,Clint Eastwood,102,Crime|Drama|Romance|Thriller,2071-11-03,33,5.8,1971,3904266,57083066,53178800,6
9948,0.317925,4000000,12121618,8121618,Shaft,Richard Roundtree|Moses Gunn|Charles Cioffi|Christopher St. John|Gwenn Mitchell,Gordon Parks,100,Adventure|Action|Thriller|Crime,2071-07-02,30,6.2,1971,21540779,65277275,43736496,6
9950,0.291077,9000000,10404330,1404330,Fiddler on the Roof,Chaim Topol|Norma Crane|Leonard Frey|Molly Picon|Paul Mann,Norman Jewison,181,Drama|Music|Romance,2071-11-03,68,6.6,1971,48466754,56029345,7562591,7
9951,0.369308,1300000,29133000,27833000,The Last Picture Show,Timothy Bottoms|Jeff Bridges|Cybill Shepherd|Ben Johnson|Cloris Leachman,Peter Bogdanovich,118,Drama,2071-10-03,42,7.0,1971,7000753,156886883,149886130,7
9952,0.275523,1300000,72266306,70966306,Vanishing Point,Barry Newman|Cleavon Little|Dean Jagger|Victoria Medlin|Gilda Texter,Richard C. Sarafian,99,Action|Thriller|Drama,2071-01-15,48,7.1,1971,7000753,389168143,382167390,7
9978,2.679627,65000000,261317921,196317921,Total Recall,Arnold Schwarzenegger|Sharon Stone|Rachel Ticotin|Ronny Cox|Michael Ironside,Paul Verhoeven,113,Action|Adventure|Science Fiction,1990-06-01,1012,6.8,1990,108478405,436113096,327634691,7
9979,2.659926,25000000,46836394,21836394,Goodfellas,Robert De Niro|Ray Liotta|Joe Pesci|Lorraine Bracco|Paul Sorvino,Martin Scorsese,146,Drama|Crime,1990-09-12,1798,8.0,1990,41722463,78165189,36442726,8
9980,2.535646,70000000,240031094,170031094,Die Hard 2,Bruce Willis|Bonnie Bedelia|William Atherton|Reginald VelJohnson|Franco Nero,Renny Harlin,124,Action|Thriller,1990-07-02,1252,6.4,1990,116822897,400587542,283764645,6
9981,2.441201,40000000,244527583,204527583,Back to the Future Part III,Michael J. Fox|Christopher Lloyd|Mary Steenburgen|Thomas F. Wilson|Lea Thompson,Robert Zemeckis,118,Adventure|Action|Comedy|Science Fiction|Family,1990-05-25,1762,6.9,1990,66755941,408091726,341335785,7
9982,2.285811,20000000,53000000,33000000,Edward Scissorhands,Johnny Depp|Winona Ryder|Dianne Wiest|Alan Arkin|Anthony Michael Hall,Tim Burton,105,Fantasy|Drama|Romance,1990-12-05,1939,7.4,1990,33377970,88451622,55073652,7
9983,2.212092,14000000,463000000,449000000,Pretty Woman,Julia Roberts|Richard Gere|Ralph Bellamy|Jason Alexander|HÃ©ctor Elizondo,Garry Marshall,119,Romance|Comedy,1990-03-23,963,6.9,1990,23364579,772700024,749335445,7
9984,1.761161,54000000,136766062,82766062,The Godfather: Part III,Al Pacino|Diane Keaton|Andy GarcÃ­a|Talia Shire|Sofia Coppola,Francis Ford Coppola,162,Drama|Action|Thriller|Crime,1990-12-24,880,6.9,1990,90120521,228248681,138128160,7
9985,1.695911,22000000,424208848,402208848,Dances with Wolves,Kevin Costner|Mary McDonnell|Graham Greene|Rodney A. Grant|Floyd Red Crow Westerman,Kevin Costner,181,Adventure|Drama|Western,1990-11-09,585,7.3,1990,36715767,707961527,671245760,7
9986,1.513223,22000000,505000000,483000000,Ghost,Patrick Swayze|Demi Moore|Tony Goldwyn|Whoopi Goldberg|Vincent Schiavelli,Jerry Zucker,127,Fantasy|Drama|Thriller|Mystery|Romance,1990-07-12,714,6.7,1990,36715767,842793762,806077995,7
9987,1.469009,13500000,201965915,188465915,Teenage Mutant Ninja Turtles,Judith Hoag|Elias Koteas|Josh Pais|Brian Tochi|Leif Tilden,Steve Barron,93,Science Fiction|Action|Adventure|Comedy|Family,1990-03-30,267,6.6,1990,22530130,337060620,314530490,7
9988,1.295204,20000000,61276872,41276872,Misery,James Caan|Kathy Bates|Richard Farnsworth|Frances Sternhagen|Lauren Bacall,Rob Reiner,107,Horror|Thriller,1990-11-28,501,7.5,1990,33377970,102264882,68886912,7
9989,1.243528,42000000,119946358,77946358,Rocky V,Sylvester Stallone|Talia Shire|Burt Young|Sage Stallone|Burgess Meredith,John G. Avildsen,104,Drama,1990-10-18,354,5.3,1990,70093738,200178301,130084563,5
9990,1.19834699999999,13000000,35763605,22763605,Child's Play 2,Alex Vincent|Jenny Agutter|Gerrit Graham|Christine Elise|Brad Dourif,John Lafia,84,Drama|Horror,1990-11-09,140,5.9,1990,21695681,59685828,37990147,6
9992,1.072912,30,200,170,The Hunt for Red October,Alec Baldwin|Sean Connery|Scott Glenn|Sam Neill|James Earl Jones,John McTiernan,134,Action|Adventure|Thriller,1990-03-02,615,6.9,1990,50,333,283,7
9993,1.034127,35000000,57120318,22120318,Predator 2,Kevin Peter Hall|Danny Glover|Gary Busey|RubÃ©n Blades|MarÃ­a Conchita Alonso,Stephen Hopkins,108,Science Fiction|Action|Thriller,1990-11-20,374,5.7,1990,58411448,95328015,36916567,6
9994,1.0198,60000000,157920733,97920733,Days of Thunder,Tom Cruise|Robert Duvall|Nicole Kidman|Randy Quaid|Cary Elwes,Tony Scott,107,Adventure,1990-06-27,198,5.8,1990,100133912,263553680,163419768,6
9996,0.972222,14000000,5080409,-8919591,Miller's Crossing,Gabriel Byrne|Marcia Gay Harden|John Turturro|Jon Polito|J.E. Freeman,Joel Coen,115,Drama|Thriller|Crime,1990-09-21,206,7.4,1990,23364579,8478687,-14885892,7
9997,0.890276,50000000,41482207,-8517793,Gremlins 2: The New Batch,Zach Galligan|Phoebe Cates|John Glover|Robert Prosky|Robert Picardo,Joe Dante,106,Comedy|Horror|Fantasy,1990-06-15,303,6.1,1990,83444927,69229594,-14215333,6
9998,0.85552,11000000,48572000,37572000,Tremors,Kevin Bacon|Fred Ward|Finn Carter|Michael Gross|Reba McEntire,Ron Underwood,96,Action|Horror,1990-01-19,485,6.3,1990,18357883,81061739,62703856,6
9999,0.774737,35000000,45681173,10681173,RoboCop 2,Peter Weller|Belinda Bauer|John Glover|Gabriel Damon|Mario Machado,Irvin Kershner,117,Action|Adventure|Crime|Science Fiction|Thriller,1990-06-22,249,5.3,1990,58411448,76237242,17825794,5
10000,0.768724,32000000,16283667,-15716333,The Neverending Story II: The Next Chapter,Jonathan Brandis|Kenny Morrison|Clarissa Burt|John Wesley Shipp|Martin Umbach,George T. Miller,89,Drama|Family|Fantasy|Adventure,1990-10-24,111,5.7,1990,53404753,27175788,-26228965,6
10003,0.644447999999999,38000000,153518974,115518974,Another 48 Hrs.,Eddie Murphy|Nick Nolte|Brion James|Kevin Tighe|Ed O'Ross,Walter Hill,95,Thriller|Action|Comedy|Crime|Drama,1990-06-08,90,5.5,1990,63418144,256207591,192789447,5
10005,0.635353,6000000,24078196,18078196,Lionheart,Jean-Claude Van Damme|Harrison Page|Deborah Rennard|Ashley Johnson|Brian Thompson,Sheldon Lettich,105,Action|Thriller,1990-06-07,82,5.8,1990,10013391,40184066,30170675,6
10006,0.610615,4000000,16853487,12853487,Death Warrant,Jean-Claude Van Damme|Robert Guillaume|Cynthia Gibb|Patrick Kilpatrick|Art LaFleur,Deran Sarafian,93,Action|Crime|Drama|Mystery|Thriller,1990-09-14,57,5.4,1990,6675594,28126759,21451165,5
10011,0.521085,9500000,14560247,5060247,Wild at Heart,Nicolas Cage|Laura Dern|Willem Dafoe|J.E. Freeman|Crispin Glover,David Lynch,124,Comedy|Crime|Thriller,1990-05-01,145,6.5,1990,15854536,24299574,8445038,6
10014,0.51308,26000000,61489265,35489265,Flatliners,Kiefer Sutherland|Julia Roberts|Kevin Bacon|William Baldwin|Oliver Platt,Joel Schumacher,115,Drama|Horror|Science Fiction|Thriller,1990-08-09,179,6.0,1990,43391362,102619344,59227982,6
10019,0.499506,25000000,25965144,965144,Jacob's Ladder,Tim Robbins|Elizabeth PeÃ±a|Danny Aiello|Matt Craven|Pruitt Taylor Vince,Adrian Lyne,113,Drama|Mystery|Horror,1990-11-02,134,6.8,1990,41722463,43333190,1610727,7
10021,0.480169,11000000,8266343,-2733657,Cry-Baby,Johnny Depp|Amy Locane|Polly Bergen|Susan Tyrrell|Traci Lords,John Waters,85,Music|Comedy,1990-04-05,138,6.4,1990,18357883,13795687,-4562196,6
10022,0.465917,10000000,16153593,6153593,Mo' Better Blues,Denzel Washington|Spike Lee|Wesley Snipes|Giancarlo Esposito|John Turturro,Spike Lee,129,Drama|Romance,1990-08-03,24,6.0,1990,16688985,26958707,10269722,6
10023,0.459932,7000000,9229401,2229401,Dark Angel,Dolph Lundgren|Brian Benben|Betsy Brantley|Matthias Hues|Jay Bilas,Craig R. Baxley,91,Action|Thriller|Science Fiction|Crime|Horror,1990-01-26,37,5.4,1990,11682289,15402933,3720644,5
10027,0.438396,47000000,103738726,56738726,Dick Tracy,Warren Beatty|Al Pacino|Madonna|Charlie Korsmo|Glenne Headly,Warren Beatty,103,Adventure|Action|Comedy|Thriller|Crime,1990-06-15,125,5.7,1990,78438231,173129408,94691177,6
10028,0.429512,16000000,48878502,32878502,Darkman,Liam Neeson|Frances McDormand|Colin Friels|Larry Drake|Nelson Mashita,Sam Raimi,96,Action|Science Fiction|Crime,1990-08-24,148,6.0,1990,26702376,81573260,54870884,6
10031,0.42047,4200000,5835247,1635247,Night of the Living Dead,Patricia Tallman|Tony Todd|Tom Towles|McKee Anderson|Bill Moseley,Tom Savini,88,Horror,1990-10-19,63,6.7,1990,7009373,9738435,2729062,7
10035,0.409621,47000000,15691192,-31308808,The Bonfire of the Vanities,Tom Hanks|Bruce Willis|Melanie Griffith|Kim Cattrall|Saul Rubinek,Brian De Palma,125,Comedy|Drama,1990-12-21,46,4.8,1990,78438231,26187007,-52251224,5
10036,0.403249,12000000,46044400,34044400,Marked for Death,Steven Seagal|Basil Wallace|Keith David|Tom Wright|Joanna Pacula,Dwight H. Little,94,Action|Thriller,1990-10-05,44,6.0,1990,20026782,76843431,56816649,6
10039,0.386018,15000000,201957688,186957688,Kindergarten Cop,Arnold Schwarzenegger|Penelope Ann Miller|Pamela Reed|Linda Hunt|Richard Tyson,Ivan Reitman,111,Comedy,1990-12-21,304,5.7,1990,25033478,337046890,312013412,6
10043,0.592379,1000000,2554476,1554476,King of New York,Christopher Walken|David Caruso|Laurence Fishburne|Victor Argo|Wesley Snipes,Abel Ferrara,103,Thriller|Crime,1990-07-18,46,6.2,1990,1668898,4263161,2594263,6
10044,0.369847,10500000,11582891,1082891,Graveyard Shift,David Andrews|Kelly Wolf|Stephen Macht|Robert Alan Beuth|Andrew Divoff,Ralph S. Singleton,89,Drama|Horror,1990-10-26,20,4.7,1990,17523434,19330669,1807235,5
10046,0.339218,25000000,2075084,-22924916,The Sheltering Sky,Debra Winger|John Malkovich|Campbell Scott|Jill Bennett|Timothy Spall,Bernardo Bertolucci,138,Adventure|Drama|Romance,1990-10-24,25,6.2,1990,41722463,3463104,-38259359,6
10047,0.323339,1500000,5728953,4228953,Hardware,Dylan McDermott|Stacey Travis|William Hootkins|Carl McCoy|Iggy Pop,Richard Stanley,93,Horror|Science Fiction|Thriller,1990-09-14,33,5.1,1990,2503347,9561041,7057694,5
10050,0.317091,3,16,13,Tales from the Darkside: The Movie,Rae Dawn Chong|Christian Slater|Deborah Harry|Steve Buscemi|David Johansen,John Harrison,93,Fantasy|Horror|Comedy,1990-05-03,37,5.8,1990,5,26,21,6
10052,0.309387,10000000,47410000,37410000,Hard to Kill,Steven Seagal|Kelly LeBrock|William Sadler|Frederick Coffin|Bonnie Burroughs,Bruce Malmuth,96,Action|Thriller,1990-02-09,64,5.4,1990,16688985,79122479,62433494,5
10055,0.298196,37931000,27931461,-9999539,The Rescuers Down Under,Bob Newhart|Eva Gabor|John Candy|Tristan Rogers|Adam Ryen,Hendel Butoy|Mike Gabriel,77,Adventure|Animation|Crime|Family|Fantasy,1990-11-16,166,6.4,1990,63302990,46614774,-16688216,6
10063,0.384309,2500000,205068,-2294932,Frankenhooker,Patty Mullen|James Lorinz|Joanne Ritchie|J.J. Clark|Helmar Augustus Cooper,Frank Henenlotter,85,Comedy|Horror|Science Fiction,1990-06-01,20,5.6,1990,4172246,342237,-3830009,6
10068,0.255367,11000000,8862354,-2137646,Nightbreed,Craig Sheffer|Anne Bobby|David Cronenberg|Charles Haid|Hugh Quarshie,Clive Barker,102,Action|Drama|Fantasy|Horror,1990-02-16,40,6.2,1990,18357883,14790369,-3567514,6
10069,0.255318,19000000,10000000,-9000000,The Two Jakes,Jack Nicholson|Harvey Keitel|Meg Tilly|Madeleine Stowe|RubÃ©n Blades,Jack Nicholson,138,Crime|Drama|Mystery,1990-08-10,17,6.0,1990,31709072,16688985,-15020087,6
10077,0.078482,49000000,20423389,-28576611,The Adventures of Ford Fairlane,Andrew Dice Clay|Wayne Newton|Priscilla Presley|Morris Day|Lauren Holly,Renny Harlin,104,Action|Comedy|Thriller|Crime|Mystery,1990-07-11,33,6.5,1990,81776028,34084564,-47691464,6
10081,0.177761999999999,20000000,15379253,-4620747,Mr. Destiny,Jim Belushi|Michael Caine|Linda Hamilton|Jon Lovitz|Rene Russo,James Orr,110,Fantasy|Comedy|Science Fiction|Romance,1990-10-12,23,6.2,1990,33377970,25666412,-7711558,6
10082,0.1746,22000000,39071603,17071603,Postcards from the Edge,Meryl Streep|Shirley MacLaine|Dennis Quaid|Gene Hackman|Richard Dreyfuss,Mike Nichols,101,Comedy|Drama,1990-09-12,15,6.0,1990,36715767,65206541,28490774,6
10093,0.142836,500000,3779620,3279620,Paris is Burning,Dorian Corey|Pepper LaBeija|Willi Ninja|Octavia St. Laurent|Anji Xtravaganza,Jennie Livingston,71,Documentary,1990-03-13,27,7.6,1990,834449,6307802,5473353,8
10094,0.142486,18000000,476684675,458684675,Home Alone,Macaulay Culkin|Joe Pesci|Daniel Stern|John Heard|Catherine O'Hara,Chris Columbus,103,Comedy|Family,1990-11-09,1393,7.0,1990,30040173,795538358,765498185,7
10095,0.257865,31000000,35419397,4419397,Mermaids,Cher|Winona Ryder|Christina Ricci|Bob Hoskins|Michael Schoeffling,Richard Benjamin,110,Comedy|Drama|Romance,1990-12-14,68,6.5,1990,51735854,59111379,7375525,6
10096,0.126283,2500000,26386000,23886000,House Party,Christopher Reid|Martin Lawrence|Christopher Martin|Robin Harris|Tisha Campbell-Martin,Reginald Hudlin,100,Comedy|Drama,1990-03-09,21,6.6,1990,4172246,44035556,39863310,7
10110,2.631987,4000000,215880014,211880014,One Hundred and One Dalmatians,Rod Taylor|J. Pat O'Malley|Betty Lou Gerson|Martha Wentworth|Ben Wright,Clyde Geronimi|Hamilton Luske|Wolfgang Reitherman,79,Adventure|Animation|Comedy|Family,2061-01-25,913,6.6,1961,29179444,1574814739,1545635295,7
10111,1.752027,2500000,9500000,7000000,Breakfast at Tiffany's,Audrey Hepburn|George Peppard|Patricia Neal|Buddy Ebsen|Martin Balsam,Blake Edwards,110,Comedy|Drama|Romance,2061-10-05,557,7.4,1961,18237153,69301181,51064028,7
10112,0.900245,6000000,43656822,37656822,West Side Story,Natalie Wood|Richard Beymer|Russ Tamblyn|Rita Moreno|George Chakiris,Jerome Robbins|Robert Wise,152,Music|Crime|Drama,2061-10-18,192,6.6,1961,43769167,318470457,274701290,7
10113,0.754548,6000000,28900000,22900000,The Guns of Navarone,Gregory Peck|David Niven|Anthony Quinn|Stanley Baker|Anthony Quayle,J. Lee Thompson|Alexander Mackendrick,158,Action|Adventure|Drama|War,2061-04-27,95,7.0,1961,43769167,210821488,167052321,7
10115,0.538364,3000000,10000000,7000000,Judgment at Nuremberg,Spencer Tracy|Burt Lancaster|Richard Widmark|Marlene Dietrich|Maximilian Schell,Stanley Kramer,186,Drama|History,2061-12-01,67,6.7,1961,21884583,72948612,51064029,7
10121,0.282665,5037000,14483352,9446352,King of Kings,Jeffrey Hunter|SiobhÃ¡n McKenna|Hurd Hatfield|Viveca Lindfors|Robert Ryan,Nicholas Ray,168,Drama,2061-10-11,10,5.9,1961,36744215,105654042,68909827,6
10124,0.249542,200000,2000000,1800000,The Pit and the Pendulum,Vincent Price|John Kerr|Barbara Steele|Luana Anders|Antony Carbone,Roger Corman,80,Horror,2061-08-12,23,6.3,1961,1458972,14589722,13130750,6
10130,0.173731,6000000,4300000,-1700000,One-Eyed Jacks,Marlon Brando|Karl Malden|Katy Jurado|Pina Pellicer|Ben Johnson,Marlon Brando,141,Western|Action,2061-03-30,17,6.1,1961,43769167,31367903,-12401264,6
10131,0.303783,3000000,4000000,1000000,"One, Two, Three",James Cagney|Liselotte Pulver|Horst Buchholz|Pamela Tiffin|Howard St. John,Billy Wilder,115,Comedy|Family,2061-12-15,30,7.5,1961,21884583,29179444,7294861,7
10134,0.290285,2900000,5000000,2100000,Pocketful of Miracles,Glenn Ford|Bette Davis|Hope Lange|Arthur O'Connell|Peter Falk,Frank Capra,136,Comedy|Drama,2061-12-18,10,6.1,1961,21155097,36474306,15319209,6
10141,2.610362,806948,32000000,31193052,Psycho,Anthony Perkins|Vera Miles|John Gavin|Janet Leigh|Martin Balsam,Alfred Hitchcock,109,Drama|Horror|Thriller,2060-08-14,1180,8.0,1960,5949601,235934958,229985357,8
10142,1.872132,2000000,4905000,2905000,The Magnificent Seven,Yul Brynner|Eli Wallach|Steve McQueen|Charles Bronson|Robert Vaughn,John Sturges,128,Action|Adventure|Western,2060-10-23,224,7.0,1960,14745934,36164405,21418471,7
10143,1.136943,12000000,60000000,48000000,Spartacus,Kirk Douglas|Laurence Olivier|Jean Simmons|Charles Laughton|Peter Ustinov,Stanley Kubrick,197,Action|Drama|History,2060-10-06,211,6.9,1960,88475609,442378047,353902438,7
10144,0.947307,3000000,25000000,22000000,The Apartment,Jack Lemmon|Shirley MacLaine|Fred MacMurray|Ray Walston|Jack Kruschen,Billy Wilder,125,Comedy|Drama|Romance,2060-06-15,235,7.9,1960,22118902,184324186,162205284,8
10170,0.055821,3000000,7100000,4100000,Cinderfella,Jerry Lewis|Ed Wynn|Judith Anderson|Henry Silva|Robert Hutton,Frank Tashlin,91,Comedy|Romance,2060-12-18,13,7.2,1960,22118902,52348068,30229166,7
10173,2.582657,1300000,28262574,26962574,Taxi Driver,Robert De Niro|Cybill Shepherd|Harvey Keitel|Jodie Foster|Peter Boyle,Martin Scorsese,113,Crime|Drama,1976-02-08,1269,7.8,1976,4981207,108293649,103312442,8
10174,2.389663,1100000,117235147,116135147,Rocky,Sylvester Stallone|Talia Shire|Burt Young|Carl Weathers|Burgess Meredith,John G. Avildsen,119,Drama,1976-11-21,963,7.2,1976,4214867,449209681,444994814,7
10175,1.263483,1800000,33800000,32000000,Carrie,Sissy Spacek|Piper Laurie|Amy Irving|William Katt|Betty Buckley,Brian De Palma,98,Horror|Thriller,1976-11-03,497,6.8,1976,6897056,129511393,122614337,7
10176,0.999413,2800000,60922980,58122980,The Omen,Gregory Peck|Lee Remick|David Warner|Billie Whitelaw|Harvey Stephens,Richard Donner,111,Horror|Thriller,1976-06-06,203,6.9,1976,10728754,233438462,222709708,7
10177,0.924068,9000000,25000000,16000000,Logan's Run,Michael York|Richard Jordan|Jenny Agutter|Roscoe Lee Browne|Farrah Fawcett,Michael Anderson,120,Adventure|Action|Romance|Science Fiction,1976-06-23,101,5.9,1976,34485282,95792450,61307168,6
10178,0.886829999999999,24000000,52614445,28614445,King Kong,Jeff Bridges|Jessica Lange|Charles Grodin|John Randolph|Rene Auberjonois,John Guillermin,134,Action|Adventure|Drama|Horror|Science Fiction,1976-09-08,70,5.9,1976,91960752,201602665,109641913,6
10179,0.85009,8500000,70600000,62100000,All the President's Men,Robert Redford|Dustin Hoffman|Jack Warden|Martin Balsam|Hal Holbrook,Alan J. Pakula,138,Drama|History|Mystery|Thriller,1976-04-04,216,7.3,1976,32569433,270517880,237948447,7
10180,0.722259,9000000,46236000,37236000,The Enforcer,Clint Eastwood|Tyne Daly|Harry Guardino|Bradford Dillman|John Mitchum,James Fargo,96,Action|Crime|Thriller,1976-12-21,97,6.6,1976,34485282,177162390,142677108,7
10181,0.600495,2000000,7900000,5900000,Family Plot,Barbara Harris|Bruce Dern|Karen Black|William Devane|Ed Lauter,Alfred Hitchcock,121,Comedy|Crime|Thriller,1976-04-09,37,6.7,1976,7663396,30270414,22607018,7
10182,0.597297,3700000,31800000,28100000,The Outlaw Josey Wales,Clint Eastwood|Chief Dan George|Sondra Locke|Bill McKinney|John Vernon,Clint Eastwood,135,Drama|Western,1976-06-30,135,7.1,1976,14177282,121847997,107670715,7
10183,0.522601,6500000,21709020,15209020,Marathon Man,Dustin Hoffman|Laurence Olivier|Roy Scheider|William Devane|Marthe Keller,John Schlesinger,125,Thriller,1976-10-05,90,7.1,1976,24906037,83182409,58276372,7
10185,0.476406,3800000,23689877,19889877,Network,Faye Dunaway|William Holden|Peter Finch|Robert Duvall|Wesley Addy,Sidney Lumet,121,Drama,1976-11-01,161,7.4,1976,14560452,90772454,76212002,7
10191,0.360421,6000000,33833201,27833201,The Pink Panther Strikes Again,Peter Sellers|Herbert Lom|Lesley-Anne Down|Burt Kwouk|Colin Blakely,Blake Edwards,103,Comedy|Mystery,1976-12-15,47,6.6,1976,22990188,129638609,106648421,7
10208,0.155768,6000000,161000000,155000000,A Star Is Born,Barbra Streisand|Kris Kristofferson|Gary Busey|Oliver Clark|Venetta Fields,Frank Pierson,139,Drama|Music|Romance,1976-12-16,14,5.7,1976,22990188,616903382,593913194,6
10218,0.017498,35000000,35323292,323292,The Bad News Bears,Walter Matthau|Tatum O'Neal|Christopher Daniel Barnes|Ben Piazza|Vic Morrow,Michael Ritchie,102,Comedy|Family,1976-04-07,54,6.6,1976,134109430,135348188,1238758,7
10220,2.571339,14600000,70906973,56306973,Groundhog Day,Bill Murray|Andie MacDowell|Chris Elliott|Stephen Tobolowsky|Brian Doyle-Murray,Harold Ramis,101,Romance|Fantasy|Drama|Comedy,1993-02-11,1339,7.2,1993,22038261,107031945,84993684,7
10221,2.455618,18000000,75634409,57634409,The Nightmare Before Christmas,Danny Elfman|Chris Sarandon|Catherine O'Hara|William Hickey|Glenn Shadix,Henry Selick,76,Fantasy|Animation|Family,1993-10-09,1172,7.4,1993,27170459,114167868,86997409,7
10222,2.377288,22000000,321265768,299265768,Schindler's List,Liam Neeson|Ben Kingsley|Ralph Fiennes|Caroline Goodall|Jonathan Sagall,Steven Spielberg,195,Drama|History|War,1993-11-29,2632,8.1,1993,33208339,484941026,451732687,8
10223,2.204926,63000000,920100000,857100000,Jurassic Park,Sam Neill|Laura Dern|Jeff Goldblum|Richard Attenborough|Bob Peck,Steven Spielberg,127,Adventure|Science Fiction,1993-06-11,3169,7.4,1993,95096607,1388863311,1293766704,7
10224,1.960217,57000000,159055768,102055768,Demolition Man,Sylvester Stallone|Wesley Snipes|Sandra Bullock|Nigel Hawthorne|Benjamin Bratt,Marco Brambilla,115,Action|Adventure|Comedy|Science Fiction,1993-10-08,580,6.1,1993,86039787,240089904,154050117,6
10225,1.73212599999999,25000000,441286195,416286195,Mrs. Doubtfire,Robin Williams|Sally Field|Pierce Brosnan|Harvey Fierstein|Polly Holliday,Chris Columbus,125,Comedy|Drama|Family,1993-11-24,809,6.9,1993,37736749,666108255,628371506,7
10226,1.708867,44000000,368875760,324875760,The Fugitive,Harrison Ford|Tommy Lee Jones|Sela Ward|Julianne Moore|Joe Pantoliano,Andrew Davis,130,Adventure|Action|Thriller|Crime|Mystery,1993-08-06,717,7.0,1993,66416678,556806879,490390201,7
10227,1.35597,40000000,176997168,136997168,In the Line of Fire,Clint Eastwood|Rene Russo|John Malkovich|Dylan McDermott|Gary Cole,Wolfgang Petersen,128,Action|Drama|Thriller|Crime|Mystery,1993-07-08,170,6.5,1993,60378798,267171908,206793110,6
10228,1.294131,26000000,206678440,180678440,Philadelphia,Tom Hanks|Denzel Washington|Jason Robards|Mary Steenburgen|Antonio Banderas,Jonathan Demme,125,Drama|Mystery,1993-12-22,514,7.5,1993,39246219,311974896,272728677,7
10229,1.242232,6900000,7993039,1093039,Dazed and Confused,Jason London|Rory Cochrane|Wiley Wiggins|Sasha Jenson|Michelle Burke,Richard Linklater,102,Comedy|Drama,1993-09-24,320,7.3,1993,10415342,12065252,1649910,7
10230,1.207245,85000000,137298489,52298489,Last Action Hero,Arnold Schwarzenegger|F. Murray Abraham|Art Carney|Charles Dance|Frank McRae,John McTiernan,130,Adventure|Fantasy|Action|Comedy|Family,1993-06-17,367,5.8,1993,128304946,207247944,78942998,6
10231,1.19024699999999,30000000,135130999,105130999,A Perfect World,Kevin Costner|Clint Eastwood|Laura Dern|T.J. Lowther|Bradley Whitford,Clint Eastwood,138,Crime|Drama|Thriller,1993-11-24,188,6.9,1993,45284098,203976183,158692085,7
10232,1.176724,20000000,35739755,15739755,Robin Hood: Men in Tights,Cary Elwes|Dom DeLuise|Roger Rees|Dave Chappelle|Eric Allan Kramer,Mel Brooks,104,Comedy,1993-07-28,273,6.3,1993,30189399,53948086,23758687,6
10234,1.041911,70000000,255000211,185000211,Cliffhanger,Sylvester Stallone|John Lithgow|Michael Rooker|Janine Turner|Rex Linn,Renny Harlin,112,Action|Adventure|Thriller,1993-05-28,312,6.1,1993,105662897,384915158,279252261,6
10235,1.038971,40000000,116300000,76300000,Sliver,Sharon Stone|William Baldwin|Tom Berenger|Polly Walker|Colleen Camp,Phillip Noyce,108,Drama|Thriller,1993-05-21,62,4.7,1993,60378798,175551356,115172558,5
10236,1.02495499999999,21,42,21,Teenage Mutant Ninja Turtles III,Paige Turco|Stuart Wilson|Sab Shimono|Vivian Wu|Mark Caso,Stuart Gillard,96,Action|Adventure|Comedy|Family|Fantasy,1993-03-17,95,5.2,1993,31,63,32,5
10239,0.980554,14000000,154864401,140864401,Cool Runnings,Leon Robinson|Doug E. Doug|Rawle D. Lewis|Malik Yoba|John Candy,Jon Turteltaub,98,Comedy,1993-09-30,289,6.8,1993,21132579,233763161,212630582,7
10240,0.940335,21000000,227799884,206799884,Sleepless in Seattle,Tom Hanks|Meg Ryan|Bill Pullman|Ross Malinger|Rosie O'Donnell,Nora Ephron,105,Comedy|Drama|Romance,1993-06-24,362,6.4,1993,31698869,343857082,312158213,6
10241,0.926373,25000000,56505065,31505065,Tombstone,Kurt Russell|Val Kilmer|Sam Elliott|Bill Paxton|Stephen Lang,George P. Cosmatos,130,Action|Adventure|Drama|History|Western,1993-12-25,373,7.3,1993,37736749,85292698,47555949,7
10243,0.892862,30000000,11146270,-18853730,For Love or Money,Michael J. Fox|Gabrielle Anwar|Anthony Higgins|Fyvush Finkel|Sandra Reaves-Phillips,Barry Sonnenfeld,94,Comedy|Romance,1993-10-01,35,5.4,1993,45284098,16824959,-28459139,5
10244,0.885824,30000000,36516012,6516012,Carlito's Way,Al Pacino|Sean Penn|Penelope Ann Miller|John Leguizamo|Ingrid Rogers,Brian De Palma,144,Action|Crime|Drama|Thriller,1993-11-10,394,7.4,1993,45284098,55119823,9835725,7
10245,0.873616,25000000,133752825,108752825,Hot Shots! Part Deux,Charlie Sheen|Lloyd Bridges|Valeria Golino|Richard Crenna|Rowan Atkinson,Jim Abrahams,86,Action|Comedy|War,1993-05-21,255,6.1,1993,37736749,201895871,164159122,6
10246,0.853733,12500000,12281551,-218449,True Romance,Christian Slater|Patricia Arquette|Michael Rapaport|Bronson Pinchot|Gary Oldman,Tony Scott,120,Action|Thriller|Crime|Romance,1993-09-09,402,7.3,1993,18868374,18538632,-329742,7
10247,0.834235,42000000,20844907,-21155093,Super Mario Bros.,Bob Hoskins|John Leguizamo|Dennis Hopper|Samantha Mathis|Fisher Stevens,Annabel Jankel|Rocky Morton,104,Adventure|Comedy|Family|Fantasy,1993-05-27,114,4.0,1993,63397738,31464760,-31932978,4
10248,0.830934,38000000,57319029,19319029,Sister Act 2: Back in the Habit,Whoopi Goldberg|Kathy Najimy|James Coburn|Barnard Hughes|Mary Wickes,Bill Duke,107,Music|Comedy,1993-12-09,173,5.8,1993,57359858,86521352,29161494,6
10250,0.796639,45000000,195268056,150268056,The Pelican Brief,Julia Roberts|Denzel Washington|Sam Shepard|William Atherton|John Lithgow,Alan J. Pakula,141,Action|Mystery|Thriller,1993-12-16,207,6.2,1993,67926148,294751265,226825117,6
10251,0.794564,30000000,53898845,23898845,The Three Musketeers,Charlie Sheen|Kiefer Sutherland|Chris O'Donnell|Oliver Platt|Tim Curry,Stephen Herek,105,Action|Adventure|Comedy,1993-11-11,112,5.9,1993,45284098,81358687,36074589,6
10252,0.789429,22000000,10696210,-11303790,RoboCop 3,Robert John Burke|Nancy Allen|Mario Machado|Jodi Long|John Posey,Fred Dekker,104,Action|Adventure|Crime|Science Fiction|Thriller,1993-11-05,169,4.2,1993,33208339,16145607,-17062732,4
10253,0.787932,11000000,30000000,19000000,What's Eating Gilbert Grape,Johnny Depp|Leonardo DiCaprio|Juliette Lewis|Darlene Cates|Mary Steenburgen,Lasse HallstrÃ¶m,118,Romance|Drama,1993-12-17,495,7.4,1993,16604169,45284098,28679929,7
10254,0.787414,35000000,117270765,82270765,Dennis the Menace,Walter Matthau|Mason Gamble|Joan Plowright|Christopher Lloyd|Lea Thompson,Nick Castle,94,Family|Comedy,1993-06-23,117,5.8,1993,52831448,177016697,124185249,6
10255,0.76151,9000000,2395231,-6604769,Kalifornia,Brad Pitt|David Duchovny|Juliette Lewis|Michelle Forbes|Kathy Larson,Dominic Sena,117,Thriller|Crime,1993-09-01,96,6.3,1993,13585229,3615529,-9969700,6
10256,0.756988,22000000,17287898,-4712102,A Bronx Tale,Robert De Niro|Chazz Palminteri|Lillo Brancato|Francis Capra|Taral Hicks,Robert De Niro,121,Drama|Crime,1993-09-14,227,7.2,1993,33208339,26095562,-7112777,7
10257,0.755397999999999,13500000,11285588,-2214412,Manhattan Murder Mystery,Woody Allen|Diane Keaton|Jerry Adler|Alan Alda|Anjelica Huston,Woody Allen,104,Comedy|Crime|Mystery|Thriller,1993-08-18,69,6.9,1993,20377844,17035256,-3342588,7
10258,0.750847,25000000,40903593,15903593,Falling Down,Michael Douglas|Robert Duvall|Barbara Hershey|Rachel Ticotin|Frederic Forrest,Joel Schumacher,113,Crime|Drama|Thriller,1993-02-26,380,7.0,1993,37736749,61742744,24005995,7
10260,0.743875,42000000,270248367,228248367,The Firm,Tom Cruise|Jeanne Tripplehorn|Gene Hackman|Holly Hunter|Ed Harris,Sydney Pollack,154,Drama|Mystery|Thriller,1993-06-30,258,6.5,1993,63397738,407931792,344534054,6
10261,0.743063,15000000,10611160,-4388840,The Dark Half,Timothy Hutton|Amy Madigan|Michael Rooker|Julie Harris|Robert Joy,George A. Romero,122,Mystery|Horror,1993-04-23,28,4.9,1993,22642049,16017227,-6624822,5
10263,0.710505,28000000,39514713,11514713,Hocus Pocus,Bette Midler|Sarah Jessica Parker|Kathy Najimy|Omri Katz|Thora Birch,Kenny Ortega,96,Comedy|Family|Fantasy,1993-07-16,278,6.1,1993,42265158,59646272,17381114,6
10265,0.683387,13000000,65796862,52796862,In the Name of the Father,Daniel Day-Lewis|Emma Thompson|Pete Postlethwaite|John Lynch|Beatie Edney,Jim Sheridan,133,Drama,1993-12-12,156,7.4,1993,19623109,99318386,79695277,7
10266,0.682902999999999,13000000,428868,-12571132,Body Snatchers,Gabrielle Anwar|Terry Kinney|Billy Wirth|Christine Elise|Forest Whitaker,Abel Ferrara,87,Horror|Science Fiction|Thriller,1993-06-09,28,5.5,1993,19623109,647363,-18975746,5
10267,0.666908,20000000,153698625,133698625,Free Willy,Jason James Richter|Lori Petty|August Schellenberg|Michael Madsen|Jayne Atkinson,Simon Wincer,112,Family|Adventure,1993-07-16,226,5.9,1993,30189399,232003457,201814058,6
10274,0.634017,7000000,116700000,109700000,The Piano,Holly Hunter|Harvey Keitel|Sam Neill|Anna Paquin|Cliff Curtis,Jane Campion,121,Romance|Drama,1993-05-19,131,6.8,1993,10566289,176155144,165588855,7
10275,0.625238,35000000,18635620,-16364380,Geronimo: An American Legend,Jason Patric|Wes Studi|Gene Hackman|Robert Duvall|Matt Damon,Walter Hill,115,Action|Drama|Western,1993-12-10,19,6.1,1993,52831448,28129908,-24701540,6
10279,0.611772,17000000,44456478,27456478,The Good Son,Macaulay Culkin|Elijah Wood|Wendy Crewson|David Morse|Daniel Hugh Kelly,Joseph Ruben,87,Drama|Horror|Thriller,1993-09-24,94,6.2,1993,25660989,67105718,41444729,6
10281,0.595221,18000000,74189677,56189677,Hard Target,Jean-Claude Van Damme|Arnold Vosloo|Lance Henriksen|Yancy Butler|Sven-Ole Thorsen,John Woo,97,Action|Adventure|Crime|Thriller,1993-08-20,115,5.9,1993,27170459,111987088,84816629,6
10282,0.574693,11500000,23237911,11737911,The Remains of the Day,Anthony Hopkins|Emma Thompson|James Fox|Christopher Reeve|Hugh Grant,James Ivory,134,Drama|Romance,1993-11-05,96,7.1,1993,17358904,35076928,17718024,7
10283,0.565312,6000000,5617391,-382609,Batman: Mask of the Phantasm,"Kevin Conroy|Dana Delany|Efrem Zimbalist, Jr.|Mark Hamill|Hart Bochner",Bruce Timm|Eric Radomski,76,Animation|Action|Adventure|Family,1993-12-25,98,7.2,1993,9056819,8479282,-577537,7
10284,0.56486,34000000,32255440,-1744560,The Age of Innocence,Daniel Day-Lewis|Michelle Pfeiffer|Winona Ryder|Alexis Smith|Geraldine Chaplin,Martin Scorsese,139,Drama|Romance,1993-09-17,76,6.7,1993,51321978,48688617,-2633361,7
10291,0.519349,32000000,36733909,4733909,Alive,Ethan Hawke|Vincent Spano|Bruce Ramsay|David Kriegel|Josh Hamilton,Frank Marshall,120,Action|Adventure|Drama|Thriller,1993-01-15,198,6.7,1993,48303038,55448732,7145694,7
10294,0.504169,3000000,15,-2999985,Jason Goes to Hell: The Final Friday,Kane Hodder|John D. LeMay|Kari Keegan|Steven Williams|Steven Culp,Adam Marcus,87,Horror|Thriller,1993-08-13,86,3.9,1993,4528409,22,-4528387,4
10297,0.490013,8,27,19,National Lampoon's Loaded Weapon 1,Emilio Estevez|Samuel L. Jackson|Jon Lovitz|Tim Curry|Kathy Ireland,Gene Quintano,84,Comedy,1993-02-04,72,5.5,1993,12,40,28,5
10299,0.485211,12000000,22750363,10750363,Rudy,Sean Astin|Jon Favreau|Ned Beatty|Greta Lind|Scott Benjaminson,David Anspaugh,114,Drama,1993-09-17,113,7.2,1993,18113639,34340989,16227350,7
10303,0.475609,15000000,118243066,103243066,Beethoven's 2nd,Charles Grodin|Bonnie Hunt|Nicholle Tom|Christopher Castile|Sarah Rose Karr,Rod Daniel,89,Family|Comedy,1993-12-14,84,5.0,1993,22642049,178484356,155842307,5
10306,0.453557,20000000,11585483,-8414517,So I Married an Axe Murderer,Mike Myers|Nancy Travis|Anthony LaPaglia|Amanda Plummer|Brenda Fricker,Thomas Schlamme,93,Comedy|Crime|Romance,1993-07-30,72,6.2,1993,30189399,17487938,-12701461,6
10307,0.450208,25000000,6,-24999994,The House of the Spirits,Meryl Streep|Glenn Close|Jeremy Irons|Winona Ryder|Antonio Banderas,Bille August,140,Romance|Drama,1993-10-19,52,6.7,1993,37736749,9,-37736740,7
10312,0.410092,38000000,266614059,228614059,Indecent Proposal,Robert Redford|Demi Moore|Woody Harrelson|Seymour Cassel|Oliver Platt,Adrian Lyne,117,Drama,1993-04-07,152,5.6,1993,57359858,402445913,345086055,6
10315,0.397807,3500000,27900000,24400000,Menace II Society,Tyrin Turner|Larenz Tate|Glenn Plummer|Jada Pinkett Smith|Samuel L. Jackson,Albert Hughes|Allen Hughes,97,Drama|Action|Crime,1993-05-26,94,7.1,1993,5283144,42114211,36831067,7
10317,0.394817,30000000,13273595,-16726405,Body of Evidence,Madonna|Willem Dafoe|Julianne Moore|Anne Archer|JÃ¼rgen Prochnow,Uli Edel,99,Drama|Thriller|Romance,1993-01-15,25,4.4,1993,45284098,20036092,-25248006,4
10323,0.374068,8000000,2000000,-6000000,Red Rock West,Nicolas Cage|Dennis Hopper|Lara Flynn Boyle|J. T. Walsh|Timothy Carhart,John Dahl,98,Crime|Drama|Thriller,1993-06-16,27,6.1,1993,12075759,3018939,-9056820,6
10327,0.134756,900000,8556940,7656940,Leprechaun,Warwick Davis|Jennifer Aniston|Ken Olandt|Mark Holton|Robert Hy Gorman,Mark Jones,92,Comedy|Horror|Thriller,1993-01-08,51,5.5,1993,1358522,12916443,11557921,5
10331,0.336871,25000000,2438031,-22561969,Son of the Pink Panther,Roberto Benigni|Herbert Lom|Claudia Cardinale|Shabana Azmi|Debrah Farentino,Blake Edwards,93,Comedy|Foreign,1993-01-01,15,4.0,1993,37736749,3680134,-34056615,4
10335,0.321865,35000000,4858139,-30141861,Little Buddha,Keanu Reeves|Bridget Fonda|Chris Isaak|Ruocheng Ying|Alex Wiesendanger,Bernardo Bertolucci,140,Drama|History,1993-12-01,33,5.8,1993,52831448,7333214,-45498234,6
10336,0.320607,1500000,418961,-1081039,Killing Zoe,Eric Stoltz|Julie Delpy|Jean-Hugues Anglade|Tai Thai|Bruce Ramsay,Roger Avary,96,Action|Crime|Drama|Thriller,1993-10-01,46,5.8,1993,2264204,632409,-1631795,6
10338,0.313792,14000000,27515786,13515786,Poetic Justice,Janet Jackson|Tupac Shakur|Regina King|Joe Torry|Tyra Ferrell,John Singleton,109,Drama|Romance,1993-07-23,24,6.8,1993,21132579,41534252,20401673,7
10344,0.286492,900000,6980986,6080986,Children of the Corn II: The Final Sacrifice,Terence Knox|Paul Scherrer|Ryan Bollman|Christie Clark|Rosalind Allen,David Price,92,Horror|Mystery,1993-01-29,15,4.7,1993,1358522,10537588,9179066,5
10348,0.269327,11000000,32861136,21861136,The Joy Luck Club,Ming-Na Wen|Lauren Tom|Tamlyn Tomita|Rosalind Chao|Kiá»u Chinh,Wayne Wang,139,Drama,1993-09-08,17,6.8,1993,16604169,49602897,32998728,7
10354,0.240771,6000000,13609396,7609396,The Crush,Cary Elwes|Alicia Silverstone|Jennifer Rubin|Kurtwood Smith|Amber Benson,Alan Shapiro,89,Drama|Thriller,1993-04-02,28,5.9,1993,9056819,20542974,11486155,6
10355,0.23906,19885552,19724334,-161218,Fire in the Sky,D. B. Sweeney|Robert Patrick|Craig Sheffer|Peter Berg|Henry Thomas,Robert Lieberman,109,Drama|Horror|Thriller|Mystery,1993-03-12,49,6.4,1993,30016643,29773289,-243354,6
10364,0.207999,6000000,3283371,-2716629,Only the Strong,Mark Dacascos|Geoffrey Lewis|Stacey Travis|Paco Christian Prieto|Todd Susman,Sheldon Lettich,99,Action,1993-08-27,12,6.7,1993,9056819,4956149,-4100670,7
10368,0.191721,6000000,12974636,6974636,Man's Best Friend,Ally Sheedy|Lance Henriksen|Robert Costanzo|Fredric Lehne|John Cassini,John Lafia,97,Horror|Science Fiction|Thriller,1993-11-19,10,5.5,1993,9056819,19584823,10528004,5
10378,0.140785,14000000,63513743,49513743,Dragon: The Bruce Lee Story,Jason Scott Lee|Lauren Holly|Robert Wagner|Michael Learned|Nancy Kwan,Rob Cohen,120,Drama|Action,1993-05-07,72,6.9,1993,21132579,95872087,74739508,7
10381,0.128982,2000000,54207,-1945793,Return of the Living Dead 3,Melinda Clarke|J. Trevor Edmond|Kent McCord|Sarah Douglas|James T. Callahan,Brian Yuzna,97,Horror|Romance|Science Fiction,1993-10-01,34,5.6,1993,3018939,81823,-2937116,6
10391,0.276654,1000000,6933459,5933459,Xi yan,Kuei Ya-Lei|Sihung Lung|May Chin|Winston Chao|Mitchell Lichtenstein,Ang Lee,109,Comedy|Drama|Romance,1993-08-04,20,6.8,1993,1509469,10465848,8956379,7
10398,2.550704,4000000,205843612,201843612,The Jungle Book,Phil Harris|Sebastian Cabot|Louis Prima|George Sanders|Sterling Holloway,Wolfgang Reitherman,78,Family|Animation|Adventure,2067-10-18,928,7.0,1967,26147054,1345551058,1319404004,7
10399,2.22723,3000000,104397102,101397102,The Graduate,Anne Bancroft|Dustin Hoffman|Katharine Ross|Murray Hamilton|Buck Henry,Mike Nichols,106,Comedy|Drama|Romance,2067-12-21,426,7.5,1967,19610291,682419190,662808899,7
10400,1.975304,12000000,41744718,29744718,Casino Royale,David Niven|Peter Sellers|Ursula Andress|Orson Welles|Joanna Pettet,Val Guest|Ken Hughes|John Huston|Joseph McGrath|Robert Parrish,131,Adventure|Action|Comedy,2067-04-13,76,5.4,1967,78441164,272875358,194434194,5
10401,1.554808,9500000,111584787,102084787,You Only Live Twice,Sean Connery|Akiko Wakabayashi|Karin Dor|Mie Hama|TetsurÅ Tamba,Lewis Gilbert,117,Action|Thriller|Adventure,2067-06-12,301,6.2,1967,62099255,729403389,667304134,6
10402,1.022408,2500000,50700000,48200000,Bonnie and Clyde,Warren Beatty|Faye Dunaway|Michael J. Pollard|Gene Wilder|Gene Hackman,Arthur Penn,111,Crime|Drama,2067-07-18,153,7.6,1967,16341909,331413921,315072012,8
10404,0.678719,3000000,16217773,13217773,Cool Hand Luke,Paul Newman|George Kennedy|Luke Askew|Morgan Woodward|Harry Dean Stanton,Stuart Rosenberg,126,Crime|Drama,2067-06-22,171,7.2,1967,19610291,106011750,86401459,7
10405,0.586060999999999,4000000,11000000,7000000,Wait Until Dark,"Audrey Hepburn|Alan Arkin|Richard Crenna|Efrem Zimbalist, Jr.|Jack Weston",Terence Young,108,Crime|Drama|Thriller,2067-10-26,42,7.5,1967,26147054,71904401,45757347,7
10409,0.485288,25000000,45300000,20300000,The Dirty Dozen,Lee Marvin|Ernest Borgnine|Charles Bronson|Jim Brown|John Cassavetes,Robert Aldrich,150,Action|Adventure|War,2067-06-15,168,7.2,1967,163419093,296115397,132696304,7
10410,0.428652,2000000,27379978,25379978,In the Heat of the Night,Sidney Poitier|Rod Steiger|Warren Oates|Lee Grant|Larry Gates,Norman Jewison,109,Crime|Drama|Mystery|Thriller,2067-08-02,83,7.0,1967,13073527,178976447,165902920,7
10413,0.321935,4000000,56666667,52666667,Guess Who's Coming to Dinner,Spencer Tracy|Sidney Poitier|Katharine Hepburn|Katharine Houghton|Isabel Sanford,Stanley Kramer,108,Comedy|Drama|Romance,2067-12-11,72,7.4,1967,26147054,370416614,344269560,7
10418,0.241283,18000000,9000000,-9000000,Doctor Dolittle,Rex Harrison|Samantha Eggar|Richard Attenborough|Anthony Newley|Peter Bull,Richard Fleischer,152,Adventure|Fantasy|Comedy|Family|Music,2067-12-19,16,5.1,1967,117661747,58830873,-58830874,5
10420,0.213291,5000000,50000000,45000000,Valley of the Dolls,Barbara Parkins|Patty Duke|Sharon Tate|Paul Burke|Tony Scotti,Mark Robson,123,Music|Drama|Romance,2067-12-27,13,6.2,1967,32683818,326838186,294154368,6
10425,0.114342,3500000,2000000,-1500000,A Countess from Hong Kong,Marlon Brando|Sophia Loren|Tippi Hedren|Sydney Chaplin|Charles Chaplin,Charles Chaplin,120,Comedy|Romance,2067-01-05,17,5.4,1967,22878673,13073527,-9805146,5
10438,2.508235,2500000,78898765,76398765,From Russia With Love,Sean Connery|Daniela Bianchi|Lotte Lenya|Robert Shaw|Bernard Lee,Terence Young,115,Action|Thriller|Adventure,2063-10-11,458,6.7,1963,17800448,561773358,543972910,7
10440,1.13932099999999,2500000,11403529,8903529,The Birds,Tippi Hedren|Rod Taylor|Suzanne Pleshette|Veronica Cartwright|Ethel Griffies,Alfred Hitchcock,119,Horror,2063-03-28,434,7.0,1963,17800448,81195171,63394723,7
10441,0.920094,4000000,13474588,9474588,Charade,Cary Grant|Audrey Hepburn|Walter Matthau|James Coburn|George Kennedy,Stanley Donen,113,Comedy|Mystery|Romance|Thriller,2063-12-05,187,7.5,1963,28480717,95941483,67460766,7
10443,0.804532999999999,31115000,57750000,26635000,Cleopatra,Elizabeth Taylor|Richard Burton|Rex Harrison|Roddy McDowall|Martin Landau,Joseph L. Mankiewicz|Rouben Mamoulian|Darryl F. Zanuck,248,Drama|History|Romance,2063-06-12,68,6.3,1963,221544381,411190358,189645977,6
10446,0.664326,4000000,5000000,1000000,The Great Escape,Steve McQueen|James Garner|Richard Attenborough|James Donald|Charles Bronson,John Sturges,172,Adventure|Drama|History|Thriller|War,2063-06-20,409,7.5,1963,28480717,35600896,7120179,7
10457,0.207161,17000000,10000000,-7000000,55 Days at Peking,Charlton Heston|Ava Gardner|David Niven|Burt Kwouk|Flora Robson,Nicholas Ray|Guy Green,154,Action|Drama|History,2063-05-06,18,5.6,1963,121043049,71201793,-49841256,6
10472,2.485419,18500000,131060248,112560248,Aliens,Sigourney Weaver|Carrie Henn|Michael Biehn|Lance Henriksen|Paul Reiser,James Cameron,137,Horror|Action|Thriller|Science Fiction,1986-07-18,2027,7.6,1986,36804018,260732097,223928079,8
10473,1.528427,16000000,5900000,-10100000,Highlander,Christopher Lambert|Roxanne Hart|Clancy Brown|Sean Connery|Beatie Edney,Russell Mulcahy,116,Adventure|Action|Fantasy,1986-03-07,312,6.5,1986,31830502,11737497,-20093005,6
10474,1.522478,6000000,138530565,132530565,Platoon,Tom Berenger|Charlie Sheen|Willem Dafoe|Forest Whitaker|John C. McGinley,Oliver Stone,120,Drama|War|Action,1986-12-18,650,7.3,1986,11936438,275593594,263657156,7
10475,1.469796,15000000,356830601,341830601,Top Gun,Tom Cruise|Kelly McGillis|Val Kilmer|Anthony Edwards|Tom Skerritt,Tony Scott,110,Drama|Action|Romance,1986-05-16,1046,6.6,1986,29841096,709881085,680039989,7
10476,1.36519,6000000,70136369,64136369,Ferris Bueller's Day Off,Matthew Broderick|Alan Ruck|Mia Sara|Jeffrey Jones|Jennifer Grey,John Hughes,103,Drama|Comedy,1986-06-11,755,7.3,1986,11936438,139529742,127593304,7
10477,1.349043,8000000,52287000,44287000,Stand by Me,Wil Wheaton|River Phoenix|Corey Feldman|Jerry O'Connell|Kiefer Sutherland,Rob Reiner,89,Crime|Drama,1986-08-07,792,7.5,1986,15915251,104020093,88104842,7
10480,1.161643,15000000,60629159,45629159,The Fly,Jeff Goldblum|Geena Davis|John Getz|Joy Boushel|Leslie Carlson,David Cronenberg,96,Horror|Science Fiction,1986-08-15,502,6.9,1986,29841096,120616037,90774941,7
10481,1.161139,17000000,6735922,-10264078,Nine 1/2 Weeks,Mickey Rourke|Kim Basinger|Margaret Whitton|David Margulies|Christine Baranski,Adrian Lyne,117,Drama|Romance,1986-02-14,90,5.9,1986,33819908,13400486,-20419422,6
10482,1.136303,14000000,82424789,68424789,The Great Mouse Detective,Barrie Ingham|Val Bettin|Vincent Price|Susanne Pollatschek|Candy Candido,Ron Clements|Burny Mattinson|David Michener|John Musker,74,Animation,1986-07-02,174,6.7,1986,27851689,163976403,136124714,7
10483,1.045604,40000000,1641825,-38358175,Pirates,Walter Matthau|Cris Campion|Damien Thomas|Olu Jacobs|Charlotte Lewis,Roman Polanski,124,Adventure|Comedy,1986-05-08,22,6.2,1986,79576256,3266257,-76309999,6
10486,0.994488,6000000,8551228,2551228,Blue Velvet,Isabella Rossellini|Kyle MacLachlan|Dennis Hopper|Laura Dern|Hope Lange,David Lynch,120,Crime|Drama|Mystery|Thriller,1986-08-01,354,7.3,1986,11936438,17011867,5075429,7
10487,0.971594,24000000,133000000,109000000,Star Trek IV: The Voyage Home,William Shatner|Leonard Nimoy|DeForest Kelley|James Doohan|George Takei,Leonard Nimoy,119,Science Fiction|Adventure,1986-11-25,275,6.6,1986,47745753,264591052,216845299,7
10488,0.969383,37000000,37962774,962774,Howard the Duck,Lea Thompson|Jeffrey Jones|Tim Robbins|Ed Gale|Holly Robinson Peete,Willard Huyck,110,Fantasy|Comedy|Science Fiction,1986-08-01,105,4.9,1986,73608037,75523385,1915348,5
10489,0.960984,25000000,11000000,-14000000,Big Trouble in Little China,Kurt Russell|Kim Cattrall|Dennis Dun|James Hong|Victor Wong,John Carpenter,99,Adventure|Fantasy|Action|Comedy,1986-05-30,347,6.7,1986,49735160,21883470,-27851690,7
10490,0.91418,13800000,52293982,38493982,The Color of Money,Paul Newman|Tom Cruise|Mary Elizabeth Mastrantonio|Helen Shaver|John Turturro,Martin Scorsese,119,Drama,1986-10-07,130,6.5,1986,27453808,104033983,76580175,6
10491,0.889305999999999,20000000,77200000,57200000,The Name of the Rose,Sean Connery|Christian Slater|Helmut Qualtinger|Elya Baskin|Feodor Chaliapin Jr.,Jean-Jacques Annaud,130,Drama|Thriller|Mystery,1986-09-24,363,7.0,1986,39788128,153582174,113794046,7
10492,0.828454999999999,25000000,12729917,-12270083,Labyrinth,David Bowie|Jennifer Connelly|Toby Froud|Christopher Malcolm|Shelley Thompson,Jim Henson,101,Adventure|Family|Fantasy,1986-06-27,336,6.9,1986,49735160,25324978,-24410182,7
10495,0.772494,113,115103979,115103866,"The Karate Kid, Part II",Ralph Macchio|Pat Morita|Martin Kove|Charlie Tanimoto|Yuji Okumoto,John G. Avildsen,113,Adventure|Drama|Action|Romance|Family,1986-06-18,211,5.8,1986,224,228988593,228988369,6
10498,0.719299,8500000,16209459,7709459,Raw Deal,Arnold Schwarzenegger|Kathryn Harrold|Darren McGavin|Sam Wanamaker|Paul Shenar,John Irvin,106,Action|Crime|Thriller,1986-06-06,82,5.7,1986,16909954,32247201,15337247,6
10499,0.680643,5000000,328203506,323203506,Crocodile Dundee,Paul Hogan|Linda Kozlowski|Mark Blum|David Gulpilil|Michael Lombard,Peter Faiman,97,Adventure|Comedy,1986-09-26,248,6.2,1986,9947032,652930158,642983126,6
10500,0.669137,15000000,42724017,27724017,Heartbreak Ridge,Clint Eastwood|Marsha Mason|Everett McGill|Moses Gunn|Mario Van Peebles,Clint Eastwood,130,Action|Comedy|Drama|War,1986-12-15,121,6.5,1986,29841096,84995433,55154337,6
10501,0.642842,25000000,79817939,54817939,The Golden Child,Eddie Murphy|Charles Dance|Charlotte Lewis|Victor Wong|Peter Kwong,Michael Ritchie,94,Action|Adventure|Comedy,1986-12-12,152,5.4,1986,49735160,158790319,109055159,5
10503,0.582226,19000000,40996665,21996665,Poltergeist II: The Other Side,Craig T. Nelson|JoBeth Williams|Heather O'Rourke|Oliver Robins|Zelda Rubinstein,Brian Gibson,91,Thriller|Horror,1986-05-23,73,5.6,1986,37798721,81559028,43760307,6
10504,0.566943,10000000,54999651,44999651,The Money Pit,Tom Hanks|Shelley Long|Alexander Godunov|Maureen Stapleton|Joe Mantegna,Richard Benjamin,91,Comedy|Romance,1986-03-15,137,6.4,1986,19894064,109416658,89522594,6
10505,0.557155,25000000,38748395,13748395,Little Shop of Horrors,Rick Moranis|Ellen Greene|Vincent Gardenia|Steve Martin|Tisha Campbell-Martin,Frank Oz,94,Horror|Comedy|Music,1986-12-19,221,6.4,1986,49735160,77086305,27351145,6
10507,0.546365,24500000,17218023,-7281977,The Mission,Robert De Niro|Jeremy Irons|Ray McAnally|Aidan Quinn|Liam Neeson,Roland JoffÃ©,126,Adventure|Drama|Action|History,1986-09-29,127,6.8,1986,48740457,34253645,-14486812,7
10508,0.544756999999999,9000000,28607524,19607524,Hoosiers,Gene Hackman|Barbara Hershey|Dennis Hopper|C.W. Mundy|Sheb Wooley,David Anspaugh,114,Drama|Family,1986-11-14,62,6.7,1986,17904657,56911991,39007334,7
10509,0.541302,3000000,19472057,16472057,Friday the 13th Part VI: Jason Lives,Thom Mathews|Jennifer Cooke|David Kagen|RenÃ©e Jones|Tom Fridley,Tom McLoughlin,86,Horror|Mystery|Thriller,1986-08-01,90,5.5,1986,5968219,38737835,32769616,5
10511,0.524096,4500000,1261000,-3239000,From Beyond,Jeffrey Combs|Barbara Crampton|Ken Foree|Ted Sorel|Carolyn Purdy-Gordon,Stuart Gordon,86,Horror|Science Fiction|Fantasy,1986-06-05,36,5.8,1986,8952328,2508641,-6443687,6
10514,0.516685,2000000,13167232,11167232,Critters,Dee Wallace|M. Emmet Walsh|Billy Green Bush|Scott Grimes|Nadine Van der Velde,Stephen Herek,82,Comedy|Horror|Science Fiction,1986-04-11,112,5.7,1986,3978812,26194975,22216163,6
10516,0.506902,4000000,2826523,-1173477,Sid & Nancy,Gary Oldman|Chloe Webb|David Hayman|Debby Bishop|Andrew Schofield,Alex Cox,112,Drama|Music|Romance,1986-11-07,47,6.6,1986,7957625,5623102,-2334523,7
10519,0.476819,6400000,40084041,33684041,Hannah and Her Sisters,Woody Allen|Michael Caine|Mia Farrow|Carrie Fisher|Barbara Hershey,Woody Allen,107,Comedy|Drama,1986-02-07,102,7.3,1986,12732201,79743448,67011247,7
10521,0.461807,10000000,4711220,-5288780,King Kong Lives,Linda Hamilton|Brian Kerwin|John Ashton|Peter Elliott|Peter Michael Goetz,John Guillermin|Charles McCracken,105,Action|Horror,1986-11-21,13,3.5,1986,19894064,9372531,-10521533,3
10525,0.437451,14000000,62134225,48134225,Down and Out in Beverly Hills,Nick Nolte|Bette Midler|Richard Dreyfuss|Elizabeth PeÃ±a|Little Richard,Paul Mazursky,103,Comedy,1986-01-31,19,5.1,1986,27851689,123610225,95758536,5
10527,0.425424,10000000,7433663,-2566337,Maximum Overdrive,Emilio Estevez|Pat Hingle|Laura Harrington|Yeardley Smith|John Short,Stephen King,97,Action|Drama|Horror|Science Fiction,1986-07-25,68,5.4,1986,19894064,14788576,-5105488,5
10528,0.400218,3000000,20966644,17966644,A Room with a View,Maggie Smith|Helena Bonham Carter|Denholm Elliott|Julian Sands|Simon Callow,James Ivory,117,Drama|Romance,1986-03-07,80,6.6,1986,5968219,41711175,35742956,7
10530,0.389778,18000000,41382841,23382841,Peggy Sue Got Married,Kathleen Turner|Nicolas Cage|Barry Miller|Catherine Hicks|Joan Allen,Francis Ford Coppola,103,Comedy|Drama|Fantasy|Romance,1986-10-05,57,5.7,1986,35809315,82327289,46517974,6
10539,0.3478,2700000,3500000,800000,The Wraith,Charlie Sheen|Nick Cassavetes|Sherilyn Fenn|Randy Quaid|Matthew Barry,Mike Marvin,93,Romance|Science Fiction|Horror|Action|Crime,1986-11-21,48,5.9,1986,5371397,6962922,1591525,6
10541,0.327717,4700000,8025872,3325872,The Texas Chainsaw Massacre 2,Dennis Hopper|Caroline Williams|Jim Siedow|Bill Moseley|Bill Johnson,Tobe Hooper,101,Horror,1986-08-22,43,5.7,1986,9350210,15966721,6616511,6
10552,0.207606,12000000,4884663,-7115337,Invaders from Mars,Karen Black|Hunter Carson|Timothy Bottoms|Laraine Newman|James Karen,Tobe Hooper,100,Science Fiction,1986-01-01,20,5.1,1986,23872876,9717579,-14155297,5
10556,0.277984,18000000,3900000,-14100000,The Manhattan Project,John Lithgow|Christopher Collet|Cynthia Nixon|Jill Eikenberry|John Mahoney,Marshall Brickman,118,Science Fiction|Thriller,1986-06-13,11,6.0,1986,35809315,7758685,-28050630,6
10558,0.258898,6500000,2347000,-4153000,At Close Range,Sean Penn|Christopher Walken|Mary Stuart Masterson|Chris Penn|Millie Perkins,James Foley,111,Crime|Drama,1986-04-18,21,6.0,1986,12931141,4669136,-8262005,6
10566,0.245607,1100000,5450815,4350815,Troll,Noah Hathaway|Michael Moriarty|Julia Louis-Dreyfus|Shelley Hack|Jenny Beck,John Carl Buechler,82,Fantasy|Horror,1986-01-17,22,4.6,1986,2188347,10843886,8655539,5
10572,0.203663,12000000,15945534,3945534,Armed and Dangerous,John Candy|Eugene Levy|Robert Loggia|Meg Ryan|Kenneth McMillan,Mark L. Lester,88,Action|Comedy|Crime,1986-08-15,20,5.1,1986,23872876,31722147,7849271,5
10578,0.167621,15000000,12308521,-2691479,Club Paradise,Robin Williams|Peter O'Toole|Rick Moranis|Jimmy Cliff|Twiggy,Harold Ramis,96,Comedy|Drama|Romance,1986-07-11,10,4.1,1986,29841096,24486650,-5354446,4
10584,0.094098,18000000,9697739,-8302261,SpaceCamp,Kate Capshaw|Lea Thompson|Kelly Preston|Larry B. Scott|Joaquin Phoenix,Harry Winer,107,Family|Adventure,1986-06-06,23,6.2,1986,35809315,19292744,-16516571,6
10588,0.076196,1900000,4790926,2890926,Vamp,Chris Makepeace|Sandy Baron|Robert Rusler|Dedee Pfeiffer|Gedde Watanabe,Richard Wenk,93,Comedy|Horror,1986-07-18,12,5.2,1986,3779872,9531098,5751226,5
10589,0.068835,15000000,8620929,-6379071,Manhunter,William Petersen|Kim Greist|Dennis Farina|Brian Cox|Joan Allen,Michael Mann,119,Crime|Horror|Thriller,1986-08-14,163,6.6,1986,29841096,17150531,-12690565,7
10593,2.272486,15000000,32056467,17056467,Robin Hood,Brian Bedford|Phil Harris|Peter Ustinov|Pat Buttram|Ken Curtis,Wolfgang Reitherman,83,Animation|Family,1973-11-08,641,6.9,1973,73667393,157434424,83767031,7
10594,2.010733,8000000,441306145,433306145,The Exorcist,Linda Blair|Max von Sydow|Ellen Burstyn|Jason Miller|Lee J. Cobb,William Friedkin,122,Drama|Horror|Thriller,1973-12-26,1113,7.2,1973,39289276,2167324901,2128035625,7
10595,1.549139,7000000,161777836,154777836,Live and Let Die,Roger Moore|Yaphet Kotto|Jane Seymour|Clifton James|Julius Harris,Guy Hamilton,121,Adventure|Action|Thriller,1973-07-05,293,6.1,1973,34378117,794516768,760138651,6
10596,1.087374,500000,3000000,2500000,Mean Streets,Harvey Keitel|Robert De Niro|David Proval|Amy Robinson|Richard Romanus,Martin Scorsese,110,Drama|Crime,1973-10-02,141,7.1,1973,2455579,14733478,12277899,7
10597,0.993066,850000,90000000,89150000,Enter the Dragon,Bruce Lee|Jim Kelly|John Saxon|Ahna Capri|Sek Kin,Robert Clouse,99,Crime|Thriller|Action,1973-08-17,279,7.0,1973,4174485,442004362,437829877,7
10599,0.876503,1700000,8844595,7144595,Battle for the Planet of the Apes,Roddy McDowall|Lew Ayres|Bobby Porter|Richard Eastham|Claude Akins,J. Lee Thompson,93,Action|Science Fiction,1973-06-14,99,5.3,1973,8348971,43437217,35088246,5
10601,0.863155999999999,5500000,159616327,154116327,The Sting,Paul Newman|Robert Redford|Robert Shaw|Charles Durning|Ray Walston,George Roy Hill,129,Comedy|Crime|Drama,1973-12-25,304,7.7,1973,27011377,783901253,756889876,8
10606,0.684079,777000,115000000,114223000,American Graffiti,Richard Dreyfuss|Ron Howard|Paul Le Mat|Charles Martin Smith|Cindy Williams,George Lucas,110,Comedy|Drama,1973-08-01,145,6.5,1973,3815970,564783351,560967381,6
10608,0.600434,12000000,53267000,41267000,Papillon,Steve McQueen|Dustin Hoffman|Victor Jory|Don Gordon|Anthony Zerbe,Franklin J. Schaffner,151,Crime|Drama,1973-12-13,191,7.4,1973,58933914,261602737,202668823,7
10609,0.5684,2000000,18344729,16344729,Sleeper,Woody Allen|Diane Keaton|John Beck|Mary Gregory|Brian Avery,Woody Allen,89,Science Fiction|Comedy|Romance,1973-12-17,93,6.9,1973,9822319,90093891,80271572,7
10611,0.50142,3000000,29800000,26800000,Serpico,Al Pacino|John Randolph Jones|Jack Kehoe|Biff McGuire|Barbara Eda-Young,Sidney Lumet,129,Crime|Drama|History,1973-12-05,200,7.3,1973,14733478,146352555,131619077,7
10647,0.066994,1000000,2000000,1000000,Dillinger,Warren Oates|Ben Johnson|Michelle Phillips|Cloris Leachman|Harry Dean Stanton,John Milius,107,Action|Crime|Drama,1973-07-20,10,6.7,1973,4911159,9822319,4911160,7
10648,1.936962,4000000,55675257,51675257,The Aristocats,Phil Harris|Sterling Holloway|Scatman Crothers|Eva Gabor|Paul Winchell,Wolfgang Reitherman,78,Animation|Comedy|Family|Adventure,2070-12-24,625,7.0,1970,22465473,312692750,290227277,7
10649,0.797231,3000000,18999718,15999718,Beneath the Planet of the Apes,James Franciscus|Kim Hunter|Maurice Evans|Linda Harrison|Paul Richards,Ted Post,95,Adventure|Science Fiction|Mystery,2070-05-01,163,5.9,1970,16849105,106709414,89860309,6
10650,0.717333,3500000,81600000,78100000,MASH,Donald Sutherland|Elliott Gould|Tom Skerritt|Sally Kellerman|Robert Duvall,Robert Altman,116,Comedy|Drama|War,2070-01-24,126,6.8,1970,19657289,458295656,438638367,7
10653,0.467344,12000000,89800000,77800000,Patton,George C. Scott|Karl Malden|Stephen Young|Michael Strong|Carey Loftin,Franklin J. Schaffner,172,Drama|History|War,2070-01-25,188,6.9,1970,67396420,504349877,436953457,7
10654,0.396028,2200000,136400000,134200000,Love Story,Ali MacGraw|Ryan O'Neal|John Marley|Ray Milland|Russell Nype,Arthur Hiller,99,Drama|Romance,2070-12-16,56,6.6,1970,12356010,766072642,753716632,7
10656,0.381352,25485000,29548291,4063291,Tora! Tora! Tora!,Martin Balsam|SÃ´ Yamamura|Joseph Cotten|Tatsuya Mihashi|E.G. Marshall,Richard Fleischer|Kinji Fukasaku|Toshio Masuda,144,History|Action|Drama|Adventure|War,2070-09-23,93,6.6,1970,143133147,165954086,22820939,7
10660,0.336237,10000000,100489151,90489151,Airport,Burt Lancaster|Dean Martin|Jean Seberg|Jacqueline Bisset|George Kennedy,George Seaton,137,Action|Drama|Thriller,2070-03-05,33,6.2,1970,56163683,564384086,508220403,6
10661,0.279079,7000000,900000,-6100000,Zabriskie Point,Mark Frechette|Daria Halprin|Paul Fix|G. D. Spradlin|Bill Garaway,Michelangelo Antonioni,110,Drama|Romance,2070-02-09,30,6.5,1970,39314578,5054731,-34259847,6
10665,0.290174,15000000,31559552,16559552,Little Big Man,Dustin Hoffman|Faye Dunaway|Chief Dan George|Martin Balsam|Richard Mulligan,Arthur Penn,139,Action|Comedy|Drama|Western,2070-12-14,44,7.2,1970,84245525,177250068,93004543,7
10675,0.193759,3716946,3500000,-216946,The Ballad of Cable Hogue,Jason Robards|Stella Stevens|David Warner|Slim Pickens|L.Q. Jones,Sam Peckinpah,121,Action|Comedy|Western,2070-05-13,19,7.3,1970,20875737,19657289,-1218448,7
10683,0.429246,10000000,1500000,-8500000,The Private Life of Sherlock Holmes,Robert Stephens|Colin Blakely|GeneviÃ¨ve Page|Christopher Lee|Tamara Toumanova,Billy Wilder,125,Adventure|Comedy|Crime|Mystery|Romance,2070-10-29,21,6.7,1970,56163683,8424552,-47739131,7
10689,1.910465,11000000,141195658,130195658,Thunderball,Sean Connery|Claudine Auger|Adolfo Celi|Luciana Paluzzi|Rik Van Nutter,Terence Young,130,Adventure|Action|Thriller,2065-12-16,331,6.3,1965,76126200,977153544,901027344,6
10690,1.313676,8200000,163214286,155014286,The Sound of Music,Julie Andrews|Christopher Plummer|Eleanor Parker|Richard Haydn|Peggy Wood,Robert Wise,174,Drama|Family|Music|Romance,2065-03-02,620,7.2,1965,56748622,1129534861,1072786239,7
10691,1.282053,14000000,111721910,97721910,Doctor Zhivago,Omar Sharif|Julie Christie|Geraldine Chaplin|Rod Steiger|Alec Guinness,David Lean,197,Drama|Romance|War,2065-12-22,126,6.9,1965,96887891,773178594,676290703,7
10692,0.622157,5600000,29950000,24350000,Those Magnificent Men in Their Flying Machines or How I Flew from London to Paris in 25 hours 11 minutes,Stuart Whitman|Sarah Miles|James Fox|Alberto Sordi|Robert Morley,Ken Annakin,138,Action|Adventure|Comedy,2065-06-03,19,6.6,1965,38755156,207270882,168515726,7
10716,0.146033,20000000,12000000,-8000000,The Greatest Story Ever Told,Max von Sydow|Michael Anderson Jr.|Carroll Baker|Ina Balin|Victor Buono,George Stevens,199,Drama|History,2065-02-15,13,5.7,1965,138411273,83046764,-55364509,6
10724,1.778746,7000000,81974493,74974493,On Her Majesty's Secret Service,George Lazenby|Diana Rigg|Telly Savalas|Gabriele Ferzetti|Ilse Steppat,Peter R. Hunt,142,Adventure|Action|Thriller,2069-12-12,258,6.4,1969,41609849,487278044,445668195,6
10725,1.357317,6000000,102308889,96308889,Butch Cassidy and the Sundance Kid,Paul Newman|Robert Redford|Katharine Ross|Strother Martin|Henry Jones,George Roy Hill,110,History|Drama|Western|Crime,2069-09-23,379,7.0,1969,35665585,608151066,572485481,7
10727,0.859806,3600000,44785053,41185053,Midnight Cowboy,Dustin Hoffman|Jon Voight|Sylvia Miles|John McGiver|Brenda Vaccaro,John Schlesinger,113,Drama,2069-05-25,124,7.0,1969,21399351,266214187,244814836,7
10728,0.615889,6244087,638641,-5605446,The Wild Bunch,Ernest Borgnine|William Holden|Robert Ryan|Edmond O'Brien|Warren Oates,Sam Peckinpah,145,Adventure|Western,2069-06-17,121,7.2,1969,37116502,3796250,-33320252,7
10755,1.697618,6000000,181813770,175813770,Grease,John Travolta|Olivia Newton-John|Stockard Channing|Jeff Conaway|Didi Conn,Randal Kleiser,110,Music,1978-07-07,786,7.0,1978,20056204,607749015,587692811,7
10756,1.5627,20000000,187884007,167884007,Jaws 2,Roy Scheider|Lorraine Gary|Murray Hamilton|Joseph Mascolo|Jeffrey Kramer,Jeannot Szwarc,116,Horror|Thriller,1978-06-16,179,5.5,1978,66854013,628040000,561185987,5
10757,1.210531,650000,55000000,54350000,Dawn of the Dead,David Emge|Ken Foree|Scott H. Reiniger|Gaylen Ross|David Crawford,George A. Romero,127,Horror,1978-09-02,306,7.2,1978,2172755,183848538,181675783,7
10758,1.210324,55000000,300218018,245218018,Superman,Marlon Brando|Gene Hackman|Christopher Reeve|Ned Beatty|Jackie Cooper,Richard Donner,143,Adventure|Fantasy|Action|Science Fiction,1978-12-14,518,6.7,1978,183848538,1003538977,819690439,7
10759,1.198849,300000,70000000,69700000,Halloween,Donald Pleasence|Jamie Lee Curtis|P.J. Soles|Nancy Kyes|Nick Castle,John Carpenter,91,Horror|Thriller,1978-10-25,522,7.3,1978,1002810,233989048,232986238,7
10760,1.15793,2700000,141000000,138300000,Animal House,John Belushi|Tim Matheson|John Vernon|Verna Bloom|Tom Hulce,John Landis,109,Comedy,1978-07-27,230,6.7,1978,9025291,471320797,462295506,7
10762,0.959754,15000000,50000000,35000000,The Deer Hunter,Robert De Niro|John Cazale|John Savage|Christopher Walken|Meryl Streep,Michael Cimino,183,Drama|War,1978-12-08,464,7.4,1978,50140510,167135034,116994524,7
10770,0.512718999999999,2300000,35000000,32700000,Midnight Express,Brad Davis|Irene Miracle|Bo Hopkins|Randy Quaid|John Hurt,Alan Parker,121,Drama|Crime,1978-10-06,141,7.5,1978,7688211,116994524,109306313,7
10771,0.496029,4000000,30471420,26471420,The Lord of the Rings,Christopher Guard|William Squire|Michael Scholes|John Hurt|Simon Chandler,Ralph Bakshi,132,Drama|Animation|Adventure,1978-11-15,91,6.0,1978,13370802,101856836,88486034,6
10775,0.468871,7920000,14560084,6640084,Death on the Nile,Peter Ustinov|Mia Farrow|Simon MacCorkindale|Lois Chiles|Angela Lansbury,John Guillermin,140,Mystery,1978-10-06,51,6.2,1978,26474189,48670002,22195813,6
10777,0.43921,11,11,0,F.I.S.T.,Sylvester Stallone|Rod Steiger|Peter Boyle|Melinda Dillon|David Huffman,Norman Jewison,145,Drama|Action,1978-04-26,13,6.7,1978,36,36,0,7
10778,0.435312,5000000,7230000,2230000,Force 10 from Navarone,Harrison Ford|Robert Shaw|Barbara Bach|Edward Fox|Franco Nero,Guy Hamilton,118,Action|Adventure|War|Thriller,1978-11-01,39,6.6,1978,16713503,24167726,7454223,7
10779,0.411826,12000000,22765081,10765081,Convoy,Kris Kristofferson|Ali MacGraw|Ernest Borgnine|Burt Young|Madge Sinclair,Sam Peckinpah,110,Action|Comedy|Drama,1978-06-27,31,6.2,1978,40112408,76096852,35984444,6
10780,0.409377,3500000,24046533,20546533,Invasion of the Body Snatchers,Donald Sutherland|Brooke Adams|Leonard Nimoy|Veronica Cartwright|Jeff Goldblum,Philip Kaufman,115,Horror|Thriller|Science Fiction|Mystery,1978-12-19,87,6.5,1978,11699452,80380362,68680910,6
10788,0.277769,24000000,21049053,-2950947,The Wiz,Diana Ross|Michael Jackson|Nipsey Russell|Ted Ross|Theresa Merritt,Sidney Lumet,134,Adventure|Family|Fantasy|Music|Science Fiction,1978-10-24,30,6.1,1978,80224816,70360684,-9864132,6
10791,0.236193,6800000,26518355,19718355,Damien: Omen II,William Holden|Lee Grant|Jonathan Scott-Taylor|Robert Foxworth|Lance Henriksen,Don Taylor|Mike Hodges,107,Action|Drama|Horror|Thriller,1978-06-09,71,6.1,1978,22730364,88642923,65912559,6
10793,0.226002,1000000,3713768,2713768,Watership Down,John Hurt|Richard Briers|Michael Graham Cox|John Bennett|Simon Cadell,Martin Rosen,88,Adventure|Animation|Drama,1978-10-14,67,6.8,1978,3342700,12414014,9071314,7
10822,0.670273999999999,7500000,33736689,26236689,Who's Afraid of Virginia Woolf?,Elizabeth Taylor|Richard Burton|George Segal|Sandy Dennis|Agnes Flanagan,Mike Nichols,131,Drama,2066-06-21,74,7.5,1966,50385110,226643572,176258462,7
10828,0.40273,3000000,13000000,10000000,Torn Curtain,Paul Newman|Julie Andrews|Lila Kedrova|HansjÃ¶rg Felmy|Tamara Toumanova,Alfred Hitchcock,128,Mystery|Thriller,2066-07-13,46,6.3,1966,20154044,87334190,67180146,6
10829,0.395668,4653000,6000000,1347000,El Dorado,John Wayne|Robert Mitchum|James Caan|Charlene Holt|Paul Fix,Howard Hawks,120,Action|Western,2066-12-17,36,6.9,1966,31258922,40308088,9049166,7
10835,0.299911,12000000,20000000,8000000,The Sand Pebbles,Steve McQueen|Richard Attenborough|Richard Crenna|Candice Bergen|Emmanuelle Arsan,Robert Wise,182,Action|Adventure|Drama|War|Romance,2066-12-20,28,7.0,1966,80616176,134360293,53744117,7
10848,0.207257,5115000,12000000,6885000,Fantastic Voyage,Stephen Boyd|Raquel Welch|Edmond O'Brien|Donald Pleasence|Arthur O'Connell,Richard Fleischer,100,Adventure|Science Fiction,2066-08-24,42,6.7,1966,34362645,80616176,46253531,7
